ЁЯП╗ => ЁЯП╗, ркдрлНрк╡ркЪрк╛, ркдрлНрк╡ркЪрк╛ркирлЛ рккрлНрк░ркХрк╛рк░-1-2, рк░ркВркЧ
ЁЯП╝ => ЁЯП╝, ркдрлНрк╡ркЪрк╛, ркдрлНрк╡ркЪрк╛ркирлЛ рккрлНрк░ркХрк╛рк░-3, рк░ркВркЧ
ЁЯП╜ => ЁЯП╜, ркдрлНрк╡ркЪрк╛, ркдрлНрк╡ркЪрк╛ркирлЛ рккрлНрк░ркХрк╛рк░-4, рк░ркВркЧ
ЁЯП╛ => ЁЯП╛, ркдрлНрк╡ркЪрк╛, ркдрлНрк╡ркЪрк╛ркирлЛ рккрлНрк░ркХрк╛рк░-5, рк░ркВркЧ
ЁЯП┐ => ЁЯП┐, ркдрлНрк╡ркЪрк╛, ркдрлНрк╡ркЪрк╛ркирлЛ рккрлНрк░ркХрк╛рк░-6, рк░ркВркЧ
ЁЯША => ЁЯША, ркЪрк╣рлЗрк░рлЛ, ркорлЛркЯрлЗркерлА рк╣рк╕рк╡рлБркВ, рк╡рк┐ркирлЛркжрлА, рк╕рлНркорк╛ркЗрк▓рлА, рк╕рлНркорк┐ркд, рк╕рлНркорк┐ркд ркХрк░ркдрлЛ ркЪрк╣рлЗрк░рлЛ, рк╕рлНркорк┐ркд ркХрк░рк╡рлБркВ, рк╣рк╕рк╡рлБркВ
ЁЯШБ => ЁЯШБ, ркЪрк╣рлЗрк░рлЛ, ркорлЛркЯрлЗркерлА рк╣рк╕рк╡рлБркВ, рк╡рк┐ркирлЛркжрлА, рк╕рлНркорк╛ркЗрк▓, рк╕рлНркорк╛ркЗрк▓рлА, рк╕рлНркорк┐ркд, рк╕рлНркорк┐ркд ркХрк░ркдрлЛ, рк╕рлНркорк┐ркд ркХрк░рк╡рлБркВ, рк╣рк╕ркдрлА ркЖркВркЦрлЛ, рк╣рк╕ркдрлА ркЖркВркЦрлЛ рк╕рк╛ркерлЗркирлЛ рк╕рлНркорк┐ркд ркХрк░ркдрлЛ ркЪрк╣рлЗрк░рлЛ, рк╣рк╕рк╡рлБркВ, рк╣рк╛рк╕рлНркп ркХрк░рк╡рлБркВ
ЁЯШВ => ЁЯШВ, ркЕрк╢рлНрк░рлБ, ркЖркиркВркж, ркЖркиркВркжрк╛рк╢рлНрк░рлБ, ркЖркиркВркжрк╛рк╢рлНрк░рлБ рк╕рк╛ркерлЗркирлЛ ркЪрк╣рлЗрк░рлЛ, ркЪрк╣рлЗрк░рлЛ, рк╣рк░рлНрк╖ркирк╛ ркЖркВрк╕рлБ рк╕рк╛ркерлЗркирлЛ ркЪрк╣рлЗрк░рлЛ
ЁЯдг => ЁЯдг, ркЪрк╣рлЗрк░рлЛ, ркЬркорлАрки, ркЬркорлАрки рккрк░ рк▓рлЛркЯрлАркирлЗ рк╣рк╕рк╡рлБркВ, рк▓рлЛркЯрк╡рлБркВ, рк╣рк╕рк╡рлБркВ
ЁЯШГ => ЁЯШГ, ркЦрлБрк▓рлНрк▓рк╛ ркорлЛркВ рк╕рк╛ркерлЗркирлЛ рк╕рлНркорк┐ркд ркХрк░ркдрлЛ ркЪрк╣рлЗрк░рлЛ, ркЦрлБрк▓рлНрк▓рк╛ркВ ркорлЛркВркП рк╣рк╕ркдрлЛ ркЪрк╣рлЗрк░рлЛ, ркЦрлБрк▓рлНрк▓рк╛ ркорлЛркВркП рк╣рк╛рк╕рлНркп, ркЪрк╣рлЗрк░рлЛ, ркорлЛркЯрлЗркерлА рк╣рк╕рк╡рлБркВ, рк╡рк┐ркирлЛркжрлА, рк╕рлНркорк╛ркЗрк▓рлА, рк╣рк╕рк╡рлБркВ, рк╣рк╛рк╕рлНркп ркХрк░рк╡рлБркВ
ЁЯШД => ЁЯШД, ркЦрлБрк▓рлНрк▓рк╛ ркорлЛркВ ркЕркирлЗ рк╣рк╕ркдрлА ркЖркВркЦрлЛ рк╕рк╛ркерлЗркирлЛ рк╕рлНркорк┐ркд ркХрк░ркдрлЛ ркЪрк╣рлЗрк░рлЛ, ркЦрлБрк▓рлНрк▓рк╛ ркорлЛркВркП рк╣рк╛рк╕рлНркп, ркЦрлБрк▓рлНрк▓рлБркВ ркорлЛркврлБркВ, ркорлЛркЯрлЗркерлА рк╣рк╕рк╡рлБркВ, рк╡рк┐ркирлЛркжрлА, рк╕рлНркорк╛ркЗрк▓рлА, рк╣рк╕ркдрлА ркЖркВркЦрлЛ, рк╣рк╕рк╡рлБркВ, рк╣рк╛рк╕рлНркп ркХрк░рк╡рлБркВ
ЁЯШЕ => ЁЯШЕ, ркЦрлБрк▓рлНрк▓рк╛ ркорлЛркВ ркЕркирлЗ ркаркВркбрк╛ рккрк░рк╕рлЗрк╡рк╛ рк╕рк╛ркерлЗркирлЛ рк╕рлНркорк┐ркд ркХрк░ркдрлЛ ркЪрк╣рлЗрк░рлЛ, ркаркВркбрк╛ рккрк░рк╕рлЗрк╡рк╛ рк╕рк╛ркерлЗ рк╣рк╛рк╕рлНркп, ркаркВркбрлЛ рккрк░рк╕рлЗрк╡рлЛ, рк╣рк╛рк╕рлНркп рккрк░ркВркдрлБ ркаркВркбрк╛ рккрк░рк╕рлЗрк╡рк╛ рк╕рк╛ркерлЗ
ЁЯШЖ => ЁЯШЖ, ркЦрлБрк▓рлНрк▓рк╛ ркорлЛркВ ркЕркирлЗ ркЪрлБрк╕рлНркдрккркгрлЗ ркмркВркз ркЖркВркЦрлЛ рк╕рк╛ркерлЗркирлЛ рк╕рлНркорк┐ркд ркХрк░ркдрлЛ ркЪрк╣рлЗрк░рлЛ, ркЦрлБрк▓рлНрк▓рк╛ ркорлЛркВркП рк╣рк╛рк╕рлНркп, ркЦрлБрк▓рлНрк▓рлБркВ ркорлЛркврлБркВ, ркЪрк╣рлЗрк░рлЛ, ркмркВркз ркЖркВркЦрлЛ, ркмркВркз ркЖркВркЦрлЛ рк╕рк╛ркерлЗркирлБркВ рк╣рк╛рк╕рлНркп
ЁЯШЙ => ЁЯШЙ, ркЖркВркЦ ркорк╛рк░ркдрлЛ ркЪрк╣рлЗрк░рлЛ, ркЖркВркЦ ркорк╛рк░рк╡рлА, ркЪрк╣рлЗрк░рлЛ
ЁЯШК => ЁЯШК, ркЪрк╣рлЗрк░рлЛ, рк╣рк╕ркдрлА ркЖркВркЦрлЛ, рк╣рк╕ркдрлЛ ркЪрк╣рлЗрк░рлЛ, рк╣рк╕ркдрлЛ ркЪрк╣рлЗрк░рлЛ ркЕркирлЗ ркЖркВркЦрлЛ, рк╣рк╕рлНркдрлА ркЖркВркЦрлЛ рк╕рк╛ркерлЗркирлЛ рк╕рлНркорк┐ркд ркХрк░ркдрлЛ ркЪрк╣рлЗрк░рлЛ, рк╣рк╛рк╕рлНркп
ЁЯШЛ => ЁЯШЛ, ркЪрк╣рлЗрк░рлЛ, ркпрко ркпрко ркорк╕рлНркд, рк╕рлНрк╡рк╛ркжрк┐рк╖рлНркЯ, рк╕рлНрк╡рк╛ркжрк┐рк╖рлНркЯ ркнрлЛркЬрки, рк╕рлНрк╡рк╛ркжрк┐рк╖рлНркЯркирк╛ ркнрк╛рк╡рк╡рк╛рк│рлЛ ркЪрк╣рлЗрк░рлЛ, рк╣рк╕ркдрлЛ ркЪрк╣рлЗрк░рлЛ
ЁЯШО => ЁЯШО, ркЪрк╣рлЗрк░рлЛ, ркЬрлЗрки ркХрлВрк▓, ркЬрлЙ ркХрлВрк▓, ркаркВркбрлЛ, ркорлБркЦ, рк╕ркиркЧрлНрк▓рк╛рк╕рлЗрк╕, рк╕ркиркЧрлНрк▓рк╛рк╕рлЗрк╕ рк╕рк╛ркерлЗ рк╣рк╕ркдрлЛ ркЪрк╣рлЗрк░рлЛ, рк╣рк╛рк╕рлНркп
ЁЯШН => ЁЯШН, ркЖркВркЦрлЛ, ркЪрк╣рлЗрк░рлЛ, рккрлНрк░рлЗрко, ркорлБркЦ, рк╕рлНркирлЗрк╣рлА, рк╣рк╕ркдрлЛ ркЪрк╣рлЗрк░рлЛ, рк╣рлГркжркп, рк╣рлГркжркпрк╛ркХрк╛рк░ ркЖркВркЦрлЛ, рк╣рлГркжркпрк╛ркХрк╛рк░ркирлА ркЖркВркЦрлЛ рк╕рк╛ркерлЗркирлЛ рк╕рлНркорк┐ркд ркХрк░ркдрлЛ ркЪрк╣рлЗрк░рлЛ
ЁЯШШ => ЁЯШШ, ркЪрк╣рлЗрк░рлЛ, ркЪрлБркВркмрки ркЙркЫрк╛рк│ркдрлЛ ркЪрк╣рлЗрк░рлЛ, ркЪрлБркВркмрки ркЙркЫрк╛рк│рк╡рк╛, ркорлБркЦ
ЁЯШЧ => ЁЯШЧ, ркЪрк╣рлЗрк░рлЛ, ркЪрлБркВркмрки, ркЪрлБркВркмрки ркХрк░ркдрлЛ ркЪрк╣рлЗрк░рлЛ, ркЪрлБркВркмркирк╡рк╛рк│рлЛ ркЪрк╣рлЗрк░рлЛ, ркорлБркЦ
ЁЯШЩ => ЁЯШЩ, ркЪрк╣рлЗрк░рлЛ, ркЪрлБркВркмрки ркЕркирлЗ рк╣рк╛рк╕рлНркп, ркорлБркЦ, рк╣рк╕ркдрлА ркЖркВркЦрлЛ, рк╣рк╕ркдрлА ркЖркВркЦрлЛ рк╕рк╛ркерлЗркирлЛ ркЪрлБркВркмрки ркХрк░ркдрлЛ ркЪрк╣рлЗрк░рлЛ, рк╣рк╛рк╕рлНркп, рк╣рк╛рк╕рлНркп рк╕рк╛ркерлЗркирлЛ ркЪрлБркВркмрки ркХрк░ркдрлЛ ркЪрк╣рлЗрк░рлЛ
ЁЯШЪ => ЁЯШЪ, ркЪрк╣рлЗрк░рлЛ, ркЪрлБркВркмрки ркХрк░рк╡рлБркВ, ркмркВркз ркЖркВркЦрлЛ, ркмркВркз ркЖркВркЦрлЛ рк╕рк╛ркерлЗ ркЪрлБркВркмрки ркХрк░ркдрлЛ ркЪрк╣рлЗрк░рлЛ, ркмркВркз ркЖркВркЦрлЛ рк╕рк╛ркерлЗ ркЪрлБркВркмрки ркХрк░рк╡рлБркВ, ркорлБркЦ
тШ║ => тШ║, ркЪрк╣рлЗрк░рлЛ, ркмрк┐рки-ркнрк░рлЗрк▓рлЛ рк╕рлНркорк╛ркЗрк▓рлА ркЪрк╣рлЗрк░рлЛ, ркорлБркЦ, рк╕рлНркорк╛ркЗрк▓рлА, рк╣рк╕ркдрлЛ ркЪрк╣рлЗрк░рлЛ
ЁЯЩВ => ЁЯЩВ, ркЪрк╣рлЗрк░рлЛ, ркорлБркЦ, рк╕рк╣рлЗркЬ рк╕рлНркорк┐ркд ркХрк░ркдрлЛ ркЪрк╣рлЗрк░рлЛ, рк╕рлНркорк┐ркд, рк╣рк╛рк╕рлНркп
ЁЯдЧ => ЁЯдЧ, ркЖрк▓рк┐ркВркЧрки, ркЖрк▓рк┐ркВркЧрки ркХрк░ркдрлЛ ркЪрк╣рлЗрк░рлЛ, ркЖрк▓рк┐ркВркЧрки ркХрк░рк╡рлБркВ, ркЪрк╣рлЗрк░рлЛ, ркорлБркЦ
ЁЯдй => ЁЯдй, рк╕рлНркЯрк╛рк░ рк╕рлНркЯрлНрк░ркХ
ЁЯдФ => ЁЯдФ, ркЪрк╣рлЗрк░рлЛ, ркорлБркЦ, рк╡рк┐ркЪрк╛рк░ ркХрк░ркдрлЛ, рк╡рк┐ркЪрк╛рк░рк╢рлАрк▓, рк╡рк┐ркЪрк╛рк░рк╢рлАрк▓ ркЪрк╣рлЗрк░рлЛ
ЁЯди => ЁЯди, ркКркВркЪрлА ркнрлНрк░ркорк░ рк╕рк╛ркерлЗркирлЛ ркЪрк╣рлЗрк░рлЛ
ЁЯШР => ЁЯШР, ркХрлЛркИ ркЯрк┐рккрлНрккркгрлА ркирк╣рлАркВ, ркЪрк╣рлЗрк░рлЛ, ркдркЯрк╕рлНрке, ркдркЯрк╕рлНрке ркЪрк╣рлЗрк░рлЛ, ркнрк╛рк╡рк╢рлВркирлНркп, ркнрк╛рк╡рк╢рлВркирлНркп ркЪрк╣рлЗрк░рлЛ
ЁЯШС => ЁЯШС, ркЕркХркеркирлАркп ркЪрк╣рлЗрк░рлЛ, ркХрлЛркИ ркЯрк┐рккрлНрккркгрлА ркирк╣рлАркВ, ркЪрк╣рлЗрк░рлЛ, ркнрк╛рк╡рк╢рлВркирлНркп ркЪрк╣рлЗрк░рлЛ, ркорлБркЦ, рк╣рк╛рк╡ркнрк╛рк╡рк╡рк┐рк╣рлАрки
ЁЯШ╢ => ЁЯШ╢, ркЪрк╣рлЗрк░рлЛ, ркорлБркЦ, ркорлЛркВркврк╛ рк╡ркЧрк░ркирлЛ, ркорлЛркВркврк╛ рк╡ркЧрк░ркирлЛ ркЪрк╣рлЗрк░рлЛ
ЁЯЩД => ЁЯЩД, ркЖркВркЦрлЛ, ркЖркВркЦрлЛ рклрлЗрк░рк╡ркдрлЛ ркЪрк╣рлЗрк░рлЛ, ркЪрк╣рлЗрк░рлЛ, рклрлЗрк░рк╡ркдрлЛ, рклрлЗрк░рк╡рк╡рлА, ркорлБркЦ
ЁЯШП => ЁЯШП, ркХрлГркдрлНрк░рк┐рко рк╣рк╕ркдрлЛ ркЪрк╣рлЗрк░рлЛ, ркХрлГркдрлНрк░рк┐рко рк╣рк╛рк╕рлНркп, ркЪрк╣рлЗрк░рлЛ, ркорлБркЦ
ЁЯШг => ЁЯШг, ркЪрк╣рлЗрк░рлЛ, ркЬркмрк░ркжрк╕рлНркд, ркЬркмрк░ркжрк╕рлНркд ркЪрк╣рлЗрк░рлЛ, ркдрлЗ ркнрлВрк▓ ркеркИ, ркорк╛рк░рк╛ркерлА ркнрлВрк▓ ркеркИркирлЛ ркЪрк╣рлЗрк░рлЛ, ркорлБркЦ
ЁЯШе => ЁЯШе, ркЪрк╣рлЗрк░рлЛ, ркирк╡рк╛ркИ!, ркирк╛ркЦрлБрк╢, ркирк╛ркЦрлБрк╢ рккрк░ркВркдрлБ рк░рк╛рк╣ркдрк╡рк╛рк│рлЛ, ркирк╛ркЦрлБрк╢ рккрк░ркВркдрлБ рк░рк╛рк╣ркдрк╡рк╛рк│рлЛ ркЪрк╣рлЗрк░рлЛ, рк░рк╛рк╣ркд
ЁЯШо => ЁЯШо, ркЦрлБрк▓рлНрк▓рк╛ркВ ркорлЛркВркврк╛рк╡рк╛рк│рлЛ ркЪрк╣рлЗрк░рлЛ, ркЦрлБрк▓рлНрк▓рлБркВ ркорлЛркврлБркВ, ркЪрк╣рлЗрк░рлЛ, ркорлЛркВркврлБркВ, рк╕рк╣рк╛ркирлБркнрлВркдрк┐
ЁЯдР => ЁЯдР, ркЪрк╣рлЗрк░рлЛ, ркЭрк┐рккркерлА ркмркВркз ркХрк░рлЗрк▓рлЛ ркорлЛркврлБркВ, ркорлБркЦ, ркорлЛркврк╛ рккрк░ ркЭрк┐ркк рк╕рк╛ркерлЗркирлЛ ркЪрк╣рлЗрк░рлЛ
ЁЯШп => ЁЯШп, ркЕркЪркВркнрк┐ркд, ркЕрк╡рк╛ркХ, ркЪрк╣рлЗрк░рлЛ, рк╢рк╛ркВркд ркЪрк╣рлЗрк░рлЛ
ЁЯШк => ЁЯШк, ркКркВркШркдрлБркВ, ркКркВркШркдрлЛ ркЪрк╣рлЗрк░рлЛ, ркЪрк╣рлЗрк░рлЛ
ЁЯШл => ЁЯШл, ркЪрк╣рлЗрк░рлЛ, ркерк╛ркХрлЗрк▓рлЛ, ркерк╛ркХрлЗрк▓рлЛ ркЪрк╣рлЗрк░рлЛ
ЁЯШ┤ => ЁЯШ┤, ркЪрк╣рлЗрк░рлЛ, ркирк┐ркВркжрлНрк░рк╛ркзрлАрки ркЪрк╣рлЗрк░рлЛ, ркирк┐ркжрлНрк░рк╛ркорк╛ркВ, ркирк┐ркжрлНрк░рк╛ркорк╛ркВркирлЛ ркЪрк╣рлЗрк░рлЛ
ЁЯШМ => ЁЯШМ, ркЪрк╣рлЗрк░рлЛ, рк░рк╛рк╣ркд, рк░рк╛рк╣ркдркирк╛ ркнрк╛рк╡рк╡рк╛рк│рлЛ ркЪрк╣рлЗрк░рлЛ, рк░рк╛рк╣ркдрк╡рк╛рк│рлЛ ркЪрк╣рлЗрк░рлЛ
ЁЯШЫ => ЁЯШЫ, ркЪрк╣рлЗрк░рлЛ, ркЬрлАркн ркмрк╣рк╛рк░, ркмрк╣рк░ ркХрк╛ркврлЗрк▓рлА ркЬрлАркн рк╕рк╛ркерлЗркирлЛ ркЪрк╣рлЗрк░рлЛ, ркмрк╣рк╛рк░ ркХрк╛ркврлЗрк▓рлА ркЬрлАркн, ркмрк╣рк╛рк░ ркХрк╛ркврлЗрк▓рлА ркЬрлАркн рк╕рк╛ркерлЗркирлЛ ркЪрк╣рлЗрк░рлЛ
ЁЯШЬ => ЁЯШЬ, ркЖркВркЦ ркорк╛рк░рк╡рк╛ркирлА рк╕рк╛ркерлЗ ркЬрлАркн ркмрк╣рк╛рк░, ркЖркВркЦ ркорк╛рк░рк╡рк╛ркирлА рк╕рк╛ркерлЗ ркЬрлАркн ркмрк╣рк╛рк░ ркХрк╛рквркдрлЛ ркЪрк╣рлЗрк░рлЛ, ркЪрк╣рлЗрк░рлЛ, ркЬрлАркн ркмрк╣рк╛рк░, ркоркЬрк╛ркХ, ркорк╛ркдрлНрк░ рк╣рлЗрк░рк╛рки ркХрк░рк╡рлБркВ
ЁЯШЭ => ЁЯШЭ, ркЪрк╣рлЗрк░рлЛ, ркЪрлБрк╕рлНркдрккркгрлЗ ркмркВркз ркЖркВркЦрлЛ рк╕рк╛ркерлЗ ркЬрлАркн ркмрк╣рк╛рк░ ркХрк╛рквркдрлЛ ркЪрк╣рлЗрк░рлЛ, ркмркВркз ркЖркВркЦрлЛ, ркмркВркз ркЖркВркЦрлЛ рк╕рк╛ркерлЗ ркмрк╣рк╛рк░ ркХрк╛ркврлЗрк▓рлА ркЬрлАркн, ркмрк╣рк╛рк░ ркХрк╛ркврлЗрк▓рлА ркЬрлАркн, ркнркпркВркХрк░, ркорлБркЦ, ркпркХ
ЁЯдд => ЁЯдд, ркЪрк╣рлЗрк░рлЛ, рк▓рк╛рк│, рк▓рк╛рк│ ркЯрккркХрк╡рк╛рк╡рк╛рк│рлЛ ркЪрк╣рлЗрк░рлЛ
ЁЯШТ => ЁЯШТ, ркЪрк╣рлЗрк░рлЛ, ркжрлБркГркЦрлА, ркирк╛ркЦрлБрк╢, ркирк╛ркЦрлБрк╢ ркЪрк╣рлЗрк░рлЛ
ЁЯШУ => ЁЯШУ, ркЪрк╣рлЗрк░рлЛ, ркаркВркбрк╛ рккрк░рк╕рлЗрк╡рк╛ рк╕рк╛ркерлЗркирлЛ ркЪрк╣рлЗрк░рлЛ, ркаркВркбрлЛ рккрк░рк╕рлЗрк╡рлЛ
ЁЯШФ => ЁЯШФ, ркЪрк╣рлЗрк░рлЛ, ркирк╛рк╕рлАрккрк╛рк╕, рк╡рк┐ркЪрк╛рк░ркЧрлНрк░рк╕рлНркд, рк╡рк┐ркЪрк╛рк░ркЧрлНрк░рк╕рлНркд ркЪрк╣рлЗрк░рлЛ
ЁЯШХ => ЁЯШХ, ркЪрк╣рлЗрк░рлЛ, ркорлВркВркЭрк╛ркпрлЗрк▓, ркорлВркВркЭрк╛ркпрлЗрк▓ ркЪрк╣рлЗрк░рлЛ
ЁЯЩГ => ЁЯЩГ, ркКркВркзрлЛ, ркКркВркзрлЛ ркЪрк╣рлЗрк░рлЛ, ркЪрк╣рлЗрк░рлЛ, ркорлБркЦ
ЁЯдС => ЁЯдС, ркЪрк╣рлЗрк░рлЛ, ркзрки, ркзркирк╡рк╛рк│рлЛ ркЪрк╣рлЗрк░рлЛ, ркирк╛ркгрк╛ркВ, ркорлБркЦ, рк░рлВрккрк┐ркпрк╛
ЁЯШ▓ => ЁЯШ▓, ркЖркШрк╛ркд рк▓рк╛ркЧрлЗрк▓, ркЖрк╢рлНркЪрк░рлНркпркЪркХрк┐ркд, ркЖрк╢рлНркЪрк░рлНркпркЪркХрк┐ркд ркЪрк╣рлЗрк░рлЛ, ркПркХркжрко ркЖркШрк╛ркд рк▓рк╛ркЧрлЗрк▓, ркЪрк╣рлЗрк░рлЛ
тШ╣ => тШ╣, ркЧркоркЧрлАрки, ркЧркоркЧрлАрки ркЪрк╣рлЗрк░рлЛ, ркЪрк╣рлЗрк░рлЛ, ркорлБркЦ
ЁЯЩБ => ЁЯЩБ, ркЧркоркЧрлАрки, ркЪрк╣рлЗрк░рлЛ, ркерлЛркбрлЛ ркЧркоркЧрлАрки ркЪрк╣рлЗрк░рлЛ, ркорлБркЦ
ЁЯШЦ => ЁЯШЦ, ркЖркХрлБрк│рк╡рлНркпрк╛ркХрлБрк│, ркЖркХрлБрк│рк╡рлНркпрк╛ркХрлБрк│ ркЪрк╣рлЗрк░рлЛ, ркЪрк╣рлЗрк░рлЛ
ЁЯШЮ => ЁЯШЮ, ркЪрк╣рлЗрк░рлЛ, ркирк┐рк░рк╛рк╢, ркирк┐рк░рк╛рк╢ ркЪрк╣рлЗрк░рлЛ, ркирк┐рк░рк╛рк╢рк╛
ЁЯШЯ => ЁЯШЯ, ркЪрк╣рлЗрк░рлЛ, ркЪрк┐ркВркдрк╛ркЧрлНрк░рк╕рлНркд, ркЪрк┐ркВркдрк╛ркЧрлНрк░рк╕рлНркд ркЪрк╣рлЗрк░рлЛ
ЁЯШд => ЁЯШд, ркЪрк╣рлЗрк░рлЛ, ркорлЗркВ ркдрлЗ ркЬрлАркдрлНркпрк╛ркирлЛ ркЪрк╣рлЗрк░рлЛ, рк╡рк┐ркЬркп, рк╡рк┐ркЬркпрлА ркжрлЗркЦрк╛рк╡, рк╣рлБркВ ркЬрлАркдрлНркпрлЛ
ЁЯШв => ЁЯШв, ркЖркВрк╕рлБркУ, ркЪрк╣рлЗрк░рлЛ, ркжрлБркГркЦрлА, рк░ркбркдрлЛ ркЪрк╣рлЗрк░рлЛ, рк░ркбрк╡рлБркВ
ЁЯШн => ЁЯШн, ркЕрк╢рлНрк░рлБ, ркЪрк╣рлЗрк░рлЛ, ркорлЛркЯрлЗркерлА рк░ркбркдрлЛ ркЪрк╣рлЗрк░рлЛ, ркорлЛркЯрлЗркерлА рк░ркбрк╡рлБркВ, рк░ркбрк╡рлБркВ, рк░рлБркжрки
ЁЯШж => ЁЯШж, ркЦрлБрк▓рлНрк▓рк╛ркВ ркорлЛркВркврк╛ рк╕рк╛ркерлЗ ркнрк╡рк╛ркВ ркЪркбрк╛рк╡ркдрлЛ ркЪрк╣рлЗрк░рлЛ, ркЦрлБрк▓рлНрк▓рк╛ркВ ркорлЛркВркврк╛ рк╕рк╛ркерлЗ ркнрк╡рк╛ркВ ркЪркбрк╛рк╡рк╡рк╛ркВ, ркЦрлБрк▓рлНрк▓рлБркВ ркорлЛркВркврлБркВ, ркЪрк╣рлЗрк░рлЛ, ркнрк╡рк╛ркВ ркЪркбрк╛рк╡ркдрлЛ ркЪрк╣рлЗрк░рлЛ, ркнрк╡рк╛ркВ ркЪркбрк╛рк╡рк╡рк╛ркВ
ЁЯШз => ЁЯШз, ркЪрк╣рлЗрк░рлЛ, ркжрлБркГркЦрлА, ркжрлБркГркЦрлА ркЪрк╣рлЗрк░рлЛ, рккрлАркбрк╛рк╡рк╡рлБркВ
ЁЯШи => ЁЯШи, ркЪрк╣рлЗрк░рлЛ, ркнркпркЧрлНрк░рк╕рлНркд, ркнркпркнрлАркд, ркнркпркнрлАркд ркЪрк╣рлЗрк░рлЛ
ЁЯШй => ЁЯШй, ркХркВркЯрк╛рк│рк╛ркЬркиркХ, ркХркВркЯрк╛рк│рк╛ркЬркиркХ ркЪрк╣рлЗрк░рлЛ, ркЪрк╣рлЗрк░рлЛ, ркерк╛ркХрлЗрк▓рлЛ
ЁЯдп => ЁЯдп, рклрк╛ркЯркдрлБркВ ркорк╛ркерлБркВ
ЁЯШм => ЁЯШм, ркЪрк╣рлЗрк░рлЛ, ркЪрлЗркиркЪрк╛рк│рк╛, ркЪрлЗркиркЪрк╛рк│рк╛ ркХрк░ркдрлЛ ркЪрк╣рлЗрк░рлЛ, ркЪрлЗрк╖рлНркЯрк╛ ркХрк░рк╡рлА
ЁЯШ░ => ЁЯШ░, ркЦрлБрк▓рлНрк▓рк╛ ркорлЛркВ ркЕркирлЗ ркаркВркбрк╛ рккрк░рк╕рлЗрк╡рк╛ рк╕рк╛ркерлЗркирлЛ ркЪрк╣рлЗрк░рлЛ, ркЦрлБрк▓рлНрк▓рлБркВ ркорлЛркврлБркВ, ркЪрк╣рлЗрк░рлЛ, ркаркВркбрк╛ рккрк░рк╕рлЗрк╡рк╛ рк╕рк╛ркерлЗркирлЛ рк╡рк╛ркжрк│рлА ркЪрк╣рлЗрк░рлЛ, ркаркВркбрлЛ рккрк░рк╕рлЗрк╡рлЛ, ркзрк╕рлЗрк▓рлЛ ркЪрк╣рлЗрк░рлЛ
ЁЯШ▒ => ЁЯШ▒, ркЪрк╣рлЗрк░рлЛ, ркнркп, ркнркпркЧрлНрк░рк╕рлНркд, ркнркпркЧрлНрк░рк╕рлНркд ркЪрк╣рлЗрк░рлЛ, ркнркпркнрлАркд, ркнркпркорк╛ркВ ркЪрлАрк╕рлЛ рккрк╛ркбркдрлЛ ркЪрк╣рлЗрк░рлЛ, ркнркпркорк╛ркВ ркЪрлАрк╕рлЛ рккрк╛ркбрк╡рлА
ЁЯШ│ => ЁЯШ│, ркЪрк╣рлЗрк░рлЛ, рклрлНрк▓рк╢рлНркб, рклрлНрк▓рк╢рлНркб ркЪрк╣рлЗрк░рлЛ, рк╕рлНркдркмрлНркз, рк╕рлНркдркмрлНркз ркЪрк╣рлЗрк░рлЛ, рк╕рлНркдркмрлНркзркдрк╛ркорк╛ркВ
ЁЯдк => ЁЯдк, ркЙркирлНркоркдрлНркд ркЪрк╣рлЗрк░рлЛ
ЁЯШ╡ => ЁЯШ╡, ркЪркХрлНркХрк░, ркЪркХрлНркХрк░ ркЖрк╡ркдрлЛ ркЪрк╣рлЗрк░рлЛ, ркЪрк╣рлЗрк░рлЛ
ЁЯШб => ЁЯШб, ркЧрлБрк╕рлНрк╕рлЗрк▓, ркЪрк╣рлЗрк░рлЛ, рккрк╛ркЧрк▓, рк░рк┐рк╕рк╛рк╡рлБркВ, рк▓рк╛рк▓ ркЪрк╣рлЗрк░рлЛ, рк▓рк╛рк▓ рк░рк┐рк╕рк╛ркпрлЗрк▓рлЛ ркЪрк╣рлЗрк░рлЛ
ЁЯШа => ЁЯШа, ркЧрлБрк╕рлНрк╕рлЗрк▓, ркЧрлБрк╕рлНрк╕рлЗрк▓ ркЪрк╣рлЗрк░рлЛ, ркЪрк╣рлЗрк░рлЛ, рккрк╛ркЧрк▓
ЁЯдм => ЁЯдм, ркорлБркЦ рккрк░ ркЪрк┐рк╣рлНркирлЛ рк╕рк╛ркерлЗркирлЛ ркЪрк╣рлЗрк░рлЛ
ЁЯШ╖ => ЁЯШ╖, ркЪрк╣рлЗрк░рлЛ, ркаркВркбрлЛ, ркдркмрлАркмрлА ркорк╛рк╕рлНркХ, ркорк╛рк╕рлНркХ, ркорк╛рк╕рлНркХрк╡рк╛рк│рлЛ ркЪрк╣рлЗрк░рлЛ, рк╣рк╡рк╛ркорк╛рки рк╣рлЗркарк│
ЁЯдТ => ЁЯдТ, ркЪрк╣рлЗрк░рлЛ, ркерк░рлНркорлЛркорлАркЯрк░, ркерк░рлНркорлЛркорлАркЯрк░ рк╕рк╛ркерлЗркирлЛ ркЪрк╣рлЗрк░рлЛ, ркмрлАркорк╛рк░, ркорк╛ркВркжрлБркВ, ркорлБркЦ
ЁЯдХ => ЁЯдХ, ркИркЬрк╛, ркШрк╛, ркЪрк╣рлЗрк░рлЛ, рккркЯрлНркЯрлА, ркорк╛ркерлЗ рккркЯрлНркЯрлАрк╡рк╛рк│рлЛ ркЪрк╣рлЗрк░рлЛ, ркорлБркЦ
ЁЯдв => ЁЯдв, ркКрк▓ркЯрлА, ркЪрк╣рлЗрк░рлЛ, ркЪрлАркдрк░рлА ркЪркбрлЗрк▓рлЛ, ркЪрлАркдрк░рлА ркЪркбрлЗрк▓рлЛ ркЪрк╣рлЗрк░рлЛ
ЁЯдо => ЁЯдо, ркЙрк▓ркЯрлА ркХрк░ркдрлЛ ркЪрк╣рлЗрк░рлЛ
ЁЯдз => ЁЯдз, ркЪрк╣рлЗрк░рлЛ, ркЫрлАркВркХ, ркЫрлАркВркХ ркЦрк╛ркдрлЛ ркЪрк╣рлЗрк░рлЛ
ЁЯШЗ => ЁЯШЗ, ркЪрк╣рлЗрк░рлЛ, рккрлНрк░ркнрк╛рк╡рк▓ркп, рккрлНрк░ркнрк╛рк╡рк▓ркп рк╕рк╛ркерлЗркирлБркВ рк╣рк╛рк╕рлНркп, рккрлНрк░ркнрк╛рк╡рк▓ркп рк╕рк╛ркерлЗркирлЛ рк╕рлНркорк┐ркд ркХрк░ркдрлЛ ркЪрк╣рлЗрк░рлЛ, ркорлБркЦ, рк╣рк╛рк╕рлНркп
ЁЯда => ЁЯда, ркХрк╛ркЙркЧрк░рлНрк▓, ркХрк╛ркЙркмрлЙркп, ркХрк╛ркЙркмрлЙркп рк╣рлЕркЯрк╡рк╛рк│рлЛ ркЪрк╣рлЗрк░рлЛ, ркЪрк╣рлЗрк░рлЛ, рк╣рлЕркЯ
ЁЯдб => ЁЯдб, ркЪрк╣рлЗрк░рлЛ, рк╡рк┐ркжрлВрк╖ркХ, рк╡рк┐ркжрлВрк╖ркХрк╡рк╛рк│рлЛ ркЪрк╣рлЗрк░рлЛ
ЁЯде => ЁЯде, ркЦрлЛркЯрлБркВ, ркЦрлЛркЯрлБркВ ркмрлЛрк▓рк╡рк╛рк╡рк╛рк│рлЛ ркЪрк╣рлЗрк░рлЛ, ркЪрк╣рлЗрк░рлЛ
ЁЯдл => ЁЯдл, ркЪрлВркк ркХрк░ркдрлЛ ркЪрк╣рлЗрк░рлЛ
ЁЯдн => ЁЯдн, ркорлЛркВ рккрк░ рк╣рк╛рке ркорлВркХрлЗрк▓рлЛ ркЪрк╣рлЗрк░рлЛ
ЁЯзР => ЁЯзР, ркорлЛркирлЛркХрк▓ рк╕рк╛ркерлЗ ркЪрк╣рлЗрк░рлЛ
ЁЯдУ => ЁЯдУ, ркЪрк╣рлЗрк░рлЛ, ркнрлЛрк│рккркг, ркнрлЛрк│рккркгркирк╛ ркнрк╛рк╡рк╡рк╛рк│рлЛ ркЪрк╣рлЗрк░рлЛ, ркорлБркЦ, ркорлБрк░рлНркЦркдрк╛ркирк╛ ркнрк╛рк╡рк╡рк╛рк│рлЛ ркЪрк╣рлЗрк░рлЛ
ЁЯШИ => ЁЯШИ, ркЪрк╣рлЗрк░рлЛ, рк╢рк┐ркВркЧркбрк╛, рк╢рк┐ркВркЧркбрк╛ рк╕рк╛ркерлЗркирлБркВ рк╣рк╛рк╕рлНркп, рк╢рк┐ркВркЧркбрк╛ рк╕рк╛ркерлЗркирлЛ рк╕рлНркорк┐ркд ркХрк░ркдрлЛ ркЪрк╣рлЗрк░рлЛ, рк╣рк╛рк╕рлНркп
ЁЯС┐ => ЁЯС┐, imp, ркЪрк╣рлЗрк░рлЛ, ркирк╛ркирлЛ рк╢рлЗркдрк╛рки, рк╢рлЗркдрк╛рки
ЁЯС╣ => ЁЯС╣, ркУркирлА, ркЪрк╣рлЗрк░рлЛ, ркЬрк╛рккрк╛ркирлА ркжрлИркдрлНркп, ркжрлИркдрлНркп, рккрк░рлА ркХркерк╛, рк░рк╛ркХрлНрк╖рк╕
ЁЯС║ => ЁЯС║, ркЪрк╣рлЗрк░рлЛ, ркЬрк╛рккрк╛ркирлА рккрлНрк░рлЗркд, ркЯрлЗркирлНркЧрлБ, рккрк░рлА ркХркерк╛, рккрлНрк░рлЗркд, рк░рк╛ркХрлНрк╖рк╕
ЁЯТА => ЁЯТА, ркЦрлЛрккрк░рлА, ркЪрк╣рлЗрк░рлЛ, рккрк░рлА ркХркерк╛, рк╢рк░рлАрк░
тШа => тШа, ркЦрлЛрккрк░рлА ркЕркирлЗ рк╣рк╛ркбркХрк╛ркВркирлА ркЪрлЛркХркбрлА, ркЪрк╣рлЗрк░рлЛ, ркжрлИркдрлНркп, ркорлБркЦ, ркорлГркдрлНркпрлБ, рк░рк╛ркХрлНрк╖рк╕, рк╢рк░рлАрк░
ЁЯС╗ => ЁЯС╗, ркЪрк╣рлЗрк░рлЛ, рккрк░рлА ркХркерк╛, ркнрлВркд
ЁЯС╜ => ЁЯС╜, UFO, ркЪрк╣рлЗрк░рлЛ, рккрк░ркЧрлНрк░рк╣рк╡рк╛рк╕рлА, рккрк░рлА ркХркерк╛, рккрлГркерлНрк╡рлА ркмрк╣рк╛рк░ркирк╛ркВ
ЁЯС╛ => ЁЯС╛, UFO, ркЪрк╣рлЗрк░рлЛ, рккрк░ркЧрлНрк░рк╣рк╡рк╛рк╕рлА рк░рк╛ркХрлНрк╖рк╕, рккрк░рлА ркХркерк╛, рк░рк╛ркХрлНрк╖рк╕
ЁЯдЦ => ЁЯдЦ, ркЪрк╣рлЗрк░рлЛ, ркорк╢рлАркирлА ркорк╛ркирк╡, ркорлБркЦ, рк░рлЛркмрлЛркЯ, рк░рлЛркмрлЛркЯркирлЛ ркЪрк╣рлЗрк░рлЛ
ЁЯТй => ЁЯТй, ркЦрлВркВркЯрлЛ, ркЫрк╛ркг, рккрлВркк
ЁЯШ║ => ЁЯШ║, ркЦрлБрк▓рлНрк▓рк╛ ркорлЛркврлЗ рк╣рк╕ркдрлА ркмрк┐рк▓рк╛ркбрлАркирлЛ ркЪрк╣рлЗрк░рлЛ, ркЦрлБрк▓рлНрк▓рлБркВ, ркЦрлБрк▓рлНрк▓рлБркВ ркорлЛркВркврлБркВ, ркЪрк╣рлЗрк░рлЛ, ркмрк┐рк▓рк╛ркбрлА, ркмрк┐рк▓рк╛ркбрлАркирлЛ ркЪрк╣рлЗрк░рлЛ, ркорлЛркВркврлБркВ, рк╕рлНркорк┐ркд ркХрк░ркдрлА ркмрк┐рк▓рк╛ркбрлАркирлЛ ркЪрк╣рлЗрк░рлЛ
ЁЯШ╕ => ЁЯШ╕, ркЪрк╣рлЗрк░рлЛ, ркмрк┐рк▓рк╛ркбрлА, ркмрк┐рк▓рк╛ркбрлАркирлЛ ркЪрк╣рлЗрк░рлЛ, рк╣рк╕ркдрлА, рк╣рк╕ркдрлА ркЖркВркЦрлЛ ркЕркирлЗ ркЕркЯрлНркЯрк╣рк╛рк╕рлНркп рк╕рк╛ркерлЗркирлЛ ркмрк┐рк▓рк╛ркбрлАркирлЛ ркЪрк╣рлЗрк░рлЛ, рк╣рк╕ркдрлА ркЖркВркЦрлЛ ркЕркирлЗ рк╣рк╕рк╡рк╛ рк╕рк╛ркерлЗркирлЛ ркмрк┐рк▓рк╛ркбрлАркирлЛ ркЪрк╣рлЗрк░рлЛ, рк╣рк╕ркдрлА ркмрк┐рк▓рк╛ркбрлАркирлЛ ркЪрк╣рлЗрк░рлЛ
ЁЯШ╣ => ЁЯШ╣, ркЖркиркВркжрк╛рк╢рлНрк░рлБ, ркЖркиркВркжрк╛рк╢рлНрк░рлБ рк╕рк╛ркерлЗркирлЛ ркмрк┐рк▓рк╛ркбрлАркирлЛ ркЪрк╣рлЗрк░рлЛ, ркЪрк╣рлЗрк░рлЛ, ркмрк┐рк▓рк╛ркбрлА, ркмрк┐рк▓рк╛ркбрлАркирлЛ ркЪрк╣рлЗрк░рлЛ
ЁЯШ╗ => ЁЯШ╗, ркЖркВркЦрлЛ, ркЪрк╣рлЗрк░рлЛ, рккрлНрк░рлЗрко, рккрлНрк░рлЗркоркорк╛ркВ, ркмрк┐рк▓рк╛ркбрлА, ркмрк┐рк▓рк╛ркбрлАркирлЛ ркЪрк╣рлЗрк░рлЛ, рк╕рлНркорк┐ркд ркХрк░ркдрлА ркмрк┐рк▓рк╛ркбрлАркирлЛ ркЪрк╣рлЗрк░рлЛ, рк╣рлГркжркп, рк╣рлГркжркпрк╛ркХрк╛рк░ ркЖркВркЦрлЛ рк╕рк╛ркерлЗ рк╣рк╕ркдрлА ркмрк┐рк▓рк╛ркбрлАркирлЛ ркЪрк╣рлЗрк░рлЛ
ЁЯШ╝ => ЁЯШ╝, ркЪрк╣рлЗрк░рлЛ, ркмрк┐рк▓рк╛ркбрлА, ркмрк┐рк▓рк╛ркбрлАркирлЛ ркЪрк╣рлЗрк░рлЛ, ркорк╛рк░рлНркорк┐ркХ рк╣рк╛рк╕рлНркп, рк╡рлНркпркВркЧрккрлВрк░рлНркг, рк╡рлНркпркВркЧрккрлВрк░рлНркг ркмрк┐рк▓рк╛ркбрлАркирлЛ ркЪрк╣рлЗрк░рлЛ, рк╡рлНркпркВркЧрккрлВрк░рлНркг рк╕рлНркорк┐ркд рк╕рк╛ркерлЗркирлЛ ркмрк┐рк▓рк╛ркбрлАркирлЛ ркЪрк╣рлЗрк░рлЛ
ЁЯШ╜ => ЁЯШ╜, ркЖркВркЦрлЛ, ркЪрк╣рлЗрк░рлЛ, ркЪрлБркВркмрки, ркЪрлБркВркмрки ркХрк░ркдрлА, ркЪрлБркВркмрки ркХрк░ркдрлА ркмрк┐рк▓рк╛ркбрлА, ркмркВркз, ркмркВркз ркЖркВркЦрлЛ, ркмркВркз ркЖркВркЦрлЛ рк╕рк╛ркерлЗ ркЪрлБркВркмрки ркХрк░ркдрлЛ ркмрк┐рк▓рк╛ркбрлАркирлЛ ркЪрк╣рлЗрк░рлЛ, ркмрк┐рк▓рк╛ркбрлА
ЁЯЩА => ЁЯЩА, ркХркВркЯрк╛рк│рк╛ркЬркиркХ ркмрк┐рк▓рк╛ркбрлАркирлЛ ркЪрк╣рлЗрк░рлЛ, ркЦрк░рлЗркЦрк░ ркЖрк╢рлНркЪрк░рлНркпркЪркХрк┐ркд, ркЪрк╣рлЗрк░рлЛ, рккрк░рлЗрк╢рк╛рки ркеркпрлЗрк▓ ркмрк┐рк▓рк╛ркбрлАркирлЛ ркЪрк╣рлЗрк░рлЛ, ркмрк┐рк▓рк╛ркбрлА, рк╣рлЗ ркнркЧрк╡рк╛рки
ЁЯШ┐ => ЁЯШ┐, ркЪрк╣рлЗрк░рлЛ, ркмрк┐рк▓рк╛ркбрлА, ркмрк┐рк▓рк╛ркбрлАркирлЛ ркЪрк╣рлЗрк░рлЛ, рк░ркбркдрлА ркмрк┐рк▓рк╛ркбрлАркирлЛ ркЪрк╣рлЗрк░рлЛ, рк░ркбрк╡рлБркВ, рк░рлБркжрки
ЁЯШ╛ => ЁЯШ╛, ркЪрк╣рлЗрк░рлЛ, ркмрк┐рк▓рк╛ркбрлА, ркмрк┐рк▓рк╛ркбрлАркирлЛ ркЪрк╣рлЗрк░рлЛ, рк░рк┐рк╕рк╛ркпрлЗрк▓ ркмрк┐рк▓рк╛ркбрлАркирлЛ ркЪрк╣рлЗрк░рлЛ, рк░рк┐рк╕рк╛рк╡рлБркВ
ЁЯЩИ => ЁЯЩИ, ркЦрк░рк╛ркм ркЬрлЛрк╢рлЛ ркирк╣рлАркВ, ркЦрк░рк╛ркм ркЬрлЛрк╢рлЛ ркирк╣рлАркВ ркмркдрк╛рк╡ркдрлЛ рк╡рк╛ркВркжрк░рлЛ, рк╡рк╛ркВркжрк░рлЛ
ЁЯЩЙ => ЁЯЩЙ, ркЦрк░рк╛ркм рк╕рк╛ркВркнрк│рк╢рлЛ ркирк╣рлАркВ, ркЦрк░рк╛ркм рк╕рк╛ркВркнрк│рк╢рлЛ ркирк╣рлАркВ ркмркдрк╛рк╡ркдрлЛ рк╡рк╛ркВркжрк░рлЛ, рк╡рк╛ркВркжрк░рлЛ
ЁЯЩК => ЁЯЩК, ркЦрк░рк╛ркм ркмрлЛрк▓рк╢рлЛ ркирк╣рлАркВ, ркЦрк░рк╛ркм ркмрлЛрк▓рк╢рлЛ ркирк╣рлАркВ ркмркдрк╛рк╡ркдрлЛ рк╡рк╛ркВркжрк░рлЛ, рк╡рк╛ркВркжрк░рлЛ
ЁЯС╢ => ЁЯС╢, рк▓рлЛркХрлЛ, рк╢рк┐рк╢рлБ
ЁЯзТ => ЁЯзТ, ркмрк╛рк│ркХ
ЁЯСж => ЁЯСж, ркЫрлЛркХрк░рлЛ, рк▓рлЛркХрлЛ
ЁЯСз => ЁЯСз, ркЫрлЛркХрк░рлА, рк▓рлЛркХрлЛ
ЁЯзС => ЁЯзС, рккрлБркЦрлНркд
ЁЯСи => ЁЯСи, рккрлБрк░рлБрк╖, рк▓рлЛркХрлЛ
ЁЯСй => ЁЯСй, рк▓рлЛркХрлЛ, рк╕рлНркдрлНрк░рлА
ЁЯзУ => ЁЯзУ, рк╡рлГркжрлНркз рккрлБркЦрлНркд
ЁЯС┤ => ЁЯС┤, ркШрк░ркбрлЛ, ркШрк░ркбрлЛ рккрлБрк░рлБрк╖, рккрлБрк░рлБрк╖, рк▓рлЛркХрлЛ, рк╡рлГркжрлНркз рккрлБрк░рлБрк╖
ЁЯС╡ => ЁЯС╡, ркШрк░ркбрлА, ркШрк░ркбрлА рк╕рлНркдрлНрк░рлА, рк▓рлЛркХрлЛ, рк╡рлГркжрлНркз рк╕рлНркдрлНрк░рлА, рк╕рлНркдрлНрк░рлА
ЁЯСитАНтЪХ => ЁЯСитАНтЪХ, ркЖрк░рлЛркЧрлНркпрк╕ркВркнрк╛рк│, ркЙрккркЪрк╛рк░ркХ, ркбрлЙркХрлНркЯрк░, ркирк░рлНрк╕, рккрлБрк░рлБрк╖, рккрлБрк░рлБрк╖ ркЖрк░рлЛркЧрлНркп ркХрк╛рк░рлНркпркХрк░рлНркдрк╛
ЁЯСйтАНтЪХ => ЁЯСйтАНтЪХ, ркЖрк░рлЛркЧрлНркпрк╕ркВркнрк╛рк│, ркЙрккркЪрк╛рк░ркХ, ркбрлЙркХрлНркЯрк░, ркирк░рлНрк╕, рк╕рлНркдрлНрк░рлА, рк╕рлНркдрлНрк░рлА ркЖрк░рлЛркЧрлНркп ркХрк╛рк░рлНркпркХрк░рлНркдрк╛
ЁЯСитАНЁЯОУ => ЁЯСитАНЁЯОУ, рккрлБрк░рлБрк╖, рк╡рк┐ркжрлНркпрк╛рк░рлНркерлА, рк╕рлНркирк╛ркдркХ
ЁЯСйтАНЁЯОУ => ЁЯСйтАНЁЯОУ, рк╡рк┐ркжрлНркпрк╛рк░рлНркерк┐ркирлА, рк╕рлНркдрлНрк░рлА, рк╕рлНркирк╛ркдркХ
ЁЯСитАНЁЯПл => ЁЯСитАНЁЯПл, ркЕркзрлНркпрк╛рккркХ, рккрлБрк░рлБрк╖, ркорк╛рк╕рлНркЯрк░, рк╢рк┐ркХрлНрк╖ркХ
ЁЯСйтАНЁЯПл => ЁЯСйтАНЁЯПл, ркЕркзрлНркпрк╛рккркХ, ркорк╛рк╕рлНркЯрк░, рк╢рк┐ркХрлНрк╖ркХ, рк╢рк┐ркХрлНрк╖рк┐ркХрк╛, рк╕рлНркдрлНрк░рлА
ЁЯСитАНтЪЦ => ЁЯСитАНтЪЦ, ркдрк░рк╛ркЬрлБ, ркирлНркпрк╛ркп, ркирлНркпрк╛ркпрк╛ркзрлАрк╢, рккрлБрк░рлБрк╖
ЁЯСйтАНтЪЦ => ЁЯСйтАНтЪЦ, ркдрк░рк╛ркЬрлБ, ркирлНркпрк╛ркп, рк╕рлНркдрлНрк░рлА, рк╕рлНркдрлНрк░рлА ркирлНркпрк╛ркпрк╛ркзрлАрк╢
ЁЯСитАНЁЯМ╛ => ЁЯСитАНЁЯМ╛, ркЦрлЗркбрлВркд, рккрлБрк░рлБрк╖, ркорк╛рк▓рлА
ЁЯСйтАНЁЯМ╛ => ЁЯСйтАНЁЯМ╛, ркЦрлЗркбрлВркд, рк╕рлНркдрлНрк░рлА, рк╕рлНркдрлНрк░рлА ркЦрлЗркбрлВркд
ЁЯСитАНЁЯН│ => ЁЯСитАНЁЯН│, рккрлБрк░рлБрк╖, ркорк╣рк╛рк░рк╛ркЬ, рк░рк╕рлЛркЗркпрлЛ, рк░рк╛ркВркзрк╡рлБркВ
ЁЯСйтАНЁЯН│ => ЁЯСйтАНЁЯН│, рк░рк╕рлЛркпркг, рк░рк╛ркВркзрк╡рлБркВ, рк╕рлНркдрлНрк░рлА
ЁЯСитАНЁЯФз => ЁЯСитАНЁЯФз, ркЗрк▓рлЗркХрлНркЯрлНрк░рк┐рк╢рки, ркХрк╛рк░рлАркЧрк░, рккрлБрк░рлБрк╖, рккрлНрк▓ркорлНркмрк░, ркорлЗркХрлЕркирк┐ркХ
ЁЯСйтАНЁЯФз => ЁЯСйтАНЁЯФз, ркЗрк▓рлЗркХрлНркЯрлНрк░рк┐рк╢рки, рккрлНрк▓ркорлНркмрк░, ркорлЗркХрлЕркирк┐ркХ, рк╕рлНркдрлНрк░рлА, рк╕рлНркдрлНрк░рлА ркорлЗркХрлЕркирк┐ркХ
ЁЯСитАНЁЯПн => ЁЯСитАНЁЯПн, ркФркжрлНркпрлЛркЧрк┐ркХ, ркХрк╛рк░рлНркпркХрк░рлНркдрк╛, рккрлБрк░рлБрк╖, рккрлБрк░рлБрк╖ рклрлЕркХрлНркЯрк░рлА ркХрк╛рк░рлНркпркХрк░рлНркдрк╛, рклрлЕркХрлНркЯрк░рлА, ркоркВркбрк▓рлА
ЁЯСйтАНЁЯПн => ЁЯСйтАНЁЯПн, ркФркжрлНркпрлЛркЧрк┐ркХ, ркХрк╛рк░рлНркпркХрк░рлНркдрк╛, рклрлЕркХрлНркЯрк░рлА, ркоркВркбрк▓рлА, рк╕рлНркдрлНрк░рлА, рк╕рлНркдрлНрк░рлА рклрлЕркХрлНркЯрк░рлА ркХрк╛рк░рлНркпркХрк░рлНркдрк╛
ЁЯСитАНЁЯТ╝ => ЁЯСитАНЁЯТ╝, ркЖрк░рлНркХрк┐ркЯрлЗркХрлНркЯ, ркСрклрк┐рк╕, рккрлБрк░рлБрк╖, рккрлБрк░рлБрк╖ ркСрклрк┐рк╕ ркХрк╛рк░рлНркпркХрк░рлНркдрк╛, рк╡рлНркпрк╡рк╕рк╛ркп, рк╕ркВркЪрк╛рк▓ркХ
ЁЯСйтАНЁЯТ╝ => ЁЯСйтАНЁЯТ╝, ркЖрк░рлНркХрк┐ркЯрлЗркХрлНркЯ, ркСрклрк┐рк╕, рк╡рлНркпрк╡рк╕рк╛ркп, рк╕ркВркЪрк╛рк▓ркХ, рк╕рлНркдрлНрк░рлА, рк╕рлНркдрлНрк░рлА ркСрклрк┐рк╕ ркХрк╛рк░рлНркпркХрк░рлНркдрк╛
ЁЯСитАНЁЯФм => ЁЯСитАНЁЯФм, ркПркирлНркЬрк┐ркирк┐ркЕрк░, ркЧркгрк┐ркдрк╢рк╛рк╕рлНркдрлНрк░рлА, ркЬрлАрк╡рк╡рк┐ркЬрлНркЮрк╛ркирлА, рккрлБрк░рлБрк╖, рккрлБрк░рлБрк╖ рк╡рлИркЬрлНркЮрк╛ркирк┐ркХ, ркнрлМркдрк┐ркХрк╡рк┐ркЬрлНркЮрк╛ркирлА, рк░рк╕рк╛ркпркгрк╢рк╛рк╕рлНркдрлНрк░рлА, рк╡рлИркЬрлНркЮрк╛ркирк┐ркХ
ЁЯСйтАНЁЯФм => ЁЯСйтАНЁЯФм, ркПркирлНркЬрк┐ркирк┐ркЕрк░, ркЧркгрк┐ркдрк╢рк╛рк╕рлНркдрлНрк░рлА, ркЬрлАрк╡рк╡рк┐ркЬрлНркЮрк╛ркирлА, ркнрлМркдрк┐ркХрк╡рк┐ркЬрлНркЮрк╛ркирлА, рк░рк╕рк╛ркпркгрк╢рк╛рк╕рлНркдрлНрк░рлА, рк╡рлИркЬрлНркЮрк╛ркирк┐ркХ, рк╕рлНркдрлНрк░рлА, рк╕рлНркдрлНрк░рлА рк╡рлИркЬрлНркЮрк╛ркирк┐ркХ
ЁЯСитАНЁЯТ╗ => ЁЯСитАНЁЯТ╗, ркХрлЛркбрк░, ркЯрлЗркХрлНркирлЙрк▓рлЛркЬрк┐рк╕рлНркЯ, рккрлБрк░рлБрк╖, рккрлБрк░рлБрк╖ ркЯрлЗркХрлНркирлЙрк▓рлЛркЬрк┐рк╕рлНркЯ, рк╡рк┐ркХрк╛рк╕ркХрк░рлНркдрк╛, рк╢рлЛркзркХ, рк╕рлЛрклрлНркЯрк╡рлЗрк░
ЁЯСйтАНЁЯТ╗ => ЁЯСйтАНЁЯТ╗, ркХрлЛркбрк░, ркЯрлЗркХрлНркирлЙрк▓рлЛркЬрк┐рк╕рлНркЯ, рк╡рк┐ркХрк╛рк╕ркХрк░рлНркдрк╛, рк╢рлЛркзркХ, рк╕рлЛрклрлНркЯрк╡рлЗрк░, рк╕рлНркдрлНрк░рлА, рк╕рлНркдрлНрк░рлА ркЯрлЗркХрлНркирлЙрк▓рлЛркЬрк┐рк╕рлНркЯ
ЁЯСитАНЁЯОд => ЁЯСитАНЁЯОд, ркЕркнрк┐ркирлЗркдрк╛, ркЧрк╛ркпркХ, рккрлБрк░рлБрк╖, ркоркирлЛрк░ркВркЬркиркХрк░рлНркдрк╛, рк░рлЙркХ, рк╕рлНркЯрк╛рк░
ЁЯСйтАНЁЯОд => ЁЯСйтАНЁЯОд, ркЕркнрк┐ркирлЗркдрк╛, ркЧрк╛ркпрк┐ркХрк╛, ркоркирлЛрк░ркВркЬркиркХрк░рлНркдрк╛, рк░рлЙркХ, рк╕рлНркЯрк╛рк░, рк╕рлНркдрлНрк░рлА
ЁЯСитАНЁЯОи => ЁЯСитАНЁЯОи, ркХрк▓рк╛ркХрк╛рк░, ркЪрк┐ркдрлНрк░ркХрк╛рк░, рккрлБрк░рлБрк╖, рккрлБрк░рлБрк╖ ркХрк▓рк╛ркХрк╛рк░
ЁЯСйтАНЁЯОи => ЁЯСйтАНЁЯОи, ркХрк▓рк╛ркХрк╛рк░, ркЪрк┐ркдрлНрк░ркХрк╛рк░, рк╕рлНркдрлНрк░рлА, рк╕рлНркдрлНрк░рлА ркХрк▓рк╛ркХрк╛рк░
ЁЯСитАНтЬИ => ЁЯСитАНтЬИ, рккрк╛ркЗрк▓ркЯ, рккрлБрк░рлБрк╖, рккрлБрк░рлБрк╖ рккрк╛ркЗрк▓ркЯ, рк╡рк┐ркорк╛рки
ЁЯСйтАНтЬИ => ЁЯСйтАНтЬИ, рккрк╛ркЗрк▓ркЯ, рк╡рк┐ркорк╛рки, рк╕рлНркдрлНрк░рлА, рк╕рлНркдрлНрк░рлА рккрк╛ркЗрк▓ркЯ
ЁЯСитАНЁЯЪА => ЁЯСитАНЁЯЪА, ркЕрк╡ркХрк╛рк╢, ркЕрк╡ркХрк╛рк╢ркпрк╛ркдрлНрк░рлА, рккрлБрк░рлБрк╖, рккрлБрк░рлБрк╖ ркЕрк╡ркХрк╛рк╢ркпрк╛ркдрлНрк░рлА, рк░рлЙркХрлЗркЯ
ЁЯСйтАНЁЯЪА => ЁЯСйтАНЁЯЪА, ркЕрк╡ркХрк╛рк╢, ркЕрк╡ркХрк╛рк╢ркпрк╛ркдрлНрк░рлА, рк░рлЙркХрлЗркЯ, рк╕рлНркдрлНрк░рлА, рк╕рлНркдрлНрк░рлА ркЕрк╡ркХрк╛рк╢ркпрк╛ркдрлНрк░рлА
ЁЯСитАНЁЯЪТ => ЁЯСитАНЁЯЪТ, ркЕркЧркирк┐рк╢рк╛ркоркХ, рккрлБрк░рлБрк╖, рккрлБрк░рлБрк╖ ркЕркЧркирк┐рк╢рк╛ркоркХ
ЁЯСйтАНЁЯЪТ => ЁЯСйтАНЁЯЪТ, ркЕркЧркирк┐рк╢рк╛ркоркХ, рк╕рлНркдрлНрк░рлА, рк╕рлНркдрлНрк░рлА ркЕркЧркирк┐рк╢рк╛ркоркХ
ЁЯСо => ЁЯСо, ркЕркзрк┐ркХрк╛рк░рлА, рккрлЛрк▓рлАрк╕, рккрлЛрк▓рлАрк╕ ркЕркзрк┐ркХрк╛рк░рлА, рк▓рлЛркХрлЛ
ЁЯСотАНтЩВ => ЁЯСотАНтЩВ, ркЕркзрк┐ркХрк╛рк░рлА, рккрлБрк░рлБрк╖, рккрлБрк░рлБрк╖ рккрлЛрк▓рлАрк╕, рккрлЛрк▓рлАрк╕
ЁЯСотАНтЩА => ЁЯСотАНтЩА, ркЕркзрк┐ркХрк╛рк░рлА, рккрлЛрк▓рлАрк╕, рк╕рлНркдрлНрк░рлА, рк╕рлНркдрлНрк░рлА рккрлЛрк▓рлАрк╕
ЁЯХ╡ => ЁЯХ╡, ркЧрлБрккрлНркдркЪрк░, ркЫрлВрккрлА рккрлЛрк▓рлАрк╕ркирлЛ ркорк╛ркгрк╕, ркЬрк╛рк╕рлВрк╕, ркбрк┐ркЯрлЗркХрлНркЯрк┐рк╡
ЁЯХ╡тАНтЩВ => ЁЯХ╡тАНтЩВ, ркЧрлБрккрлНркдркЪрк░, ркЬрк╛рк╕рлВрк╕, рккрлБрк░рлБрк╖
ЁЯХ╡тАНтЩА => ЁЯХ╡тАНтЩА, ркЧрлБрккрлНркдркЪрк░, ркЬрк╛рк╕рлВрк╕, рк╕рлНркдрлНрк░рлА, рк╕рлНркдрлНрк░рлА ркЬрк╛рк╕рлВрк╕
ЁЯТВ => ЁЯТВ, ркЪрлЛркХрлАркжрк╛рк░, рк▓рлЛркХрлЛ, рк╕рлБрк░ркХрлНрк╖рк╛ркХрк░рлНркорлА
ЁЯТВтАНтЩВ => ЁЯТВтАНтЩВ, ркЪрлЛркХрлАркжрк╛рк░, рккрлБрк░рлБрк╖, рк╕рлБрк░ркХрлНрк╖рк╛ркХрк░рлНркорлА рккрлБрк░рлБрк╖
ЁЯТВтАНтЩА => ЁЯТВтАНтЩА, ркЪрлЛркХрлАркжрк╛рк░, рк╕рлБрк░ркХрлНрк╖рк╛ркХрк░рлНркорлА рк╕рлНркдрлНрк░рлА, рк╕рлНркдрлНрк░рлА
ЁЯС╖ => ЁЯС╖, ркХрк╛рк░рлАркЧрк░, ркмрк╛ркВркзркХрк╛рко, ркмрк╛ркВркзркХрк╛рко ркХрк╛рк░рлАркЧрк░, рк▓рлЛркХрлЛ
ЁЯС╖тАНтЩВ => ЁЯС╖тАНтЩВ, ркХрк╛рк░рлАркЧрк░, рккрлБрк░рлБрк╖, рккрлБрк░рлБрк╖ ркмрк╛ркВркзркХрк╛рко ркХрк╛рк░рлАркЧрк░, ркмрк╛ркВркзркХрк╛рко
ЁЯС╖тАНтЩА => ЁЯС╖тАНтЩА, ркХрк╛рк░рлАркЧрк░, ркмрк╛ркВркзркХрк╛рко, рк╕рлНркдрлНрк░рлА, рк╕рлНркдрлНрк░рлА ркмрк╛ркВркзркХрк╛рко ркХрк╛рк░рлАркЧрк░
ЁЯд┤ => ЁЯд┤, рк░рк╛ркЬркХрлБркорк╛рк░
ЁЯС╕ => ЁЯС╕, рккрк░рлА ркХркерк╛, рк░рк╛ркЬркХрлБркорк╛рк░рлА, рк▓рлЛркХрлЛ
ЁЯС│ => ЁЯС│, рккрк╛ркШркбрлА, рккрк╛ркШркбрлАрк╡рк╛рк│рлЛ рк╡рлНркпркХрлНркдрк┐, рккрлБрк░рлБрк╖, рк▓рлЛркХрлЛ
ЁЯС│тАНтЩВ => ЁЯС│тАНтЩВ, рккрк╛ркШркбрлА, рккрк╛ркШркбрлАрк╡рк╛рк│рлЛ рккрлБрк░рлБрк╖, рккрлБрк░рлБрк╖
ЁЯС│тАНтЩА => ЁЯС│тАНтЩА, рккрк╛ркШркбрлА, рккрк╛ркШркбрлА рк╡рк╛рк│рлА рк╕рлНркдрлНрк░рлА, рк╕рлНркдрлНрк░рлА
ЁЯС▓ => ЁЯС▓, ркЧрлБркЖ рккрлА ркорк╛ркУ, ркЧрлБркЖ рккрлА ркорк╛ркУ рк╕рк╛ркерлЗркирлЛ рккрлБрк░рлБрк╖, ркЪрлАркирлА ркЯрлЛрккрлА рк╕рк╛ркерлЗркирлЛ рккрлБрк░рлБрк╖, рккрлБрк░рлБрк╖, рк▓рлЛркХрлЛ
ЁЯзХ => ЁЯзХ, ркорк╛ркерк╛ркирк╛ рк╕рлНркХрк╛ркл рк╕рк╛ркерлЗ рк╕рлНркдрлНрк░рлА
ЁЯзФ => ЁЯзФ, ркжрк╛ркврлА рк╡рк╛рк│рлА рк╡рлНркпркХрлНркдрк┐
ЁЯС▒ => ЁЯС▒, рккрлАрк│рк╛рк╢ рккркбркдрк╛ркВ рк╡рк╛рк│рк╡рк╛рк│рлА рк╡рлНркпркХрлНркдрк┐, рк▓рлЛркХрлЛ
ЁЯС▒тАНтЩВ => ЁЯС▒тАНтЩВ, рккрлАрк│рк╛рк╢ рккркбркдрк╛ркВ рк╡рк╛рк│рк╡рк╛рк│рлЛ рккрлБрк░рлБрк╖, рккрлБрк░рлБрк╖, рк╕рлЛркирлЗрк░рлА рк╡рк╛рк│рк╡рк╛рк│рлБркВ
ЁЯС▒тАНтЩА => ЁЯС▒тАНтЩА, рккрлАрк│рк╛рк╢ рккркбркдрк╛ркВ рк╡рк╛рк│рк╡рк╛рк│рлА рк╕рлНркдрлНрк░рлА, рк╕рлЛркирлЗрк░рлА рк╡рк╛рк│рк╡рк╛рк│рлБркВ, рк╕рлНркдрлНрк░рлА
ЁЯд╡ => ЁЯд╡, ркЯркХрлНрк╕рлАркбрлЛ, ркЯркХрлНрк╕рлАркбрлЛ рккрк╣рлЗрк░рлЗрк▓рлЛ ркорк╛ркгрк╕, ркорк╛ркгрк╕, рк╡рк░рк░рк╛ркЬрк╛
ЁЯС░ => ЁЯС░, ркШрлВркВркШркЯ, ркШрлВркВркШркЯ ркдрк╛ркгрлЗрк▓рлА ркирк╡рк╡ркзрлБ, ркдрк╛ркгрлЗрк▓рлА ркирк╡рк╡ркзрлБ, ркирк╡рк╡ркзрлБ, рк▓рлЛркХрлЛ
ЁЯд░ => ЁЯд░, рк╕ркЧрк░рлНркнрк╛, рк╕ркЧрк░рлНркнрк╛ рк╕рлНркдрлНрк░рлА, рк╕рлНркдрлНрк░рлА
ЁЯд▒ => ЁЯд▒, рк╕рлНркдркирккрк╛рки
ЁЯС╝ => ЁЯС╝, ркЪрк╣рлЗрк░рлЛ, ркжрлЗрк╡ркжрлВркд, рккрк░рлА ркХркерк╛, ркмрк╛рк│ ркжрлЗрк╡ркжрлВркд
ЁЯОЕ => ЁЯОЕ, ркЙркЬрк╡ркгрлА, ркирк╛ркдрк╛рк▓, рклрк╛ркзрк░ ркХрлНрк░рк┐рк╕ркорк╕, рк╕рк╛ркВркдрк╛, рк╕рк╛ркВркдрк╛ ркХрлНрк▓рлЛркЭ
ЁЯд╢ => ЁЯд╢, ркХрлНрк░рк┐рк╕рлНркорк╕, ркоркзрк░, ркоркзрк░ ркХрлНрк░рк┐рк╕рлНркорк╕
ЁЯзЩ => ЁЯзЩ, ркорлЗркЬ
ЁЯзЩтАНтЩА => ЁЯзЩтАНтЩА, рк╕рлНркдрлНрк░рлА ркорлЗркЬ
ЁЯзЩтАНтЩВ => ЁЯзЩтАНтЩВ, рккрлБрк░рлБрк╖ ркорлЗркЬ
ЁЯзЪ => ЁЯзЪ, рккрк░рлА
ЁЯзЪтАНтЩА => ЁЯзЪтАНтЩА, рк╕рлНркдрлНрк░рлА рккрк░рлА
ЁЯзЪтАНтЩВ => ЁЯзЪтАНтЩВ, рккрлБрк░рлБрк╖ рккрк░рлА
ЁЯзЫ => ЁЯзЫ, рккрк┐ркЪрк╛рк╢
ЁЯзЫтАНтЩА => ЁЯзЫтАНтЩА, ркорк╣рк┐рк▓рк╛ рккрк┐рк╢рк╛ркЪ
ЁЯзЫтАНтЩВ => ЁЯзЫтАНтЩВ, рккрлБрк░рлБрк╖ рккрк┐ркЪрк╛рк╢
ЁЯзЬ => ЁЯзЬ, ркорк░рккрк░рлНрк╕рки
ЁЯзЬтАНтЩА => ЁЯзЬтАНтЩА, ркорк░ркорлЗркИркб
ЁЯзЬтАНтЩВ => ЁЯзЬтАНтЩВ, ркорк░ркорлЗрки
ЁЯзЭ => ЁЯзЭ, ркИрк▓рлНркл
ЁЯзЭтАНтЩА => ЁЯзЭтАНтЩА, рк╕рлНркдрлНрк░рлА ркИрк▓рлНркл
ЁЯзЭтАНтЩВ => ЁЯзЭтАНтЩВ, рккрлБрк░рлБрк╖ ркИрк▓рлНркл
ЁЯзЮ => ЁЯзЮ, ркЬрлАркирлА
ЁЯзЮтАНтЩА => ЁЯзЮтАНтЩА, рк╕рлНркдрлНрк░рлА ркЬрлАркирлА
ЁЯзЮтАНтЩВ => ЁЯзЮтАНтЩВ, рккрлБрк░рлБрк╖ ркЬрлАркирлА
ЁЯзЯ => ЁЯзЯ, ркЭрлЛркорлНркмрлА
ЁЯзЯтАНтЩА => ЁЯзЯтАНтЩА, рк╕рлНркдрлНрк░рлА ркЭрлЛркорлНркмрлА
ЁЯзЯтАНтЩВ => ЁЯзЯтАНтЩВ, рккрлБрк░рлБрк╖ ркЭрлЛркорлНркмрлА
ЁЯЩН => ЁЯЩН, ркнрк╡рк╛ркВ ркЪркбрк╛рк╡рк╡рк╛ркВ, ркнрк╡рк╛ркВ ркЪркбрк╛рк╡рлЗрк▓ рк╡рлНркпркХрлНркдрк┐, рк╡рлНркпркХрлНркдрк┐, рк╣рк╛рк╡ркнрк╛рк╡
ЁЯЩНтАНтЩВ => ЁЯЩНтАНтЩВ, рккрлБрк░рлБрк╖, ркнрк╡рк╛ркВ ркЪркбрк╛рк╡рк╡рк╛ркВ, ркнрк╡рк╛ркВ ркЪркбрк╛рк╡рк╡рк╛ркВрк╡рк╛рк│рлЛ рккрлБрк░рлБрк╖, рк╣рк╛рк╡ркнрк╛рк╡
ЁЯЩНтАНтЩА => ЁЯЩНтАНтЩА, ркнрк╡рк╛ркВ ркЪркбрк╛рк╡рк╡рк╛ркВ, ркнрк╡рк╛ркВ ркЪркбрк╛рк╡рк╡рк╛ркВрк╡рк╛рк│рлА рк╕рлНркдрлНрк░рлА, рк╕рлНркдрлНрк░рлА, рк╣рк╛рк╡ркнрк╛рк╡
ЁЯЩО => ЁЯЩО, рк░рк┐рк╕рк╛ркдрлА рк╡рлНркпркХрлНркдрк┐, рк░рк┐рк╕рк╛рк╡рлБркВ, рк╡рлНркпркХрлНркдрк┐, рк╣рк╛рк╡ркнрк╛рк╡
ЁЯЩОтАНтЩВ => ЁЯЩОтАНтЩВ, рккрлБрк░рлБрк╖, рк░рк┐рк╕рк╛ркпрлЗрк▓рлЛ рккрлБрк░рлБрк╖, рк░рк┐рк╕рк╛рк╡рлБркВ, рк╣рк╛рк╡ркнрк╛рк╡
ЁЯЩОтАНтЩА => ЁЯЩОтАНтЩА, рк░рк┐рк╕рк╛ркпрлЗрк▓рлА рк╕рлНркдрлНрк░рлА, рк░рк┐рк╕рк╛рк╡рлБркВ, рк╕рлНркдрлНрк░рлА, рк╣рк╛рк╡ркнрк╛рк╡
ЁЯЩЕ => ЁЯЩЕ, ркЪрк╣рлЗрк░рлЛ, ркирк╣рлАркВ, рккрлНрк░ркдрк┐ркмркВркзрк┐ркд, рк╕рк╛рк░рлБркВ ркиркерлА, рк╕рк╛рк░рлБркВ ркирк╣рлАркВркирлЛ рк╣рк╛рк╡ркнрк╛рк╡, рк╣рк╛рк╡ркнрк╛рк╡
ЁЯЩЕтАНтЩВ => ЁЯЩЕтАНтЩВ, ркЪрк╣рлЗрк░рлЛ, ркирк╣рлАркВ, рккрлБрк░рлБрк╖, рккрлНрк░ркдрк┐ркмркВркзрк┐ркд, рк╕рк╛рк░рлБркВ ркиркерлА, рк╕рк╛рк░рлБркВ ркирк╣рлАркВркирлЛ рк╣рк╛рк╡ркнрк╛рк╡ рккрлБрк░рлБрк╖, рк╣рк╛рк╡ркнрк╛рк╡
ЁЯЩЕтАНтЩА => ЁЯЩЕтАНтЩА, ркЪрк╣рлЗрк░рлЛ, ркирк╣рлАркВ, рккрлНрк░ркдрк┐ркмркВркзрк┐ркд, рк╕рк╛рк░рлБркВ ркиркерлА, рк╕рк╛рк░рлБркВ ркирк╣рлАркВркирлЛ рк╣рк╛рк╡ркнрк╛рк╡ рк╕рлНркдрлНрк░рлА, рк╕рлНркдрлНрк░рлА, рк╣рк╛рк╡ркнрк╛рк╡
ЁЯЩЖ => ЁЯЩЖ, ркСркХрлЗ рк╣рк╛рк╡ркнрк╛рк╡, ркСркХрлЗркирлЛ рк╣рк╛рк╡ркнрк╛рк╡, ркЪрк╣рлЗрк░рлЛ, ркмркзрлБркВ ркмрк░рк╛ркмрк░ ркЫрлЗ, рк╣рк╛рк╡ркнрк╛рк╡
ЁЯЩЖтАНтЩВ => ЁЯЩЖтАНтЩВ, ркСркХрлЗ рк╣рк╛рк╡ркнрк╛рк╡, ркЪрк╣рлЗрк░рлЛ, рккрлБрк░рлБрк╖, рккрлБрк░рлБрк╖ ркСркХрлЗркирлЛ рк╣рк╛рк╡ркнрк╛рк╡, ркмркзрлБркВ ркмрк░рк╛ркмрк░ ркЫрлЗ, рк╣рк╛рк╡ркнрк╛рк╡
ЁЯЩЖтАНтЩА => ЁЯЩЖтАНтЩА, ркСркХрлЗ рк╣рк╛рк╡ркнрк╛рк╡, ркЪрк╣рлЗрк░рлЛ, ркмркзрлБркВ ркмрк░рк╛ркмрк░ ркЫрлЗ, рк╕рлНркдрлНрк░рлА, рк╕рлНркдрлНрк░рлА, ркСркХрлЗркирлЛ рк╣рк╛рк╡ркнрк╛рк╡, рк╣рк╛рк╡ркнрк╛рк╡
ЁЯТБ => ЁЯТБ, ркорк╛рк╣рк┐ркдрлА, ркорк╛рк╣рк┐ркдрлА ркЖрккркдрлА рк╡рлНркпркХрлНркдрк┐, ркорк╛рк╣рк┐ркдрлА ркбрлЗрк╕рлНркХ, рк▓рлЛркХрлЛ, рк╕рк╣рк╛ркп
ЁЯТБтАНтЩВ => ЁЯТБтАНтЩВ, рккрлБрк░рлБрк╖, ркорк╛рк╣рк┐ркдрлА, ркорк╛рк╣рк┐ркдрлА ркЖрккркдрлЛ рккрлБрк░рлБрк╖, ркорк╛рк╣рк┐ркдрлА ркбрлЗрк╕рлНркХ, рк╕рк╣рк╛ркп
ЁЯТБтАНтЩА => ЁЯТБтАНтЩА, ркорк╛рк╣рк┐ркдрлА, ркорк╛рк╣рк┐ркдрлА ркЖрккркдрлА рк╕рлНркдрлНрк░рлА, ркорк╛рк╣рк┐ркдрлА ркбрлЗрк╕рлНркХ, рк╕рк╣рк╛ркп, рк╕рлНркдрлНрк░рлА
ЁЯЩЛ => ЁЯЩЛ, ркЙрккрк░ рк╣рк╛рке ркЙркарк╛рк╡рк╡рлЛ, ркЦрлБрк╢, ркЦрлБрк╢ рк╡рлНркпркХрлНркдрк┐, рк╡рлНркпркХрлНркдрк┐, рк╣рк╛рке ркЙрккрк░ ркЙркарк╛рк╡ркдрлА ркЦрлБрк╢ рк╡рлНркпркХрлНркдрк┐, рк╣рк╛рке ркЙрккрк░ ркЙркарк╛рк╡рлЗрк▓ рк╡рлНркпркХрлНркдрк┐, рк╣рк╛рк╡ркнрк╛рк╡
ЁЯЩЛтАНтЩВ => ЁЯЩЛтАНтЩВ, ркЙрккрк░ рк╣рк╛рке ркЙркарк╛рк╡рк╡рлЛ, рккрлБрк░рлБрк╖, рк╣рк╛рке ркЙрккрк░ ркЙркарк╛рк╡ркдрлЛ ркЦрлБрк╢ рккрлБрк░рлБрк╖, рк╣рк╛рк╡ркнрк╛рк╡
ЁЯЩЛтАНтЩА => ЁЯЩЛтАНтЩА, ркЙрккрк░ рк╣рк╛рке ркЙркарк╛рк╡рк╡рлЛ, рк╕рлНркдрлНрк░рлА, рк╣рк╛рке ркЙрккрк░ ркЙркарк╛рк╡ркдрлА ркЦрлБрк╢ рк╕рлНркдрлНрк░рлА, рк╣рк╛рк╡ркнрк╛рк╡
ЁЯЩЗ => ЁЯЩЗ, ркКркВркбрлЗркерлА ркиркорлЗрк▓, ркиркорк╡рлБркВ, ркоркирлЗ ркорк╛ркл ркХрк░рк╢рлЛ, ркорк╛ркл ркХрк░рк╢рлЛ, рк╡ркВркжрки ркХрк░ркдрлА рк╡рлНркпркХрлНркдрк┐, рк╡рлНркпркХрлНркдрк┐, рк╣рк╛рк╡ркнрк╛рк╡
ЁЯЩЗтАНтЩВ => ЁЯЩЗтАНтЩВ, ркКркВркбрлЗркерлА ркиркорлЗрк▓, ркиркорк╡рлБркВ, рккрлБрк░рлБрк╖, ркоркирлЗ ркорк╛ркл ркХрк░рк╢рлЛ, ркорк╛ркл ркХрк░рк╢рлЛ, рк╡ркВркжрки ркХрк░ркдрлЛ рккрлБрк░рлБрк╖, рк╣рк╛рк╡ркнрк╛рк╡
ЁЯЩЗтАНтЩА => ЁЯЩЗтАНтЩА, ркКркВркбрлЗркерлА ркиркорлЗрк▓, ркиркорк╡рлБркВ, ркоркирлЗ ркорк╛ркл ркХрк░рк╢рлЛ, ркорк╛ркл ркХрк░рк╢рлЛ, рк╡ркВркжрки ркХрк░ркдрлА рк╕рлНркдрлНрк░рлА, рк╕рлНркдрлНрк░рлА, рк╣рк╛рк╡ркнрк╛рк╡
ЁЯдж => ЁЯдж, ркЕрк╡рк┐рк╢рлНрк╡рк╛рк╕, ркЪрк╣рлЗрк░рлЛ, ркорк╛ркерк╛ ркЙрккрк░ рк╣рк╛рке ркжрлЗрк╡рлЛ, рк░рлЛрк╖, рк╣рк╛рке
ЁЯджтАНтЩВ => ЁЯджтАНтЩВ, ркЕрк╡рк┐рк╢рлНрк╡рк╛рк╕, рккрлБрк░рлБрк╖, ркорк╛ркерк╛ ркЙрккрк░ рк╣рк╛рке ркжрлЗркдрлЛ рккрлБрк░рлБрк╖, ркорк╛ркерк╛ ркЙрккрк░ рк╣рк╛рке ркжрлЗрк╡рлЛ, рк░рлЛрк╖, рк╣рк╛рке
ЁЯджтАНтЩА => ЁЯджтАНтЩА, ркЕрк╡рк┐рк╢рлНрк╡рк╛рк╕, ркорк╛ркерк╛ ркЙрккрк░ рк╣рк╛рке ркжрлЗркдрлА рк╕рлНркдрлНрк░рлА, ркорк╛ркерк╛ ркЙрккрк░ рк╣рк╛рке ркжрлЗрк╡рлЛ, рк░рлЛрк╖, рк╕рлНркдрлНрк░рлА, рк╣рк╛рке
ЁЯд╖ => ЁЯд╖, ркЕркЬрлНркЮрк╛рки, ркмрлЗркжрк░ркХрк╛рк░рлА, рк▓рк╛рккрк░рк╡рк╛ркИ, рк╢ркВркХрк╛
ЁЯд╖тАНтЩВ => ЁЯд╖тАНтЩВ, ркЕркЬрлНркЮрк╛рки, рккрлБрк░рлБрк╖, ркмрлЗркжрк░ркХрк╛рк░рлА, ркмрлЗркжрк░ркХрк╛рк░рлА рккрлБрк░рлБрк╖, рк▓рк╛рккрк░рк╡рк╛ркИ, рк╢ркВркХрк╛
ЁЯд╖тАНтЩА => ЁЯд╖тАНтЩА, ркЕркЬрлНркЮрк╛рки, ркмрлЗркжрк░ркХрк╛рк░рлА, ркмрлЗркжрк░ркХрк╛рк░рлА рк╕рлНркдрлНрк░рлА, рк▓рк╛рккрк░рк╡рк╛ркИ, рк╢ркВркХрк╛, рк╕рлНркдрлНрк░рлА
ЁЯТЖ => ЁЯТЖ, рклрлЗрк╕ ркорк╕рк╛ркЬ, ркорк╕рк╛ркЬ, рк╕рк▓рлБрки
ЁЯТЖтАНтЩВ => ЁЯТЖтАНтЩВ, ркЪрк╣рлЗрк░рлЛ, рккрлБрк░рлБрк╖, рклрлЗрк╕ ркорк╕рк╛ркЬ рк▓рлЗркдрлЛ рккрлБрк░рлБрк╖, ркорк╕рк╛ркЬ
ЁЯТЖтАНтЩА => ЁЯТЖтАНтЩА, ркЪрк╣рлЗрк░рлЛ, рклрлЗрк╕ ркорк╕рк╛ркЬ рк▓рлЗркдрлА рк╕рлНркдрлНрк░рлА, ркорк╕рк╛ркЬ, рк╕рлНркдрлНрк░рлА
ЁЯТЗ => ЁЯТЗ, рккрк╛рк░рлНрк▓рк░, ркмрлНркпрлБркЯрлАрккрк╛рк░рлНрк▓рк░, рк╕рлБркВркжрк░ркдрк╛, рк╣рлЗрк░ркХркЯ
ЁЯТЗтАНтЩВ => ЁЯТЗтАНтЩВ, рккрлБрк░рлБрк╖, рк╣рлЗрк░ркХркЯ, рк╣рлЗрк░ркХркЯ ркХрк░рк╛рк╡ркдрлЛ рккрлБрк░рлБрк╖
ЁЯТЗтАНтЩА => ЁЯТЗтАНтЩА, рк╕рлНркдрлНрк░рлА, рк╣рлЗрк░ркХркЯ, рк╣рлЗрк░ркХркЯ ркХрк░рк╛рк╡ркдрлА рк╕рлНркдрлНрк░рлА
ЁЯЪ╢ => ЁЯЪ╢, рккркжркпрк╛ркдрлНрк░рлА, рк░рк╛рк╣ркжрк╛рк░рлА
ЁЯЪ╢тАНтЩВ => ЁЯЪ╢тАНтЩВ, ркЪрк╛рк▓рк╡рлБркВ, рккркжркпрк╛ркдрлНрк░рлА ркХрк░ркдрлЛ рккрлБрк░рлБрк╖, рккрлБрк░рлБрк╖, рк╣рк╛ркИркХ
ЁЯЪ╢тАНтЩА => ЁЯЪ╢тАНтЩА, ркЪрк╛рк▓рк╡рлБркВ, рккркжркпрк╛ркдрлНрк░рлА ркХрк░ркдрлА рк╕рлНркдрлНрк░рлА, рк╕рлНркдрлНрк░рлА, рк╣рк╛ркИркХ
ЁЯПГ => ЁЯПГ, ркЦрлЗрк▓ ркХрлВркж, ркжрлЛркб, ркжрлЛркбрк╡рлАрк░, ркорлЗрк░рк╛ркерлЛрки
ЁЯПГтАНтЩВ => ЁЯПГтАНтЩВ, ркЦрлЗрк▓ ркХрлВркж, ркжрлЛркб, ркжрлЛркбркдрлЛ рккрлБрк░рлБрк╖, рккрлБрк░рлБрк╖, ркорлЗрк░рк╛ркерлЛрки
ЁЯПГтАНтЩА => ЁЯПГтАНтЩА, ркЦрлЗрк▓ ркХрлВркж, ркжрлЛркб, ркжрлЛркбркдрлА рк╕рлНркдрлНрк░рлА, ркорлЗрк░рк╛ркерлЛрки, рк╕рлНркдрлНрк░рлА
ЁЯТГ => ЁЯТГ, ркирлГркдрлНркп, ркирлГркдрлНркпрк╛ркВркЧркирк╛, рк▓рлЛркХрлЛ
ЁЯХ║ => ЁЯХ║, ркбрк╛ркирлНрк╕, ркбрк╛ркирлНрк╕ ркХрк░ркдрлЛ ркорк╛ркгрк╕, ркорк╛ркгрк╕
ЁЯСп => ЁЯСп, ркЫрлЛркХрк░рлА, ркирлГркдрлНркпрк╛ркВркЧркирк╛, рккрк╛рк░рлНркЯрлА ркХрк░ркдрлА рк╕рлНркдрлНрк░рлАркУ, рк▓рлЛркХрлЛ, рк╕рк╕рк▓рк╛ ркЬрлЗрк╡рк╛ ркХрк╛рки, рк╕рк╕рк▓рк╛ ркЬрлЗрк╡рлА рк▓рк╛ркЧркдрлА ркЫрлЛркХрк░рлА, рк╕рлНркдрлНрк░рлА
ЁЯСптАНтЩВ => ЁЯСптАНтЩВ, ркбрк╛ркирлНрк╕рк░, ркирлГркдрлНркпрк╛ркВркЧркирк╛, рккрк╛рк░рлНркЯрлА, рккрк╛рк░рлНркЯрлА ркХрк░ркдрк╛ рккрлБрк░рлБрк╖рлЛ, рккрлБрк░рлБрк╖рлЛ, рк╕рк╕рк▓рк╛ ркЬрлЗрк╡рк╛ ркХрк╛рки
ЁЯСптАНтЩА => ЁЯСптАНтЩА, ркбрк╛ркирлНрк╕рк░, ркирлГркдрлНркпрк╛ркВркЧркирк╛, рккрк╛рк░рлНркЯрлА, рк╕рк╕рк▓рк╛ ркЬрлЗрк╡рк╛ ркХрк╛рки, рк╕рлНркдрлНрк░рлАркУ, рк╕рлНркдрлНрк░рлАркУ рккрк╛рк░рлНркЯрлА ркХрк░рлЗ ркЫрлЗ
ЁЯзЦ => ЁЯзЦ, ркмрк╛рклрк╡рк╛рк│рк╛ рк░рлВркоркорк╛ркВ рк╡рлНркпркХрлНркдрк┐, рк╕рлЙркирк╛, рк╕рлНркЯрлАрко рк░рлВрко
ЁЯзЦтАНтЩА => ЁЯзЦтАНтЩА, рк╕рлЙркирк╛, рк╕рлНркЯрлАрко рк░рлВрко, рк╕рлНркЯрлАркорлА рк░рлВркоркорк╛ркВ рк╕рлНркдрлНрк░рлА
ЁЯзЦтАНтЩВ => ЁЯзЦтАНтЩВ, рк╕рлЙркирк╛, рк╕рлНркЯрлАрко рк░рлВрко, рк╕рлНркЯрлАркорк╡рк╛рк│рк╛ рк░рлВркоркорк╛ркВ рккрлБрк░рлБрк╖
ЁЯзЧ => ЁЯзЧ, ркЙрккрк░ ркЪрквркирк╛рк░, рк╡рлНркпркХрлНркдрк┐ ркЪркврк╛ркИ рккрк░
ЁЯзЧтАНтЩА => ЁЯзЧтАНтЩА, ркЙрккрк░ ркЪрквркирк╛рк░, рк╕рлНркдрлНрк░рлА ркЪркврк╛ркИ рккрк░
ЁЯзЧтАНтЩВ => ЁЯзЧтАНтЩВ, ркЙрккрк░ ркЪрквркирк╛рк░, рккрлБрк░рлБрк╖ ркЪркврк╛ркИ рккрк░
ЁЯзШ => ЁЯзШ, ркзрлНркпрк╛рки, ркпрлЛркЧ, рк╡рлНркпркХрлНркдрк┐ ркХркорк│ ркЬрлЗрк╡рлА рк╕рлНркерк┐ркдрк┐ркорк╛ркВ
ЁЯзШтАНтЩА => ЁЯзШтАНтЩА, ркзрлНркпрк╛рки, ркпрлЛркЧ, рк╕рлНркдрлНрк░рлА ркХркорк│ ркЬрлЗрк╡рлА рк╕рлНркерк┐ркдрк┐ркорк╛ркВ
ЁЯзШтАНтЩВ => ЁЯзШтАНтЩВ, ркзрлНркпрк╛рки, рккрлБрк░рлБрк╖ ркХркорк│ ркЬрлЗрк╡рлА рк╕рлНркерк┐ркдрк┐ркорк╛ркВ, ркпрлЛркЧ
ЁЯЫА => ЁЯЫА, рк╕рлНркирк╛рки, рк╕рлНркирк╛рки ркХрк░ркдрлА рк╡рлНркпркХрлНркдрк┐
ЁЯЫМ => ЁЯЫМ, ркКркВркШ, ркирк┐ркВркжрлНрк░рк╛, рккркерк╛рк░рлАркорк╛ркВ рк╕рлВркдрлА рк╡рлНркпркХрлНркдрк┐, рк╣рлЛркЯрк▓
ЁЯХ┤ => ЁЯХ┤, рккрлБрк░рлБрк╖, ркмрк┐ркЭркирлЗрк╕, рк╡рлЗрккрк╛рк░, рк╡рлНркпрк╡рк╕рк╛ркп, рк╕рлВркЯ, рк╕рлВркЯрк╡рк╛рк│рлЛ рк╡рлНркпркХрлНркдрк┐
ЁЯЧг => ЁЯЧг, рккрк╛рк░рлНрк╢рлНрк╡ ркЪрк┐ркдрлНрк░, ркмрлЛрк▓ркдрлЛ ркЪрк╣рлЗрк░рлЛ, ркмрлЛрк▓рк╡рлБркВ, ркмрлЛрк▓рлЛ, ркорк╛ркерлБркВ, ркорлБркЦ
ЁЯСд => ЁЯСд, рккрк╛рк░рлНрк╢рлНрк╡ркЪрк┐ркдрлНрк░, рккрлЗркЯркерлА ркЙрккрк▓рк╛ ркнрк╛ркЧркирлБркВ рккрк╛рк░рлНрк╢рлНрк╡ркЪрк┐ркдрлНрк░, рккрлЗркЯркерлА ркЙрккрк▓рлЛ ркнрк╛ркЧ, рк▓рлЛркХрлЛ
ЁЯСе => ЁЯСе, рккрк╛рк░рлНрк╢рлНрк╡ркЪрк┐ркдрлНрк░, рккрлЗркЯркерлА ркЙрккрк▓рк╛ ркнрк╛ркЧркирк╛ рккрк╛рк░рлНрк╢рлНрк╡ркЪрк┐ркдрлНрк░, рккрлЗркЯркерлА ркЙрккрк▓рк╛ ркнрк╛ркЧркирлБркВ рккрк╛рк░рлНрк╢рлНрк╡ркЪрк┐ркдрлНрк░, рккрлЗркЯркерлА ркЙрккрк▓рлЛ ркнрк╛ркЧ, рк▓рлЛркХрлЛ
ЁЯд║ => ЁЯд║, ркдрк▓рк╡рк╛рк░, рклрлЗркирлНрк╕рк░, рклрлЗркирлНрк╕рк┐ркВркЧ, ркорк╛ркгрк╕, рк╕рлНрккрлЙрк░рлНркЯ
ЁЯПЗ => ЁЯПЗ, ркЦрлЗрк▓ ркХрлВркж, ркШрлЛркбрк╛ ркжрлЛркб, ркШрлЛркбрлЛ, ркЬрлЛркХрлА, ркжрлЛркб, рк░рлЗрк╕ркирлЛ ркШрлЛркбрлЛ
тЫ╖ => тЫ╖, ркмрк░ркл, рк╕рлНркХрлА, рк╕рлНркХрлА ркЦрлЗрк▓рк╛ркбрлА
ЁЯПВ => ЁЯПВ, ркЦрлЗрк▓ ркХрлВркж, рк╕рлНркирлЛркмрлЛрк░рлНркб, рк╕рлНркирлЛркмрлЛрк░рлНркбрк░, рк╕рлНркирлЛркмрлЛрк░рлНркбрк┐ркВркЧ
ЁЯПМ => ЁЯПМ, ркЧрлЛрк▓рлНркл рк░ркоркирк╛рк░ ркЦрлЗрк▓рк╛ркбрлА, ркЧрлЛрк▓рлНрклрк░, ркмрлЛрк▓
ЁЯПМтАНтЩВ => ЁЯПМтАНтЩВ, ркЧрлЛрк▓рлНркл, ркЧрлЛрк▓рлНркл рк░ркоркирк╛рк░ рккрлБрк░рлБрк╖, рккрлБрк░рлБрк╖
ЁЯПМтАНтЩА => ЁЯПМтАНтЩА, ркЧрлЛрк▓рлНркл, ркЧрлЛрк▓рлНркл рк░ркоркирк╛рк░ рк╕рлНркдрлНрк░рлА, рк╕рлНркдрлНрк░рлА
ЁЯПД => ЁЯПД, ркЦрлЗрк▓ ркХрлВркж, рк╕рк░рлНрклрк░, рк╕рк░рлНрклрк┐ркВркЧ
ЁЯПДтАНтЩВ => ЁЯПДтАНтЩВ, рккрлБрк░рлБрк╖, рк╕рк░рлНрклрк┐ркВркЧ, рк╕рк░рлНрклрк┐ркВркЧ ркХрк░ркдрлЛ рккрлБрк░рлБрк╖
ЁЯПДтАНтЩА => ЁЯПДтАНтЩА, рк╕рк░рлНрклрк┐ркВркЧ, рк╕рк░рлНрклрк┐ркВркЧ ркХрк░ркдрлА рк╕рлНркдрлНрк░рлА, рк╕рлНркдрлНрк░рлА
ЁЯЪг => ЁЯЪг, ркирк╛рк╡ркбрлА, рк╡рк╛рк╣рки, рк╣рлЛркбрлА
ЁЯЪгтАНтЩВ => ЁЯЪгтАНтЩВ, рккрлБрк░рлБрк╖, рк╣рлЛркбрлА, рк╣рлЛркбрлА ркЪрк▓рк╛рк╡ркдрлЛ рккрлБрк░рлБрк╖
ЁЯЪгтАНтЩА => ЁЯЪгтАНтЩА, рк╕рлНркдрлНрк░рлА, рк╣рлЛркбрлА, рк╣рлЛркбрлА ркЪрк▓рк╛рк╡ркдрлА рк╕рлНркдрлНрк░рлА
ЁЯПК => ЁЯПК, ркЦрлЗрк▓ ркХрлВркж, ркдрк░ркг, ркдрк░рк╡рлБркВ, рк╕рлНрк╡рк┐ркорк░ (ркдрк░рк╡рлИркпрлЛ)
ЁЯПКтАНтЩВ => ЁЯПКтАНтЩВ, рккрлБрк░рлБрк╖, рк╕рлНрк╡рк┐рко, рк╕рлНрк╡рк┐рко ркХрк░ркдрлЛ рккрлБрк░рлБрк╖
ЁЯПКтАНтЩА => ЁЯПКтАНтЩА, рк╕рлНркдрлНрк░рлА, рк╕рлНрк╡рк┐рко, рк╕рлНрк╡рк┐рко ркХрк░ркдрлА рк╕рлНркдрлНрк░рлА
тЫ╣ => тЫ╣, ркжркбрлЛ, ркмрлЛрк▓, ркмрлЛрк▓ рк╕рк╛ркерлЗркирлА рк╡рлНркпркХрлНркдрк┐
тЫ╣тАНтЩВ => тЫ╣тАНтЩВ, рккрлБрк░рлБрк╖, ркмрлЛрк▓, ркмрлЛрк▓ рк╕рк╛ркерлЗркирлЛ рккрлБрк░рлБрк╖
тЫ╣тАНтЩА => тЫ╣тАНтЩА, ркмрлЛрк▓, ркмрлЛрк▓ рк╕рк╛ркерлЗркирлА рк╕рлНркдрлНрк░рлА, рк╕рлНркдрлНрк░рлА
ЁЯПЛ => ЁЯПЛ, рк▓рк┐рклрлНркЯрк░, рк╡ркЬрки, рк╡рлЗркЯ рк▓рк┐рклрлНркЯрк░
ЁЯПЛтАНтЩВ => ЁЯПЛтАНтЩВ, рккрлБрк░рлБрк╖, рк╡рлЗркЯ рк▓рк┐рклрлНркЯ ркХрк░ркдрлЛ рккрлБрк░рлБрк╖, рк╡рлЗркЯ рк▓рк┐рклрлНркЯрк░
ЁЯПЛтАНтЩА => ЁЯПЛтАНтЩА, рк╡рлЗркЯ рк▓рк┐рклрлНркЯ ркХрк░ркдрлА рк╕рлНркдрлНрк░рлА, рк╡рлЗркЯ рк▓рк┐рклрлНркЯрк░, рк╕рлНркдрлНрк░рлА
ЁЯЪ┤ => ЁЯЪ┤, ркмрк╛ркЗркХ, ркмрк╛ркЗрк╕рк┐ркХрк▓ рк╕рк╡рк╛рк░, рк╕рк╛ркЗркХрк▓ рк╕рк╡рк╛рк░
ЁЯЪ┤тАНтЩВ => ЁЯЪ┤тАНтЩВ, рккрлБрк░рлБрк╖, ркмрк╛ркЗркХрк┐ркВркЧ, ркмрк╛ркЗрк╕рк┐ркХрк▓, ркмрк╛ркЗрк╕рк┐ркХрк▓ ркЪрк▓рк╛рк╡ркдрлЛ рккрлБрк░рлБрк╖, рк╕рк╛ркЗркХрлНрк▓рк┐рк╕рлНркЯ
ЁЯЪ┤тАНтЩА => ЁЯЪ┤тАНтЩА, ркмрк╛ркЗркХрк┐ркВркЧ, ркмрк╛ркЗрк╕рк┐ркХрк▓, ркмрк╛ркЗрк╕рк┐ркХрк▓ ркЪрк▓рк╛рк╡ркдрлА рк╕рлНркдрлНрк░рлА, рк╕рк╛ркЗркХрлНрк▓рк┐рк╕рлНркЯ, рк╕рлНркдрлНрк░рлА
ЁЯЪ╡ => ЁЯЪ╡, рккрк░рлНрк╡ркд, рккрк░рлНрк╡ркдрк╛рк░рлЛрк╣ркгркирк╛ ркмрк╛ркЗрк╕рк┐ркХрк▓ рк╕рк╡рк╛рк░, ркмрк╛ркЗркХ, рк╕рк╛ркЗркХрк▓ рк╕рк╡рк╛рк░
ЁЯЪ╡тАНтЩВ => ЁЯЪ╡тАНтЩВ, рккрк░рлНрк╡ркд, рккрк░рлНрк╡ркд ркЙрккрк░ ркмрк╛ркЗрк╕рк┐ркХрк▓ ркЪрк▓рк╛рк╡ркдрлЛ рккрлБрк░рлБрк╖, рккрлБрк░рлБрк╖, ркмрк╛ркЗркХрк┐, ркмрк╛ркЗрк╕рк┐ркХрк▓, рк╕рк╛ркЗркХрлНрк▓рк┐рк╕рлНркЯ
ЁЯЪ╡тАНтЩА => ЁЯЪ╡тАНтЩА, рккрк░рлНрк╡ркд, рккрк░рлНрк╡ркд ркЙрккрк░ ркмрк╛ркЗрк╕рк┐ркХрк▓ ркЪрк▓рк╛рк╡ркдрлА рк╕рлНркдрлНрк░рлА, ркмрк╛ркЗркХрк┐, ркмрк╛ркЗрк╕рк┐ркХрк▓, рк╕рк╛ркЗркХрлНрк▓рк┐рк╕рлНркЯ, рк╕рлНркдрлНрк░рлА
ЁЯПО => ЁЯПО, ркХрк╛рк░, рк░рлЗрк╕рк┐ркВркЧ, рк░рлЗрк╕рк┐ркВркЧ ркХрк╛рк░
ЁЯПН => ЁЯПН, ркорлЛркЯрк░рк╕рк╛ркпркХрк▓, рк░рлЗрк╕рк┐ркВркЧ
ЁЯд╕ => ЁЯд╕, ркХрк╛рк░рлНркЯрк╡рлНрк╣рлАрк▓, ркЬрк┐ркорлНркирлЗрк╕рлНркЯрк┐ркХрлНрк╕, ркорк╛ркгрк╕, рк╕рлНрккрлЙрк░рлНркЯ
ЁЯд╕тАНтЩВ => ЁЯд╕тАНтЩВ, ркХрк╛рк░рлНркЯрк╡рлНрк╣рлАрк▓, ркХрк╛рк░рлНркЯрк╡рлНрк╣рлАрк▓ ркХрк░ркдрлЛ рккрлБрк░рлБрк╖, ркЬрк┐ркорлНркирлЗрк╕рлНркЯрк┐ркХрлНрк╕, рккрлБрк░рлБрк╖, ркорк╛ркгрк╕, рк╕рлНрккрлЙрк░рлНркЯ
ЁЯд╕тАНтЩА => ЁЯд╕тАНтЩА, ркХрк╛рк░рлНркЯрк╡рлНрк╣рлАрк▓, ркХрк╛рк░рлНркЯрк╡рлНрк╣рлАрк▓ ркХрк░ркдрлА рк╕рлНркдрлНрк░рлА, ркЬрк┐ркорлНркирлЗрк╕рлНркЯрк┐ркХрлНрк╕, ркорк╛ркгрк╕, рк╕рлНркдрлНрк░рлА, рк╕рлНрккрлЙрк░рлНркЯ
ЁЯд╝ => ЁЯд╝, ркХрлБрк╕рлНркдрлА, рккрк╣рлЗрк▓рк╡рк╛рки, рккрк╣рлЗрк▓рк╡рк╛ркирлЛ, ркорк╛ркгрк╕, рк╕рлНрккрлЙрк░рлНркЯ
ЁЯд╝тАНтЩВ => ЁЯд╝тАНтЩВ, ркХрлБрк╕рлНркдрлА, ркХрлБрк╕рлНркдрлА ркХрк░ркдрк╛ рккрлБрк░рлБрк╖рлЛ, рккрк╣рлЗрк▓рк╡рк╛рки, рккрлБрк░рлБрк╖, ркорк╛ркгрк╕, рк╕рлНрккрлЙрк░рлНркЯ
ЁЯд╝тАНтЩА => ЁЯд╝тАНтЩА, ркХрлБрк╕рлНркдрлА, ркХрлБрк╕рлНркдрлА ркХрк░ркдрлА рк╕рлНркдрлНрк░рлАркУ, рккрк╣рлЗрк▓рк╡рк╛рки, ркорк╛ркгрк╕, рк╕рлНркдрлНрк░рлА, рк╕рлНрккрлЙрк░рлНркЯ
ЁЯд╜ => ЁЯд╜, рккрлЛрк▓рлЛ, ркорк╛ркгрк╕, рк╡рлЙркЯрк░, рк╡рлЙркЯрк░ рккрлЛрк▓рлЛ, рк╕рлНрккрлЙрк░рлНркЯ
ЁЯд╜тАНтЩВ => ЁЯд╜тАНтЩВ, рккрлБрк░рлБрк╖, рккрлЛрк▓рлЛ, рк╡рлЙркЯрк░, рк╡рлЙркЯрк░ рккрлЛрк▓рлЛ ркХрк░ркдрлЛ рккрлБрк░рлБрк╖, рк╕рлНрккрлЙрк░рлНркЯ
ЁЯд╜тАНтЩА => ЁЯд╜тАНтЩА, рккрлЛрк▓рлЛ, рк╡рлЙркЯрк░, рк╡рлЙркЯрк░ рккрлЛрк▓рлЛ ркХрк░ркдрлА рк╕рлНркдрлНрк░рлА, рк╕рлНркдрлНрк░рлА, рк╕рлНрккрлЙрк░рлНркЯ
ЁЯд╛ => ЁЯд╛, ркмрлЛрк▓, ркорк╛ркгрк╕, рк╕рлНрккрлЙрк░рлНркЯ, рк╣рлЕркирлНркбркмрлЛрк▓
ЁЯд╛тАНтЩВ => ЁЯд╛тАНтЩВ, рккрлБрк░рлБрк╖, рк╕рлНрккрлЙрк░рлНркЯ, рк╣рлЕркирлНркбркмрлЛрк▓, рк╣рлЕркирлНркбркмрлЛрк▓ рк░ркоркдрлЛ рккрлБрк░рлБрк╖
ЁЯд╛тАНтЩА => ЁЯд╛тАНтЩА, рк╕рлНркдрлНрк░рлА, рк╕рлНрккрлЙрк░рлНркЯ, рк╣рлЕркирлНркбркмрлЛрк▓, рк╣рлЕркирлНркбркмрлЛрк▓ рк░ркоркдрлА рк╕рлНркдрлНрк░рлА
ЁЯд╣ => ЁЯд╣, ркХрлМрк╢рк▓рлНркп, ркЬркЧрк▓, ркЬркЧрк▓рк┐ркВркЧ, ркмрк╣рлБ ркХрк╛рк░рлНркп, рк╕ркВркдрлБрк▓рки
ЁЯд╣тАНтЩВ => ЁЯд╣тАНтЩВ, ркЬркЧрк▓рк┐ркВркЧ, ркЬркЧрк▓рк┐ркВркЧ ркХрк░ркдрлЛ рккрлБрк░рлБрк╖, рккрлБрк░рлБрк╖, ркмрк╣рлБ ркХрк╛рк░рлНркп
ЁЯд╣тАНтЩА => ЁЯд╣тАНтЩА, ркЬркЧрк▓рк┐ркВркЧ, ркЬркЧрк▓рк┐ркВркЧ ркХрк░ркдрлА рк╕рлНркдрлНрк░рлА, ркмрк╣рлБ ркХрк╛рк░рлНркп, рк╕рлНркдрлНрк░рлА
ЁЯСл => ЁЯСл, ркПркХркмрлАркЬрк╛ркирк╛ркВ рк╣рк╛рке рккркХркбрк╡рк╛, ркПркХркмрлАркЬрк╛ркирк╛ркВ рк╣рк╛рке рккркХркбрлЗрк▓ рккрлБрк░рлБрк╖ ркЕркирлЗ рк╕рлНркдрлНрк░рлА, рккрлБрк░рлБрк╖, рккрлБрк░рлБрк╖ ркЕркирлЗ рк╕рлНркдрлНрк░рлА, ркпрлБркЧрк▓, рк▓рлЛркХрлЛ, рк╕рлНркдрлНрк░рлА
ЁЯСм => ЁЯСм, ркПркХркмрлАркЬрк╛ркирк╛ рк╣рк╛рке рккркХркбрлЗрк▓рк╛ ркмрлЗ рккрлБрк░рлБрк╖рлЛ, рккрлБрк░рлБрк╖, ркмрлЗ рккрлБрк░рлБрк╖, ркпрлБркЧрк▓, рк▓рлЛркХрлЛ, рк╣рк╛рке рккркХркбрк╡рк╛
ЁЯСн => ЁЯСн, ркПркХркмрлАркЬрк╛ркирк╛ркВ рк╣рк╛рке рккркХркбрлЗрк▓рлА ркмрлЗ рк╕рлНркдрлНрк░рлАркУ, ркмрлЗ рк╕рлНркдрлНрк░рлА, ркпрлБркЧрк▓, рк▓рлЛркХрлЛ, рк╕рлНркдрлНрк░рлА, рк╣рк╛рке рккркХркбрк╡рк╛
ЁЯТП => ЁЯТП, ркЪрлБркВркмрки, ркЪрлБркВркмрки ркХрк░ркдрк╛ркВ, рк░рлЛркорк╛ркВрк╕, рк▓рлЛркХрлЛ
ЁЯТС => ЁЯТС, ркжрк┐рк▓, ркжрк┐рк▓ рк╕рк╛ркерлЗркирлБркВ ркпрлБркЧрк▓, ркпрлБркЧрк▓, рк░рлЛркорк╛ркВрк╕, рк▓рлЛркХрлЛ
ЁЯСк => ЁЯСк, ркХрлБркЯрлБркВркм, рккрк┐ркдрк╛, ркмрк╛рк│ркХ, ркорк╛ркдрк╛, рк▓рлЛркХрлЛ
ЁЯд│ => ЁЯд│, ркХрлЕркорк░рк╛, рклрлЛрки, рк╕рлЗрк▓рлНрклрлА
ЁЯТк => ЁЯТк, рклрк▓рлЗркХрлНрк╕, ркмрк╛рк╡ркбрлБ, ркоркЬркмрлВркд, рк░ркорлВркЬрлА, рк╕рлНркирк╛ркпрлБ, рк╕рлНркирк╛ркпрлБ рклрк▓рлЗркХрлНрк╕
ЁЯСИ => ЁЯСИ, ркЖркВркЧрк│рлА, ркбрк╛ркмрлА ркЖркВркЧрк│рлА, ркбрк╛ркмрлА ркмрк╛ркЬрлБ ркЪрлАркВркзркдрлА ркЖркВркЧрк│рлА, рккрк╣рлЗрк▓рлА ркЖркВркЧрк│рлА, рк╣рк╛ркеркирлЛ рккрк╛ркЫрк▓рлЛ ркнрк╛ркЧ
ЁЯСЙ => ЁЯСЙ, ркЖркВркЧрк│рлА, ркЬркоркгрлА ркЖркВркЧрк│рлА, ркЬркоркгрлА ркмрк╛ркЬрлБ ркЪрлАркВркзркдрлА ркЖркВркЧрк│рлА, рккрк╣рлЗрк▓рлА ркЖркВркЧрк│рлА, рк╣рк╛ркеркирлЛ рккрк╛ркЫрк▓рлЛ ркнрк╛ркЧ
тШЭ => тШЭ, ркЖркВркЧрк│рлА, ркЙрккрк░, ркЙрккрк░ ркЪрлАркВркзркдрлА ркдрк░рлНркЬркирлА, ркЪрлАркВркзркдрлА, рккрлНрк░ркерко ркЖркВркЧрк│рлА, рк╢рк░рлАрк░, рк╣рк╛рке
ЁЯСЖ => ЁЯСЖ, ркЖркВркЧрк│рлА, ркЙрккрк░ ркЖркВркЧрк│рлА, ркЙрккрк░ркирлА ркмрк╛ркЬрлБ ркЪрлАркВркзрк╛ркпрлЗрк▓рлА ркЖркВркЧрк│рлА, рккрк╣рлЗрк▓рлА ркЖркВркЧрк│рлА, рк╣рк╛ркеркирлА рккрк╛ркЫрк▓рлА ркмрк╛ркЬрлБркПркерлА ркЙрккрк░ ркЪрлАркВркзркдрлА ркдрк░рлНркЬркирлА, рк╣рк╛ркеркирлЛ рккрк╛ркЫрк▓рлЛ ркнрк╛ркЧ
ЁЯЦХ => ЁЯЦХ, ркЖркВркЧрк│рлА, ркоркзрлНркпркорк╛, рк╡ркЪрк▓рлА ркЖркВркЧрк│рлА, рк╡ркЪрлНркЪрлЗркирлА ркЖркВркЧрк│рлА, рк╢рк░рлАрк░, рк╣рк╛рке
ЁЯСЗ => ЁЯСЗ, ркЖркВркЧрк│рлА, ркирлАркЪрлА ркЖркВркЧрк│рлА, ркирлАркЪрлЗркирлА ркмрк╛ркЬрлБ ркЪрлАркВркзрк╛ркпрлЗрк▓рлА ркЖркВркЧрк│рлА, рккрк╣рлЗрк▓рлА ркЖркВркЧрк│рлА, рк╣рк╛ркеркирлА рккрк╛ркЫрк▓рлА ркмрк╛ркЬрлБркПркерлА ркирлАркЪрлЗ ркЪрлАркВркзркдрлА ркдрк░рлНркЬркирлА, рк╣рк╛ркеркирлЛ рккрк╛ркЫрк▓рлЛ ркнрк╛ркЧ
тЬМ => тЬМ, ркХрк╛ркдрк░, рк╡рк┐ркЬркп, рк╡рк┐ркЬркпркирлБркВ ркЪрк┐рк╣рлНрки, рк╡рк┐ркЬркпрлА рк╣рк╛рке
ЁЯдЮ => ЁЯдЮ, ркХрлНрк░рлЙрк╕, ркХрлНрк░рлЙрк╕рлНркб рклрк┐ркВркЧрк░рлНрк╕, рклрк┐ркВркЧрк░, ркнрк╛ркЧрлНркп, рк╣рк╛рке
ЁЯЦЦ => ЁЯЦЦ, ркЖркВркЧрк│рлА, рк╡рк▓рлНркХрки, рк╢рк░рлАрк░, рк╕рлЗрк▓рлНркпрлБркЯркирлА ркПркХ рк░рлАркд, рк╕рлНрккрлЛркЕркХ, рк╣рк╛рке
ЁЯдШ => ЁЯдШ, ркЖркВркЧрк│рлА, рк░рлЛркХ-ркСрки, рк╢рк░рлАрк░, рк╢рк┐ркВркЧркбрк╛ркВ, рк╢рк┐ркВркЧркбрк╛ркирлБркВ ркЪрк┐рк╣рлНрки, рк╣рк╛рке
ЁЯдЩ => ЁЯдЩ, ркХрлЙрк▓, ркоркирлЗ ркХрлЙрк▓ ркХрк░рлЛ рк╣рк╛рке, рк╣рк╛рке
ЁЯЦР => ЁЯЦР, ркЖркВркЧрк│рлА, рклрлЗрк▓рк╛рк╡рлЗрк▓рлА ркЖркВркЧрк│рлА рк╡рк╛рк│рлЛ ркЙркарк╛рк╡рлЗрк▓рлЛ рк╣рк╛рке, рклрлЗрк▓рк╛рк╡рлЗрк▓рлБркВ, рк╢рк░рлАрк░, рк╣рк╛рке
тЬЛ => тЬЛ, ркЙркарк╛рк╡рлЗрк▓рлЛ рк╣рк╛рке, рк╣рк╛рке
ЁЯСМ => ЁЯСМ, ркЪрк┐рк╣рлНрки, ркмрк░рк╛ркмрк░, ркмрк░рк╛ркмрк░ ркЪрк┐рк╣рлНрки, ркмрк░рк╛ркмрк░ рк╣рк╛рке ркЪрк┐рк╣рлНрки, рк╣рк╛рке
ЁЯСН => ЁЯСН, ркЕркВркЧрлБркарлЛ, ркЙркВркЪрлЛ, ркЪрк┐рк╣рлНрки, ркеркорлНркмрлНрк╕ ркЕркк, рк╣рк╛рке
ЁЯСО => ЁЯСО, ркЕркВркЧрлБркарлЛ, ркЪрк┐рк╣рлНрки, ркирлАркЪрлЛ, ркирлАркЪрлЛ ркЕркВркЧрлВркарлЛ, рк╣рк╛рке
тЬК => тЬК, ркЙркарк╛рк╡рлЗрк▓ ркорлБркарлНркарлА, ркорлБркарлНркарлА, рк╣рк╛рке
ЁЯСК => ЁЯСК, ркмркВркз ркорлБркарлНркарлА, ркорлБркарлНркарлА, рк╣рк╛рке
ЁЯдЫ => ЁЯдЫ, ркбрк╛ркмрлАркмрк╛ркЬрлБ, ркбрк╛ркмрлАркмрк╛ркЬрлБркирлА ркорлБркарлНркарлА, ркорлБркарлНркарлА
ЁЯдЬ => ЁЯдЬ, ркЬркоркгрлАркмрк╛ркЬрлБ, ркЬркоркгрлАркмрк╛ркЬрлБркирлА ркорлБркарлНркарлА, ркорлБркарлНркарлА
ЁЯдЪ => ЁЯдЪ, ркмрлЗркХрк╣рлЗркирлНркб, рк╣рк╛рке
ЁЯСЛ => ЁЯСЛ, рк╣рк▓рк╛рк╡рк╡рк╛, рк╣рк╛рке, рк╣рк╛рке рк╣рк▓рк╛рк╡рк╡рк╛
ЁЯдЯ => ЁЯдЯ, рк╣рк╛рк╡ркнрк╛рк╡ рккрлНрк░ркдрлНркпрлЗ рккрлНрк░рлЗрко
тЬН => тЬН, рк▓ркЦркдрлЛ, рк▓ркЦрк╡рлБркВ, рк▓ркЦрк╛ркг, рк▓ркЦрлА рк░рк╣рлЗрк▓рлЛ рк╣рк╛рке, рк╢рк░рлАрк░, рк╣рк╛рке
ЁЯСП => ЁЯСП, ркЪрк┐рк╣рлНрки, ркдрк╛рк│рлА, ркдрк╛рк│рлА рккрк╛ркбркдрк╛ркВ рк╣рк╛рке, рк╣рк╛рке
ЁЯСР => ЁЯСР, ркЦрлБрк▓рлНрк▓рк╛ркВ, ркЦрлБрк▓рлНрк▓рк╛ркВ рк╣рк╛рке, ркЦрлБрк▓рлНрк▓рк╛ркВ рк╣рк╛ркеркирлБркВ ркЪрк┐рк╣рлНрки, ркЪрк┐рк╣рлНрки, рк╣рк╛рке
ЁЯЩМ => ЁЯЩМ, ркЙркЬрк╡ркгрлА, ркЙркЬрк╡ркгрлАркорк╛ркВ ркмркВркирлЗ рк╣рк╛рке ркЙркарк╛рк╡рк╡рк╛, ркмркВркирлЗ рк╣рк╛рке, рк╣рк╛рке ркЙркарк╛рк╡ркдрлА рк╡рлНркпркХрлНркдрк┐, рк╣рлБрк░рк░рлЗ
ЁЯд▓ => ЁЯд▓, рк╣ркерлЗрк│рлАркУ ркПркХ рк╕рк╛ркерлЗ
ЁЯЩП => ЁЯЩП, ркЕркжркм рк╡рк╛рк│рлЗрк▓рк╛ рк╣рк╛рке, рккрлНрк░рк╛рк░рлНркеркирк╛, рккрлНрк░рк╛рк░рлНркеркирк╛ ркХрк░рк╡рлА, рк╡рк╛рк│рлЗрк▓рк╛ рк╣рк╛рке, рк╣рк╛рке, рк╣рк╛рк╡ркнрк╛рк╡
ЁЯдЭ => ЁЯдЭ, ркХрк░рк╛рк░, ркорк┐рк▓рк╛рк╡рк╡рлБркВ, ркорлАркЯрк┐ркВркЧ, рк╣рк╛рке, рк╣рк╛рке ркорк┐рк▓рк╛рк╡рк╡рлЛ
ЁЯТЕ => ЁЯТЕ, ркХрлЛрк╕рлНркорлЗркЯрк┐ркХрлНрк╕, ркиркЦ, ркиркЦркирлА рк╕ркВркнрк╛рк│, ркирлЗркЗрк▓ рккрлЛрк▓рк┐рк╢, рк╣рк╛рке ркдркерк╛ ркиркЦркирлА рк╕рк╛ркЬрк╕ркВркнрк╛рк│
ЁЯСВ => ЁЯСВ, ркХрк╛рки, рк╢рк░рлАрк░
ЁЯСГ => ЁЯСГ, ркЪрк╣рлЗрк░рлЛ, ркирк╛ркХ, рк╢рк░рлАрк░
ЁЯСг => ЁЯСг, ркирк┐рк╢рк╛рки, рккркЧ, рккркЧркирк╛ркВ ркирк┐рк╢рк╛рки, рк╢рк░рлАрк░
ЁЯСА => ЁЯСА, ркЖркВркЦрлЛ, ркЪрк╣рлЗрк░рлЛ, рк╢рк░рлАрк░
ЁЯСБ => ЁЯСБ, ркЖркВркЦ, рк╢рк░рлАрк░
ЁЯСБтАНЁЯЧи => ЁЯСБтАНЁЯЧи, ркЖркВркЦ, рк╕рк╛ркХрлНрк╖рлА, рк╕рлНрккрлАркЪ ркмркмрк▓
ЁЯза => ЁЯза, ркоркЧркЬ
ЁЯСЕ => ЁЯСЕ, ркЪрк╣рлЗрк░рлЛ, ркЬрлАркн, рк╢рк░рлАрк░
ЁЯСД => ЁЯСД, ркЪрк╣рлЗрк░рлЛ, ркорлЛркврлБркВ, рк╢рк░рлАрк░, рк╣рлЛрка
ЁЯТЛ => ЁЯТЛ, ркЪрлБркВркмрки, ркЪрлБркВркмркиркирлБркВ ркЪрк┐рк╣рлНрки, рк░рлЛркорк╛ркВрк╕, рк╣рлЛрка
ЁЯТШ => ЁЯТШ, ркдрлАрк░, ркдрлАрк░ рк╕рк╛ркерлЗркирлБркВ рк╣рлГркжркп, ркжрк┐рк▓, ркжрк┐рк▓ ркЕркирлЗ ркдрлАрк░, рккрлНрк░рлЗрко, рк▓рк╛ркЧркгрлА
тЭд => тЭд, рк▓рк╛рк▓, рк▓рк╛рк▓ рк╣рлГркжркп, рк╣рлГркжркп
ЁЯТУ => ЁЯТУ, ркжрк┐рк▓, ркзркбркХркдрлБркВ, ркзркбркХркдрлБркВ ркжрк┐рк▓, ркзркбркХрки, рккрлНрк░рлЗрко, рк▓рк╛ркЧркгрлА
ЁЯТФ => ЁЯТФ, ркдрлЛркбрк╡рлБркВ, ркнркЧрлНрки, ркнркЧрлНрки рк╣рлГркжркп, рк▓рк╛ркЧркгрлА, рк╣рлГркжркп, рк╣рлГркжркп ркнркВркЧ
ЁЯТХ => ЁЯТХ, рккрлНрк░рлЗрко, рккрлНрк░рлЗркорлАркУ, ркмрлЗ ркжрк┐рк▓, рк▓рк╛ркЧркгрлА
ЁЯТЦ => ЁЯТЦ, ркЪрк│ркХркдрлБркВ, ркЪрк│ркХркдрлБркВ ркжрк┐рк▓, рккрлНрк░рлЗрко, рк░рлЛркорк╛ркВркЪрк┐ркд, рк▓рк╛ркЧркгрлА
ЁЯТЧ => ЁЯТЧ, ркжрк┐рк▓, рккрлНрк░рлЗрко, ркорлВркВркЭрк╛ркпрлЗрк▓рлБркВ, рк░рлЛркорк╛ркВркЪрк┐ркд, рк▓рк╛ркЧркгрлА, рк╡ркзркдрлБркВ ркжрк┐рк▓
ЁЯТЩ => ЁЯТЩ, ркжрк┐рк▓, рк▓рк╛ркЧркгрлА, рк╡рк╛ркжрк│рлА, рк╡рк╛ркжрк│рлА ркжрк┐рк▓
ЁЯТЪ => ЁЯТЪ, ркжрк┐рк▓, рк▓рк╛ркЧркгрлА, рк▓рлАрк▓рлБркВ, рк▓рлАрк▓рлБркВ ркжрк┐рк▓
ЁЯТЫ => ЁЯТЫ, ркжрк┐рк▓, рккрлАрк│рлБркВ, рккрлАрк│рлБркВ ркжрк┐рк▓, рк▓рк╛ркЧркгрлА
ЁЯзб => ЁЯзб, ркирк╛рк░ркВркЧрлА ркжрк┐рк▓
ЁЯТЬ => ЁЯТЬ, ркЬрк╛ркВркмрк▓рлА, ркЬрк╛ркВркмрк▓рлА ркжрк┐рк▓, ркжрк┐рк▓, рк▓рк╛ркЧркгрлА
ЁЯЦд => ЁЯЦд, ркХрк╛рк│рлБркВ, ркХрк╛рк│рлБркВ рк╣рлГркжркп, ркЦрк░рк╛ркм, рк╣рлГркжркп
ЁЯТЭ => ЁЯТЭ, ркжрк┐рк▓, рк░рк┐ркмрки, рк░рк┐ркмрки рк╕рк╛ркерлЗркирлБркВ ркжрк┐рк▓, рк▓рк╛ркЧркгрлА, рк╡рлЗрк▓рлЗркирлНркЯрк╛ркЗрки
ЁЯТЮ => ЁЯТЮ, ркЖрк░рк╛ркзрлНркп, ркжрк┐рк▓, рккрлНрк░рлЗрко, ркнркоркдрк╛, ркнркоркдрк╛ ркжрк┐рк▓, рк▓рк╛ркЧркгрлА, рк╕рлБркВркжрк░
ЁЯТЯ => ЁЯТЯ, ркжрк┐рк▓, ркжрк┐рк▓ркирлЛ рк╢ркгркЧрк╛рк░
тЭг => тЭг, ркЙркжрлНркЧрк╛рк░рк╡рк╛ркЪркХ, ркЙркжрлНркЧрк╛рк░рк╡рк╛ркЪркХ ркЪрк┐рк╣рлНрки рк╕рк╛ркерлЗркирлБркВ рк╣рлГркжркп, ркЪрк┐рк╣рлНрки, рк╡рк┐рк░рк╛ркоркЪрк┐рк╣рлНрки, рк╣рлГркжркп
ЁЯТМ => ЁЯТМ, ркжрк┐рк▓, ркжрк┐рк▓ рк╕рк╛ркерлЗркирлЛ ркорлЗркЗрк▓, рккркдрлНрк░, рккрлНрк░рлЗрко рккркдрлНрк░, рк░рлЛркорк╛ркВрк╕
ЁЯТд => ЁЯТд, ркКркВркШркдрлБркВ, ркКркВркШрк░рлЗркЯрлА, ркирк╕ркХрлЛрк░рк╛, рк░ркорлВркЬрлА, рк▓рк╛ркЧркгрлА
ЁЯТв => ЁЯТв, ркХрлЛркорк┐ркХ, ркЧрлБрк╕рлНрк╕рк╛ркирлБркВ ркЪрк┐рк╣рлНрки, ркЧрлБрк╕рлНрк╕рлЗ ркеркпрлЗрк▓рлБркВ, ркЧрлБрк╕рлНрк╕рлЛ, рк▓рк╛ркЧркгрлА
ЁЯТг => ЁЯТг, ркмрлЛркорлНркм, рк░ркорлВркЬрлА, рк▓рк╛ркЧркгрлА
ЁЯТе => ЁЯТе, ркЯркХрлНркХрк░, ркЯркХрлНркХрк░ркирлБркВ рккрлНрк░ркдрлАркХ, рк░ркорлВркЬрлА, рк▓рк╛ркЧркгрлА
ЁЯТж => ЁЯТж, рккрк░рк╕рлЗрк╡рк╛ркирк╛ркВ ркЫрк╛ркВркЯрк╛, рккрк░рк╕рлЗрк╡рк╛ркирк╛ркВ ркЯрлАрккрк╛, рккрк░рк╕рлЗрк╡рлЛ, рккрлНрк░рк╕рлНрк╡рлЗркжркпрлБркХрлНркд, рк░ркорлВркЬрлА, рк▓рк╛ркЧркгрлА
ЁЯТи => ЁЯТи, ркЪрк╛рк▓рлБ ркбрлЗрк╢, ркбрлЗрк╢рк┐ркВркЧ, ркжрлЛркбрлЛ, ркнрк╛ркЧрк╡рлБркВ, рк░ркорлВркЬрлА, рк▓рк╛ркЧркгрлА
ЁЯТл => ЁЯТл, ркЪркХрлНркХрк░, ркдрк╛рк░рк╛, ркдрк╛рк░рк╛ ркЬрлЛрк╡рк╛, рк░ркорлВркЬрлА, рк▓рк╛ркЧркгрлА
ЁЯТм => ЁЯТм, рккрк░рккрлЛркЯрлЛ, рклрлБркЧрлНркЧрлЛ, ркнрк╛рк╖ркг рккрк░рккрлЛркЯрлЛ, ркнрк╛рк╖ркг рклрлБркЧрлНркЧрлЛ, рк░ркорлВркЬрлА, рк╕ркВрк╡рк╛ркж, рк╕ркВрк╡рк╛ркж рккрк░рккрлЛркЯрлЛ
ЁЯЧи => ЁЯЧи, ркбрк╛ркмрлБркВ рк╕рлНрккрлАркЪ ркмркмрк▓, рк╡рк╛ркгрлА, рк╕ркВрк╡рк╛ркж, рк╕рлНрккрлАркЪ
ЁЯЧп => ЁЯЧп, ркХрлНрк░рлЛркз, ркЬркоркгрлА ркдрк░рклркирлБркВ ркЧрлБрк╕рлНрк╕рк╛ркирлБркВ ркмркмрк▓, рккрк░рккрлЛркЯрлЛ, рккрк╛ркЧрк▓, рклрлБркЧрлНркЧрлЛ, ркмркмрк▓
ЁЯТн => ЁЯТн, рккрк░рккрлЛркЯрлЛ, рк░ркорлВркЬрлА, рк╡рк┐ркЪрк╛рк░, рк╡рк┐ркЪрк╛рк░ркирлЛ рккрк░рккрлЛркЯрлЛ, рк╡рк┐ркЪрк╛рк░ркирлЛ рклрлБркЧрлНркЧрлЛ
ЁЯХ│ => ЁЯХ│, ркХрк╛ркгрлБркВ, ркЫрк┐ркжрлНрк░
ЁЯСУ => ЁЯСУ, ркЖркВркЦркирк╛ркВ ркЪрк╢рлНркорк╛, ркХрккркбрк╛ркВ, ркЪрк╢рлНркорк╛
ЁЯХ╢ => ЁЯХ╢, ркЖркВркЦ, ркЪрк╢рлНркорк╛ркВ, рк╕ркиркЧрлНрк▓рк╛рк╕рлЗрк╕
ЁЯСФ => ЁЯСФ, ркХрккркбрк╛ркВ, ркЯрк╛ркЗ, ркирлЗркХркЯрк╛ркЗ
ЁЯСХ => ЁЯСХ, ркХрккркбрк╛ркВ, ркЯрлА-рк╢рк░рлНркЯ, рк╢рк░рлНркЯ
ЁЯСЦ => ЁЯСЦ, ркХрккркбрк╛ркВ, ркЬрлАркирлНрк╕, ркЯрлНрк░рк╛ркЙркЭрк░, рккрлЗркирлНркЯ
ЁЯзг => ЁЯзг, рк╕рлНркХрк╛ркл
ЁЯзд => ЁЯзд, рк╣рк╛ркеркирк╛ ркорлЛркЬрк╛ркВ
ЁЯзе => ЁЯзе, ркХрлЛркЯ
ЁЯзж => ЁЯзж, ркорлЛркЬрк╛ркВ
ЁЯСЧ => ЁЯСЧ, ркХрккркбрк╛ркВ, ркбрлНрк░рлЗрк╕, рк╡рки-рккрлАрк╕
ЁЯСШ => ЁЯСШ, ркХрккркбрк╛ркВ, ркХрк┐ркорлЛркирлЛ, ркбрлНрк░рлЗрк╕
ЁЯСЩ => ЁЯСЩ, ркХрккркбрк╛ркВ, ркирк╛рк╣рк╡рк╛ркирк╛ркВ ркХрккркбрк╛ркВ, ркмрк┐ркХрлАркирлА
ЁЯСЪ => ЁЯСЪ, ркХрккркбрк╛ркВ, рк╕рлНркдрлНрк░рлАркирк╛ркВ ркХрккркбрк╛ркВ
ЁЯСЫ => ЁЯСЫ, ркХрккркбрк╛ркВ, рккрк░рлНрк╕, рккрк╛ркХрлАркЯ, рккрлИрк╕рк╛ рк░рк╛ркЦрк╡рк╛ркирлБркВ рккрк╛ркХрлАркЯ, рк╕рк┐ркХрлНркХрлЛ
ЁЯСЬ => ЁЯСЬ, ркХрккркбрк╛ркВ, ркмрлЗркЧ, рк╣рлЗркирлНркбркмрлЗркЧ
ЁЯСЭ => ЁЯСЭ, ркХрккркбрк╛ркВ, рккрк╛ркЙркЪ, ркмрлЗркЧ
ЁЯЫН => ЁЯЫН, ркЦрк░рлАркжрлА, рк╢рлЛрккрк┐ркВркЧ, рк╢рлЛрккрк┐ркВркЧ ркмрлЗркЧрлНрк╕, рк╣рлЛркЯрк▓
ЁЯОТ => ЁЯОТ, ркжрклркдрк░, рк╕рлНркХрлВрк▓, рк╕рлНркХрлВрк▓ ркжрклркдрк░, рк╕рлНркХрлВрк▓ ркмрлЗркЧ, рк╕рлНркХрлВрк▓ркирлБркВ ркжрклркдрк░
ЁЯСЮ => ЁЯСЮ, ркХрккркбрк╛ркВ, ркЬрлВркдрк╛, рккрлБрк░рлБрк╖ркирк╛ ркЬрлВркдрк╛
ЁЯСЯ => ЁЯСЯ, ркХрккркбрк╛ркВ, ркЦрлЗрк▓ркХрлВркж ркорк╛ркЯрлЗркирк╛ркВ ркЬрлВркдрк╛, ркЬрлВркдрк╛, рк╕рлНркирлАркХрк░
ЁЯСа => ЁЯСа, ркЙркВркЪрлА рк╣рк┐рк▓, ркЙркВркЪрлА рк╣рк┐рк▓рк╡рк╛рк│рк╛ ркЬрлВркдрк╛, ркХрккркбрк╛ркВ, ркЬрлВркдрк╛
ЁЯСб => ЁЯСб, ркХрккркбрк╛ркВ, рк╕рлЗркирлНркбрк▓, рк╕рлНркдрлНрк░рлА, рк╕рлНркдрлНрк░рлАркирк╛ркВ рк╕рлЗркирлНркбрк▓
ЁЯСв => ЁЯСв, ркХрккркбрк╛ркВ, ркмрлВркЯ, рк╕рлНркдрлНрк░рлА, рк╕рлНркдрлНрк░рлАркирк╛ ркмрлВркЯ
ЁЯСС => ЁЯСС, ркХрккркбрк╛ркВ, ркорлБркХрлБркЯ
ЁЯСТ => ЁЯСТ, ркХрккркбрк╛ркВ, рк╕рлНркдрлНрк░рлАркирлА рк╣рлЗркЯ, рк╣рлЗркЯ
ЁЯОй => ЁЯОй, ркЯрлЛркк рк╣рлЗркЯ, ркоркирлЛрк░ркЬрки, рк╣рлЗркЯ
ЁЯОУ => ЁЯОУ, ркЙркЬрк╡ркгрлА, ркЯрлЛрккрлА, рк╕рлНркирк╛ркдркХ, рк╕рлНркирк╛ркдркХ ркЯрлЛрккрлА
ЁЯзв => ЁЯзв, ркмрк┐рк▓рк╡рк╛рк│рлА ркХрлЗркк
тЫС => тЫС, ркХрлНрк░рлЛрк╕, ркЪрк╣рлЗрк░рлЛ, ркЯрлЛрккрлА, ркоркжркж, ркорлБркЦ, рк╕рклрлЗркж ркХрлНрк░рлЛрк╕ рк╕рк╛ркерлЗркирлА рк╣рлЗрк▓рлНркорлЗркЯ, рк╕рк╣рк╛ркп, рк╣рлЗрк▓рлНркорлЗркЯ
ЁЯУ┐ => ЁЯУ┐, ркЬрк╛ркк, ркЬрк╛рккркирлА ркорк╛рк│рк╛, ркзрк░рлНрко, ркзрк╛рк░рлНркорк┐ркХ, рккрлНрк░рк╛рк░рлНркеркирк╛, ркоркгркХрк╛ркВ, ркорк╛рк│рк╛
ЁЯТД => ЁЯТД, ркХрлЛрк╕рлНркорлЗркЯрк┐ркХрлНрк╕, ркорлЗркХркЕркк, рк▓рк┐рккрк╕рлНркЯрк┐ркХ
ЁЯТН => ЁЯТН, рк░рлЛркорк╛ркВрк╕, рк╡рлАркВркЯрлА
ЁЯТО => ЁЯТО, ркбрк╛ркпркоркВркб, рк░ркдрлНрки, рк░ркдрлНрки рккркерлНркерк░, рк░рлЛркорк╛ркВрк╕
ЁЯР╡ => ЁЯР╡, ркЪрк╣рлЗрк░рлЛ, рккрлНрк░рк╛ркгрлА, рк╡рк╛ркВркжрк░рк╛ркирлЛ ркЪрк╣рлЗрк░рлЛ, рк╡рк╛ркВркжрк░рлЛ
ЁЯРТ => ЁЯРТ, рккрлНрк░рк╛ркгрлА, рк╡рк╛ркирк░
ЁЯжН => ЁЯжН, ркЧрлЛрк░рлАрк▓рк╛, рккрлНрк░рк╛ркгрлА
ЁЯР╢ => ЁЯР╢, ркЪрк╣рлЗрк░рлЛ, рккрлНрк░рк╛ркгрлА, рк╢рлНрк╡рк╛рки, рк╢рлНрк╡рк╛ркиркирлЛ ркЪрк╣рлЗрк░рлЛ
ЁЯРХ => ЁЯРХ, ркЧрк▓рлВркбрк┐ркпрлБркВ, рккрлНрк░рк╛ркгрлА, рк╢рлНрк╡рк╛рки
ЁЯРй => ЁЯРй, ркХрлБркдрк░рлЛ, рккрлВркбрк▓, рккрлНрк░рк╛ркгрлА
ЁЯР║ => ЁЯР║, ркЪрк╣рлЗрк░рлЛ, рккрлНрк░рк╛ркгрлА, рк╡рк░рлБ, рк╡рк░рлБркирлЛ ркЪрк╣рлЗрк░рлЛ
ЁЯжК => ЁЯжК, ркЪрк╣рлЗрк░рлЛ, рккрлНрк░рк╛ркгрлА, рк╢рк┐ркпрк╛рк│, рк╢рк┐ркпрк╛рк│ркирлЛ ркЪрк╣рлЗрк░рлЛ
ЁЯР▒ => ЁЯР▒, ркЪрк╣рлЗрк░рлЛ, рккрлНрк░рк╛ркгрлА, ркмрк┐рк▓рк╛ркбрлА, ркмрк┐рк▓рк╛ркбрлАркирлЛ ркЪрк╣рлЗрк░рлЛ
ЁЯРИ => ЁЯРИ, рккрлНрк░рк╛ркгрлА, ркмрк┐рк▓рк╛ркбрлА
ЁЯжБ => ЁЯжБ, рк░рк╛рк╢рк┐ ркЪрк┐рк╣рлНрки, рк╕рк┐ркВрк╣, рк╕рк┐ркВрк╣ркирлЛ ркЪрк╣рлЗрк░рлЛ
ЁЯРп => ЁЯРп, рккрлНрк░рк╛ркгрлА, рк╡рк╛ркШ, рк╡рк╛ркШркирлЛ ркЪрк╣рлЗрк░рлЛ
ЁЯРЕ => ЁЯРЕ, рккрлНрк░рк╛ркгрлА, рк╡рк╛ркШ
ЁЯРЖ => ЁЯРЖ, ркЪрк┐ркдрлНркдрлЛ, рккрлНрк░рк╛ркгрлА
ЁЯР┤ => ЁЯР┤, ркШрлЛркбрк╛ркирлЛ ркЪрк╣рлЗрк░рлЛ, ркШрлЛркбрлЛ, ркЪрк╣рлЗрк░рлЛ, рккрлНрк░рк╛ркгрлА
ЁЯРО => ЁЯРО, ркШрлЛркбрлЛ, рккрлНрк░рк╛ркгрлА
ЁЯжД => ЁЯжД, ркПркХ рк╢рк┐ркВркЧркбрк╛рк╡рк╛рк│рлЛ ркХрк╛рк▓рлНрккркирк┐ркХ ркШрлЛркбрлЛ, ркЪрк╣рлЗрк░рлЛ, ркорлБркЦ, ркпрлБркирк┐ркХрлЛрк░рлНрки, ркпрлБркирк┐ркХрлЛрк░рлНркиркирлЛ ркЪрк╣рлЗрк░рлЛ
ЁЯжУ => ЁЯжУ, ркЭрк┐ркмрлНрк░рк╛
ЁЯжМ => ЁЯжМ, рккрлНрк░рк╛ркгрлА, рк╣рк░ркг
ЁЯРо => ЁЯРо, ркЧрк╛ркп, ркЧрк╛ркпркирлЛ ркЪрк╣рлЗрк░рлЛ, ркЪрк╣рлЗрк░рлЛ, рккрлНрк░рк╛ркгрлА
ЁЯРВ => ЁЯРВ, рккрлНрк░рк╛ркгрлА, ркмрк│ркж
ЁЯРГ => ЁЯРГ, рккрк╛ркгрлА, рккрлНрк░рк╛ркгрлА, ркнрлЗркВрк╕
ЁЯРД => ЁЯРД, ркЧрк╛ркп, рккрлНрк░рк╛ркгрлА
ЁЯР╖ => ЁЯР╖, ркЪрк╣рлЗрк░рлЛ, ркбрлБркХрлНркХрк░, ркбрлБркХрлНркХрк░ркирлЛ ркЪрк╣рлЗрк░рлЛ, рккрлНрк░рк╛ркгрлА
ЁЯРЦ => ЁЯРЦ, ркбрлБркХрлНркХрк░, рккрлНрк░рк╛ркгрлА
ЁЯРЧ => ЁЯРЧ, рккрлНрк░рк╛ркгрлА, ркнрлВркВркб
ЁЯР╜ => ЁЯР╜, ркЪрк╣рлЗрк░рлЛ, ркбрлБркХрлНркХрк░ркирлБркВ ркирк╛ркХ, ркирк╛ркХ, рккрлНрк░рк╛ркгрлА
ЁЯРП => ЁЯРП, ркирк░ ркШрлЗркЯрлБркВ, рккрлНрк░рк╛ркгрлА, ркорлЗрк╖ рк░рк╛рк╢рк┐ ркЪрк┐рк╣рлНрки
ЁЯРС => ЁЯРС, ркШрлЗркЯрлБркВ, рккрлНрк░рк╛ркгрлА
ЁЯРР => ЁЯРР, рккрлНрк░рк╛ркгрлА, ркмркХрк░рлА, ркоркХрк░ рк░рк╛рк╢рк┐ ркЪрк┐рк╣рлНрки
ЁЯРк => ЁЯРк, ркКркВркЯ, ркПркХ ркЦрлВркВркзрк╡рк╛рк│рлБркВ ркКркВркЯ, ркЦрлВркВркз, ркбрлНрк░рлЛркорлЗркбрк░рлА, рккрлНрк░рк╛ркгрлА
ЁЯРл => ЁЯРл, ркКркВркЯ, ркЦрлВркВркз, рккрлНрк░рк╛ркгрлА, ркмрлЗ ркЦрлВркВркзрк╡рк╛рк│рлЛ ркКркВркЯ, ркмрлЗркХрлНркЯрлНрк░рк┐ркпрки
ЁЯжТ => ЁЯжТ, ркЬрк┐рк░рк╛ркл
ЁЯРШ => ЁЯРШ, рккрлНрк░рк╛ркгрлА, рк╣рк╛ркерлА
ЁЯжП => ЁЯжП, ркЧрлЗркВркбрлЛ, рккрлНрк░рк╛ркгрлА
ЁЯРн => ЁЯРн, ркЙркВркжрк░, ркЙркВркжрк░ркирлЛ ркЪрк╣рлЗрк░рлЛ, ркЪрк╣рлЗрк░рлЛ, рккрлНрк░рк╛ркгрлА
ЁЯРБ => ЁЯРБ, рккрлНрк░рк╛ркгрлА, ркорлВрк╖ркХ
ЁЯРА => ЁЯРА, ркЙркВркжрк░, рккрлНрк░рк╛ркгрлА
ЁЯР╣ => ЁЯР╣, ркЪрк╣рлЗрк░рлЛ, рккрлНрк░рк╛ркгрлА, рк╣рлЗркорлНрк╕рлНркЯрк░, рк╣рлЗркорлНрк╕рлНркЯрк░ркирлЛ ркЪрк╣рлЗрк░рлЛ
ЁЯР░ => ЁЯР░, ркЪрк╣рлЗрк░рлЛ, рккрлНрк░рк╛ркгрлА, рк╕рк╕рк▓рк╛ркирлЛ ркЪрк╣рлЗрк░рлЛ, рк╕рк╕рк▓рлБркВ
ЁЯРЗ => ЁЯРЗ, рккрлНрк░рк╛ркгрлА, рк╕рк╕рк▓рлБркВ
ЁЯР┐ => ЁЯР┐, ркЦрк┐рк╕ркХрлЛрк▓рлА, ркЪрк┐рккркоркВркХ
ЁЯжФ => ЁЯжФ, рк╣рлЗркЬрк╣рлЛркЧ
ЁЯжЗ => ЁЯжЗ, ркЪрк╛ркорк╛ркЪрлАркбрк┐ркпрлБркВ, рккрлНрк░рк╛ркгрлА, рк╡рлЕркорлНрккрк╛ркпрк░
ЁЯР╗ => ЁЯР╗, ркЪрк╣рлЗрк░рлЛ, рккрлНрк░рк╛ркгрлА, рк░рлАркВркЫ, рк░рлАркВркЫркирлЛ ркЪрк╣рлЗрк░рлЛ
ЁЯРи => ЁЯРи, ркХрлЛркЖрк▓рк╛, ркХрлЛркЖрк▓рк╛ рк░рлАркВркЫ, рккрлНрк░рк╛ркгрлА
ЁЯР╝ => ЁЯР╝, ркЪрк╣рлЗрк░рлЛ, рккрк╛ркирлНркбрк╛, рккрк╛ркирлНркбрк╛ркирлЛ ркЪрк╣рлЗрк░рлЛ, рккрлНрк░рк╛ркгрлА
ЁЯР╛ => ЁЯР╛, ркирк┐рк╢рк╛рки, рккркВркЬрк╛ркирлБркВ ркирк┐рк╢рк╛рки, рккркВркЬрлЛ, рккрлНрк░рк╛ркгрлА
ЁЯжГ => ЁЯжГ, ркЯрк░рлНркХрлА
ЁЯРФ => ЁЯРФ, ркЪрк┐ркХрки, рккрлНрк░рк╛ркгрлА, ркорк░ркШрлАркирлБркВ ркмркЪрлНркЪрлБркВ
ЁЯРУ => ЁЯРУ, ркХрлВркХркбрлЛ, рккрлНрк░рк╛ркгрлА
ЁЯРг => ЁЯРг, рккркХрлНрк╖рлАркирлБркВ ркмркЪрлНркЪрлБркВ, рккрлНрк░рк╛ркгрлА, ркмркЪрлНркЪрлБркВ, ркорк░ркШрлАркирлБркВ ркмркЪрлНркЪрлБркВ, рк╕рлЗрк╡рк╡рлБркВ, рк╕рлЗрк╡рк╛ркИ рк░рк╣рлЗрк▓рлБркВ ркмркЪрлНркЪрлБркВ
ЁЯРд => ЁЯРд, рккркХрлНрк╖рлАркирлБркВ ркмркЪрлНркЪрлБркВ, рккрлНрк░рк╛ркгрлА, ркмркЪрлНркЪрлБркВ, ркорк░ркШрлАркирлБркВ ркмркЪрлНркЪрлБркВ
ЁЯРе => ЁЯРе, ркЖркЧрк│ ркдрк░ркл ркЬрлЛркдрлБркВ рккркХрлНрк╖рлАркирлБркВ ркмркЪрлНркЪрлБркВ, рккркХрлНрк╖рлАркирлБркВ ркмркЪрлНркЪрлБркВ, рккрлНрк░рк╛ркгрлА, ркмркЪрлНркЪрлБркВ, ркорк░ркШрлАркирлБркВ ркмркЪрлНркЪрлБркВ, рк╕рк╛ркорлЗ ркЬрлЛркдрлБркВ рккркХрлНрк╖рлАркирлБркВ ркмркЪрлНркЪрлБркВ
ЁЯРж => ЁЯРж, рккркХрлНрк╖рлА, рккрлНрк░рк╛ркгрлА
ЁЯРз => ЁЯРз, рккрлЗркВркЧрлНрк╡рк┐рки, рккрлНрк░рк╛ркгрлА
ЁЯХК => ЁЯХК, ркХркмрлВркдрк░, рккркХрлНрк╖рлА, рк╢рк╛ркВркдрк┐
ЁЯжЕ => ЁЯжЕ, ркЧрк░рлБркб, рккркХрлНрк╖рлА
ЁЯжЖ => ЁЯжЖ, рккркХрлНрк╖рлА, ркмркдркХ
ЁЯжЙ => ЁЯжЙ, ркШрлБрк╡ркб, рккркХрлНрк╖рлА, ркмрлБркжрлНркзрк┐ркорк╛рки
ЁЯР╕ => ЁЯР╕, ркЪрк╣рлЗрк░рлЛ, ркжрлЗркбркХрк╛ркВркирлЛ ркЪрк╣рлЗрк░рлЛ, ркжрлЗркбркХрлЛ, рккрлНрк░рк╛ркгрлА
ЁЯРК => ЁЯРК, рккрлНрк░рк╛ркгрлА, ркоркЧрк░
ЁЯРв => ЁЯРв, ркХрк╛ркЪркмрлЛ, рккрлНрк░рк╛ркгрлА
ЁЯжО => ЁЯжО, ркЧрк░рлЛрк│рлА, рк╕рк░рк┐рк╕рлГркк
ЁЯРН => ЁЯРН, рккрлНрк░рк╛ркгрлА, рк╕рк╛ркк
ЁЯР▓ => ЁЯР▓, ркЪрк╣рлЗрк░рлЛ, ркжрлИркдрлНркп, ркжрлИркдрлНркпркирлЛ ркЪрк╣рлЗрк░рлЛ, рккрлНрк░рк╛ркгрлА
ЁЯРЙ => ЁЯРЙ, ркбрлНрк░рлЗркЧрки, рккрлНрк░рк╛ркгрлА
ЁЯжХ => ЁЯжХ, рк╕рлЛрк░рлЛрккрлЛркб
ЁЯжЦ => ЁЯжЦ, ркЯрлА-рк░рлЗркХрлНрк╕
ЁЯР│ => ЁЯР│, рккрк╛ркгрлА ркЙркЫрк╛рк│ркдрлА рк╡рлНрк╣рлЗрк▓, рккрк╛ркгрлА ркЙркЫрк╛рк│рк╡рлБркВ, рккрлНрк░рк╛ркгрлА, рк╡рлНрк╣рлЗрк▓
ЁЯРЛ => ЁЯРЛ, рккрлНрк░рк╛ркгрлА, рк╡рлНрк╣рлЗрк▓
ЁЯРм => ЁЯРм, ркбрлЛрк▓рлНрклрк┐рки, рккрлНрк░рк╛ркгрлА
ЁЯРЯ => ЁЯРЯ, рккрлНрк░рк╛ркгрлА, ркорк╛ркЫрк▓рлА
ЁЯРа => ЁЯРа, ркЙрк╖рлНркгркХркЯрк┐ркмркВркзрлАркп ркорк╛ркЫрк▓рлА, рккрлНрк░рк╛ркгрлА, ркорк╛ркЫрк▓рлА
ЁЯРб => ЁЯРб, рккрлНрк░рк╛ркгрлА, ркмрлНрк▓рлЛрклрк┐рк╢, ркмрлНрк▓рлЛрклрлАрк╢, ркорк╛ркЫрк▓рлА
ЁЯжИ => ЁЯжИ, ркорк╛ркЫрк▓рлА, рк╢рк╛рк░рлНркХ
ЁЯРЩ => ЁЯРЩ, ркУркХрлНркЯрлЛрккрк╕, рккрлНрк░рк╛ркгрлА
ЁЯРЪ => ЁЯРЪ, рккрлНрк░рк╛ркгрлА, рк╢рлЗрк▓, рк╕рк░рлНрккрк╛ркХрк╛рк░ рк╢рлЗрк▓
ЁЯжА => ЁЯжА, ркХрк░ркЪрк▓рлЛ, ркХрк░рлНркХ, рк░рк╛рк╢рк┐
ЁЯжР => ЁЯжР, ркХрк░ркЪрк▓рлЛ, ркЭрлАркВркЧрлБркВ, ркирк╛ркирлБркВ, ркнрлЛркЬрки
ЁЯжС => ЁЯжС, ркнрлЛркЬрки, рк╕рлНркХрлНрк╡рк┐ркб
ЁЯРМ => ЁЯРМ, ркЧрлЛркХрк│ркЧрк╛ркп, рккрлНрк░рк╛ркгрлА
ЁЯжЛ => ЁЯжЛ, ркЬркВркдрлБ, ркмркЯрк░рклрлНрк▓рк╛ркЗ, рк╕рлБркВркжрк░
ЁЯРЫ => ЁЯРЫ, ркЗркпрк│, ркХрк╛ркиркЦркЬрлВрк░рлЛ, ркЬркВркдрлБ, рккрлНрк░рк╛ркгрлА
ЁЯРЬ => ЁЯРЬ, ркХрлАркбрлА, рккрлНрк░рк╛ркгрлА
ЁЯРЭ => ЁЯРЭ, рккрлНрк░рк╛ркгрлА, ркоркзркорк╛ркЦрлА, ркоркзрлБркоркХрлНрк╖рк┐ркХрк╛
ЁЯРЮ => ЁЯРЮ, рккрлНрк░рк╛ркгрлА, ркнркорк░рлЛ, ркорк╛ркжрк╛, ркорк╛ркжрк╛ ркнркорк░рлА, ркорк╛ркжрк╛ ркорк╛ркВркХркб
ЁЯжЧ => ЁЯжЧ, ркХркВрк╕рк╛рк░рлА
ЁЯХ╖ => ЁЯХ╖, ркХрк░рлЛрк│рк┐ркпрлЛ, ркЬркВркдрлБ
ЁЯХ╕ => ЁЯХ╕, ркХрк░рлЛрк│рк┐ркпрк╛ркирлБркВ ркЬрк╛рк│рлБркВ, ркХрк░рлЛрк│рк┐ркпрлЛ, ркЬрк╛рк│рлБркВ
ЁЯжВ => ЁЯжВ, рк░рк╛рк╢рк┐, рк╡рлАркВркЫрлА, рк╕рлНркХрлЛрк░рлНрккрк┐ркпрлЛ
ЁЯТР => ЁЯТР, рккрлБрк╖рлНркк, ркмрлБркХрлЗ, рк░рлЛркорк╛ркВрк╕
ЁЯМ╕ => ЁЯМ╕, ркЪрлЗрк░рлА, ркЪрлЗрк░рлА рккрлБрк╖рлНркк, ркЪрлЗрк░рлА ркмрлНрк▓рлЛркЭрко, рккрлБрк╖рлНркк, рккрлБрк╖рлНркк ркЬрлЛрк╡рлБркВ
ЁЯТо => ЁЯТо, рклрлВрк▓, рклрлВрк▓ркирлЛ рк╕рк┐ркХрлНркХрлЛ, рк╢рлНрк╡рлЗркд рклрлВрк▓, рк╕рк░рк╕ ркХрк░рлНркпрлБркВркирлЛ рк╕рк┐ркХрлНркХрлЛ, рк╕рк┐ркХрлНркХрлЛ
ЁЯП╡ => ЁЯП╡, ркЫрлЛркб, рклрлАркдркирлБркВ ркЧрлБрк▓рк╛ркм
ЁЯМ╣ => ЁЯМ╣, ркЧрлБрк▓рк╛ркм, рклрлВрк▓
ЁЯеА => ЁЯеА, рклрлВрк▓, ркорлБрк░рлНркЬрк╛ркпрлЗрк▓рлБркВ, ркорлБрк░рлНркЬрк╛ркпрлЗрк▓рлБркВ рклрлВрк▓
ЁЯМ║ => ЁЯМ║, ркЬрк╛рк╕рлВркж, рклрлВрк▓
ЁЯМ╗ => ЁЯМ╗, рклрлВрк▓, рк╕рлВрк░рлНркпркорлБркЦрлА
ЁЯМ╝ => ЁЯМ╝, ркЪрлЗрк░рлА, рккрлБрк╖рлНркк
ЁЯМ╖ => ЁЯМ╖, ркЯрлНркпрлВрк▓рк┐ркк, рклрлВрк▓
ЁЯМ▒ => ЁЯМ▒, ркирк╛ркирлЛ, ркирк╛ркирлЛ ркЫрлЛркб, ркмрлАркЬ
ЁЯМ▓ => ЁЯМ▓, рк╡рлГркХрлНрк╖, рк╕ркжрк╛ркмрк╣рк╛рк░, рк╕ркжрк╛ркмрк╣рк╛рк░ рк╡рлГркХрлНрк╖
ЁЯМ│ => ЁЯМ│, ркЦрк░рк╛ркЙ, ркЦрк░рк╛ркЙ рк╡рлГркХрлНрк╖, рккрк░рлНркг ркЦрк░рк╡рк╛, рк╡рлГркХрлНрк╖
ЁЯМ┤ => ЁЯМ┤, ркдрк╛ркб, ркдрк╛ркбркирлБркВ рк╡рлГркХрлНрк╖, рк╡рлГркХрлНрк╖
ЁЯМ╡ => ЁЯМ╡, ркХрлЗркХрлНркЯрк╕, ркЫрлЛркб
ЁЯМ╛ => ЁЯМ╛, ркЪрлЛркЦрк╛, ркбрк╛ркВркЧрк░, ркбрлВркВркбрлБ
ЁЯМ┐ => ЁЯМ┐, ркЬркбрлАркмрлБркЯрлНркЯрлА, рккрк░рлНркг
тШШ => тШШ, ркЫрлЛркб, ркдрлНрк░ркг рккрк░рлНркг, ркдрлНрк░рк┐ркжрк▓ рккрк╛ркВркжркбрк╛рк╡рк╛рк│рлЛ ркПркХ ркЫрлЛркб
ЁЯНА => ЁЯНА, ркЪрк╛рк░, ркЪрк╛рк░ рккрк░рлНркг ркдрлНрк░рк┐ркжрк▓, ркдрлНрк░рк┐ркжрк▓, ркирк╕рлАркмркжрк╛рк░, рккрк░рлНркг
ЁЯНБ => ЁЯНБ, ркЦрк░рлА рккркбрлЗрк▓рлБркВ рккрк░рлНркг, рккрк░рлНркг, ркорлЗрккрк▓ рккрк░рлНркг
ЁЯНВ => ЁЯНВ, ркЦрк░ркдрлА, ркЦрк░ркдрлА рккрк╛ркВркжркбрлАркУ, ркЦрк░рлЗрк▓рлА, ркЦрк░рлЗрк▓рлА рккрк╛ркВркжркбрлАркУ, рккрк╛ркВркжркбрлА, рккрк╛ркВркжркбрлАркУ
ЁЯНГ => ЁЯНГ, рккрк░рлНркг, рккрк╡рки, рккрк╡ркиркорк╛ркВ ркЙркбркдрлБркВ рккрк░рлНркг, рклрлВркВркХрк╛ркдрлЛ рккрк╡рки, рклрлВркВркХрк╛рк╡рлБркВ
ЁЯНЗ => ЁЯНЗ, ркжрлНрк░рк╛ркХрлНрк╖, рклрк│
ЁЯНИ => ЁЯНИ, ркЯрлЗркЯрлА, ркдрк░ркмрлВркЪ, рклрк│
ЁЯНЙ => ЁЯНЙ, ркдрк░ркмрлВркЪ, рклрк│
ЁЯНК => ЁЯНК, ркирк╛ркирлБркВ ркЪрккркЯрлБркВ рк╕ркВркдрк░рлБркВ, ркирк╛рк░ркВркЧрлА, рклрк│
ЁЯНЛ => ЁЯНЛ, ркЦрк╛ркЯрлБркВ, рклрк│, рк▓рлАркВркмрлБ
ЁЯНМ => ЁЯНМ, ркХрлЗрк│рлБркВ, рклрк│
ЁЯНН => ЁЯНН, ркЕркирк╛ркирк╛рк╕, рклрк│
ЁЯНО => ЁЯНО, рклрк│, рк▓рк╛рк▓, рк▓рк╛рк▓ рк╕рклрк░ркЬрки, рк╕рклрк░ркЬрки
ЁЯНП => ЁЯНП, рклрк│, рк▓рлАрк▓рлБркВ, рк▓рлАрк▓рлБркВ рк╕рклрк░ркЬрки, рк╕рклрк░ркЬрки
ЁЯНР => ЁЯНР, ркирк╛рк╕рккрк╛ркдрлА, рклрк│
ЁЯНС => ЁЯНС, ркЖрк▓рлВ, рклрк│
ЁЯНТ => ЁЯНТ, ркЪрлЗрк░рлА рклрк│, ркЪрлЗрк░рлАркЭ
ЁЯНУ => ЁЯНУ, рклрк│, ркмрлЗрк░рлА, рк╕рлНркЯрлНрк░рлЛркмрлЗрк░рлА
ЁЯеЭ => ЁЯеЭ, ркХрк┐рк╡рлА, ркХрк┐рк╡рлА рклрк│, рклрк│, ркнрлЛркЬрки
ЁЯНЕ => ЁЯНЕ, ркЯрк╛ркорлЗркЯрлБркВ, рк╢рк╛ркХ
ЁЯее => ЁЯее, ркирк╛рк░рк┐ркпрлЗрк│
ЁЯеС => ЁЯеС, ркНрк╡ркХрк╛ркбрлЛ, рклрк│, ркнрлЛркЬрки
ЁЯНЖ => ЁЯНЖ, рк░рлАркВркЧркг, рк░рлАркВркЧркг, рк╢рк╛ркХ, рк╡рлЗркВркЧркг, рк╢рк╛ркХ
ЁЯеФ => ЁЯеФ, ркмркЯрк╛ркЯрлЛ, ркнрлЛркЬрки, рк╢рк╛ркХркнрк╛ркЬрлА
ЁЯеХ => ЁЯеХ, ркЧрк╛ркЬрк░, ркнрлЛркЬрки, рк╢рк╛ркХркнрк╛ркЬрлА
ЁЯМ╜ => ЁЯМ╜, ркбрлЛркбрлЛ, ркоркХрк╛ркИ
ЁЯМ╢ => ЁЯМ╢, ркЫрлЛркб, ркдрлАркЦрлБркВ, ркорк░ркЪрлБркВ, рк▓рк╛рк▓ ркорк░ркЪрлБркВ
ЁЯеТ => ЁЯеТ, ркЕркерк╛ркгрлБркВ, ркХрк╛ркХркбрлА, ркнрлЛркЬрки, рк╢рк╛ркХркнрк╛ркЬрлА
ЁЯеж => ЁЯеж, ркмрлНрк░рлЛркХрлЛрк▓рлА
ЁЯНД => ЁЯНД, ркЭрк╛ркб, ркорк╢рк░рлБрко
ЁЯеЬ => ЁЯеЬ, ркЕркЦрк░рлЛркЯ, ркнрлЛркЬрки, ркоркЧрклрк│рлА, рк╢рк╛ркХркнрк╛ркЬрлА
ЁЯМ░ => ЁЯМ░, ркЭрк╛ркб, ркмркжрк╛рко, ркмркжрк╛рко ркЬрлЗрк╡рлБркВ ркПркХ рклрк│
ЁЯНЮ => ЁЯНЮ, ркмрлНрк░рлЗркб, ркмрлНрк░рлЗркбркирлЛ рк░рлЛркЯрк▓рлЛ, рк░рлЗрк╕рлНркЯрлЛрк░ркирлНркЯ
ЁЯеР => ЁЯеР, ркХрлНрк░рлЛркЗрк╕рлИрки, рклрлНрк░рлЗркирлНркЪ, ркнрлЛркЬрки, рк░рлЛркЯрк▓рлА
ЁЯеЦ => ЁЯеЦ, рклрлНрк░рлЗркирлНркЪ, ркмрлЗркЧрлЗркЯ, ркмрлЗркЧрлЗркЯ рк░рлЛркЯрк▓рлА, ркнрлЛркЬрки, рк░рлЛркЯрк▓рлА
ЁЯеи => ЁЯеи, ркЯрлНрк╡рк┐рк╕рлНркЯрлЗркб, рккрлНрк░рлЗркЯрлНркЭрк▓
ЁЯеЮ => ЁЯеЮ, рккрлЕркирлНркХрлЗркХ, ркнрлЛркЬрки, рк╣рлЙркЯркХрлЗркХ
ЁЯзА => ЁЯзА, ркЪрлАркЭ, ркЪрлАркЭркирлЛ ркдрлНрк░рк┐ркХрлЛркгрк╛ркХрк╛рк░ ркЯрлБркХркбрлЛ, ркЯрлБркХркбрлЛ
ЁЯНЦ => ЁЯНЦ, ркорк╛ркВрк╕, рк░рлЗрк╕рлНркЯрлЛрк░ркирлНркЯ, рк╣рк╛ркбркХрк╛ркВ рккрк░ркирлБркВ ркорк╛ркВрк╕
ЁЯНЧ => ЁЯНЧ, ркЪрк┐ркХрки ркЯркВркЧркбрлА, ркЯркВркЧркбрлА, рккрлЛрк▓рлНркЯрлНрк░рлА, рк░рлЗрк╕рлНркЯрлЛрк░ркирлНркЯ
ЁЯей => ЁЯей, ркЪрлЛркк, рккрлЛрк░рлНркХркЪрлЛркк, ркорк╛ркВрк╕ркирлЛ ркЯрлБркХркбрлЛ, рк▓рлЗркорлНркмркЪрлЛркк, рк╕рлНркЯрлЗркХ
ЁЯеУ => ЁЯеУ, ркмрлЗркХрки, ркнрлЛркЬрки, ркорк╛ркВрк╕
ЁЯНФ => ЁЯНФ, ркмрк░рлНркЧрк░, рк░рлЗрк╕рлНркЯрлЛрк░ркирлНркЯ, рк╣рлЗркоркмрк░рлНркЧрк░
ЁЯНЯ => ЁЯНЯ, рклрлНрк░рк╛ркЗрк╕, рклрлНрк░рлЗркирлНркЪ рклрлНрк░рк╛ркЗрк╕, рк░рлЗрк╕рлНркЯрлЛрк░ркирлНркЯ
ЁЯНХ => ЁЯНХ, рккрк┐ркЭрк╛, рккрк┐ркЭрк╛ рк╕рлНрк▓рк╛ркЗрк╕, рк░рлЗрк╕рлНркЯрлЛрк░ркирлНркЯ, рк╕рлНрк▓рк╛ркЗрк╕
ЁЯМн => ЁЯМн, рклрлНрк░рлЗркВркХрклрк░рлНркЯрк░, рк╕рлЛрк╕рлЗркЬ, рк╣рлЛркЯ ркбрлЛркЧ
ЁЯек => ЁЯек, ркмрлНрк░рлЗркб, рк╕рлЕркирлНркбрк╡рк┐ркЪ
ЁЯМо => ЁЯМо, ркЯрк╛ркХрлЛ, ркорлЗркХрлНрк╕рк┐ркХрки, ркорлЗркХрлНрк╕рк┐ркХрки рк╡рк╛ркиркЧрлА
ЁЯМп => ЁЯМп, ркмрк░рк┐ркЯрлЛ, ркорлЗркХрлНрк╕рк┐ркХрки, ркорлЗркХрлНрк╕рк┐ркХрки рк╡рк╛ркиркЧрлА
ЁЯеЩ => ЁЯеЩ, ркХркмрк╛ркм, рклрк▓рк╛рклрк▓, рклрк▓рлЗркЯркмрлНрк░рлЗркб, ркнрк░рлЗрк▓рлА рклрк▓рлЗркЯркмрлНрк░рлЗркб, ркнрк░рлЗрк▓рлБркВ, ркнрлЛркЬрки
ЁЯеЪ => ЁЯеЪ, ркИркВркбрлБркВ, ркнрлЛркЬрки
ЁЯН│ => ЁЯН│, ркХркбрк╛ркИ, рк░рк╛ркВркзрк╡рлБркВ, рк░рлЗрк╕рлНркЯрлЛрк░ркирлНркЯ
ЁЯеШ => ЁЯеШ, ркХрлЕрк╕рк░рлЛрк▓, ркЫрлАркЫрк░рлЛ, ркЫрлАркЫрк░рлЛ ркдрк╡рлЛ, ркдрк╡рлЛ, ркнрлЛркЬрки
ЁЯН▓ => ЁЯН▓, ркнрлЛркЬркиркирлБркВ рк╡рк╛рк╕ркг, рк░рлЗрк╕рлНркЯрлЛрк░ркирлНркЯ, рк╡рк╛рк╕ркгркорк╛ркВркирлЛ ркЦрлЛрк░рк╛ркХ, рк╕рлНркЯрлНркпрлВ
ЁЯег => ЁЯег, ркХрлЛркирлНркЬрлА, ркмрлНрк░рлЗркХрклрк╛рк╕рлНркЯ, рк╕рк┐рк░рлАркЕрк▓, рк╕рлНрккрлВрки рк╕рк╛ркерлЗ ркмрлЛрк▓
ЁЯеЧ => ЁЯеЧ, ркнрлЛркЬрки, рк▓рлАрк▓рлБркВ, рк▓рлАрк▓рлБркВ рк╕рлЕрк▓ркб, рк╕рлЕрк▓ркб
ЁЯН┐ => ЁЯН┐, рккрлЙрккркХрлЛрк░рлНрки, ркоркХрк╛ркИркирк╛ рк╢рлЗркХрлЗрк▓рк╛ ркжрк╛ркгрк╛
ЁЯел => ЁЯел, ркХрлЕрки, ркХрлЗркирлНркб рклрлВркб
ЁЯН▒ => ЁЯН▒, ркмрлЗркирлНркЯрлЛ, ркмрлЗркирлНркЯрлЛ ркмрлЛркХрлНрк╕, ркмрлЛркХрлНрк╕, рк░рлЗрк╕рлНркЯрлЛрк░ркирлНркЯ
ЁЯНШ => ЁЯНШ, ркЪрлЛркЦрк╛, ркЪрлЛркЦрк╛ркирлА ркХркХрк░рлА ркмрк┐рк╕рлНркХрлАркЯ, ркЪрлЛркЦрк╛ркирлА┬аркХркХрк░рлА ркмрк┐рк╕рлНркХрлАркЯ
ЁЯНЩ => ЁЯНЩ, ркУркирк┐ркЧрк┐рк░рлА, ркнрк╛ркдркирк╛ркВ рк╡ркбрк╛, рк░рлЗрк╕рлНркЯрлЛрк░ркирлНркЯ
ЁЯНЪ => ЁЯНЪ, ркЪрлЛркЦрк╛, ркнрк╛ркд, рк░рлЗрк╕рлНркЯрлЛрк░рлЗркирлНркЯ
ЁЯНЫ => ЁЯНЫ, ркХркврлА, ркХркврлА ркЕркирлЗ ркнрк╛ркд, ркнрк╛ркд, рк░рлЗрк╕рлНркЯрлЛрк░рлЗркирлНркЯ
ЁЯНЬ => ЁЯНЬ, ркирлБркбрк▓, ркирлБркбрк▓рлНрк╕, ркирлБркбрк▓рлНрк╕ркирлЛ рк╡рк╛ркЯркХрлЛ, рк░ркорлЗрки, рк░рлЗрк╕рлНркЯрлЛрк░ркирлНркЯ, рк╡рк░рк╛рк│ ркирлАркХрк│ркдрк╛ркВ, рк╡рк░рк╛рк│ ркирлАркХрк│ркдрлЛ рккрлНркпрк╛рк▓рлЛ, рк╡рк╛ркЯркХрлЛ
ЁЯНЭ => ЁЯНЭ, рккрк╛рк╕рлНркдрк╛, рк░рлЗрк╕рлНркЯрлЛрк░ркирлНркЯ, рк╕рлНрккркЧрлЗркЯрлА
ЁЯНа => ЁЯНа, ркЧрк│рлНркпрлБркВ, рк░рлЗрк╕рлНркЯрлЛрк░ркирлНркЯ, рк╢ркХрлНркХрк░рк┐ркпрлБркВ, рк╢рлЗркХрлЗрк▓рк╛ркВ ркмркЯрк╛ркХрк╛, рк╢рлЗркХрлЗрк▓рлБркВ, рк╢рлЗркХрлЗрк▓рлБркВ рк╢ркХрлНркХрк░рк┐ркпрлБркВ
ЁЯНв => ЁЯНв, ркУркбрлЗрки, рк░рлЗрк╕рлНркЯрлЛрк░ркирлНркЯ, рк╕рлА рклрлВркб, рк╕рлНркЯрлАркХ, рк╕рлНркЯрлАркХ рккрк░ рк╕рлА рклрлВркб
ЁЯНг => ЁЯНг, рк░рлЗрк╕рлНркЯрлЛрк░ркирлНркЯ, рк╕рлБрк╢рлА
ЁЯНд => ЁЯНд, ркЭрлАркВркЧрк╛, ркдрк│рлЗрк▓рлА ркЭрлАркВркЧрк╛ ркорк╛ркЫрк▓рлА, рк░рлЗрк╕рлНркЯрлЛрк░ркирлНркЯ
ЁЯНе => ЁЯНе, рклрк┐рк╢ ркХрлЗркХ, рклрлАрк╢ ркХрлЗркХ, ркорк╛ркЫрк▓рлА, рк░рлЗрк╕рлНркЯрлЛрк░ркирлНркЯ, рк╡ркорк│рк╡рк╛рк│рлА рклрлАрк╢ ркХрлЗркХ
ЁЯНб => ЁЯНб, ркбрлЗркирлНркЧрлЛ, ркорлЛркЪрлА, ркорлЛркЪрлА ркмрлЛрк▓рлНрк╕, рк░рлЗрк╕рлНркЯрлЛрк░ркирлНркЯ, рк▓рк╛ркХркбрлА рккрк░ ркорлЛркЪрлА ркмрлЛрк▓рлНрк╕
ЁЯеЯ => ЁЯеЯ, empanada, gy┼Нza, jiaozi, pierogi, potsticker, ркбркорлНрккрк▓рк┐ркВркЧ
ЁЯеа => ЁЯеа, рккрлНрк░рлЙрклрк┐рк╕рлА, рклрлЙрк░рлНркЪрлБрки ркХрлБркХрк┐
ЁЯеб => ЁЯеб, ркСркЗрк╕рлНркЯрк░ рккрлИрк▓, ркЯрлЗркХркЖркЙркЯ ркмрлЙркХрлНрк╕
ЁЯНж => ЁЯНж, ркЖркЗрк╕ ркХрлНрк░рлАрко, ркХрлНрк░рлАрко, рк░рлЗрк╕рлНркЯрлЛрк░ркирлНркЯ, рк╕рлЛрклрлНркЯ ркЖркЗрк╕ ркХрлНрк░рлАрко, рк╕рлЛрклрлНркЯ рк╕рк░рлНрк╡
ЁЯНз => ЁЯНз, ркЖркЗрк╕, рк░рлЗрк╕рлНркЯрлЛрк░ркирлНркЯ, рк╢рлЗрк╡рлНркб, рк╢рлЗрк╡рлНркб ркЖркЗрк╕ ркХрлНрк░рлАрко
ЁЯНи => ЁЯНи, ркЖркЗрк╕, ркЖркЗрк╕ ркХрлНрк░рлАрко, ркХрлНрк░рлАрко, рк░рлЗрк╕рлНркЯрлЛрк░ркирлНркЯ
ЁЯНй => ЁЯНй, ркбрлЛркиркЯ, ркорлАркарк╛ркИ, рк░рлЗрк╕рлНркЯрлЛрк░ркирлНркЯ
ЁЯНк => ЁЯНк, ркХрлБркХрлА, рк░рлЗрк╕рлНркЯрлЛрк░ркирлНркЯ
ЁЯОВ => ЁЯОВ, ркЙркЬрк╡ркгрлА, ркХрлЗркХ, ркЬркирлНркоркжрк┐рк╡рк╕, ркЬркирлНркоркжрк┐рк╡рк╕ ркХрлЗркХ, ркЬркирлНркоркжрк┐рк╡рк╕ркирлА ркХрлЗркХ
ЁЯН░ => ЁЯН░, ркХрк╛рккрлЗрк▓рлА ркХрлЗркХ, ркХрлЗркХ, ркирк╛ркирлА ркХрлЗркХ, рк░рлЗрк╕рлНркЯрлЛрк░ркирлНркЯ
ЁЯез => ЁЯез, рккрк╛ркЗ, рккрлЗрк╕рлНркЯрлНрк░рлА, рклрк┐рк▓рк┐ркВркЧ
ЁЯНл => ЁЯНл, ркЪрлЛркХрк▓рлЗркЯ, ркЪрлЛркХрк▓рлЗркЯ ркмрк╛рк░, ркмрк╛рк░, рк░рлЗрк╕рлНркЯрлЛрк░ркирлНркЯ
ЁЯНм => ЁЯНм, ркХрлЗркирлНркбрлА, рк░рлЗрк╕рлНркЯрлЛрк░ркирлНркЯ
ЁЯНн => ЁЯНн, ркХрлЗркирлНркбрлА, рк░рлЗрк╕рлНркЯрлЛрк░ркирлНркЯ, рк▓рлЛрк▓рк┐рккрлЛркк
ЁЯНо => ЁЯНо, ркХрк╕рлНркЯрк░рлНркб, рккрлБркбрк┐ркВркЧ, рк░рлЗрк╕рлНркЯрлЛрк░ркирлНркЯ
ЁЯНп => ЁЯНп, ркоркз, ркоркзркирлБркВ рк╡рк╛рк╕ркг, рк░рлЗрк╕рлНркЯрлЛрк░ркирлНркЯ, рк╡рк╛рк╕ркг
ЁЯН╝ => ЁЯН╝, ркжрлВркз, рккрлАркгрлБркВ, ркмрлЛркЯрк▓, рк╢рк┐рк╢рлБ ркмрлЛркЯрк▓, рк╢рк┐рк╢рлБркирлА ркмрлЛркЯрк▓
ЁЯеЫ => ЁЯеЫ, ркЧрлНрк▓рк╛рк╕, ркжрлБркз, ркжрлБркзркирлЛ ркЧрлНрк▓рк╛рк╕, рккрлАркгрлБркВ
тШХ => тШХ, ркЙркХрк│ркдрлБркВ, ркХрлЙрклрлА, ркЧрк░рко, ркЧрк░рко рккрлАркгрлБркВ, ркЪрк╛, рккрлЗркп
ЁЯН╡ => ЁЯН╡, ркЪрк╛, ркЪрк╛ ркорк╛ркЯрлЗркирлЛ ркХркк, ркЪрк╛ркирлЛ ркХркк, ркжрк╛ркВркбрлА рк╡ркЧрк░ркирлЛ ркЪрк╛ркирлЛ ркХркк, рккрлАркгрлБркВ
ЁЯН╢ => ЁЯН╢, ркХркк, ркЪрлЛркЦрк╛ркирк╛ркВ ркжрк╛рк░рлБркирлА ркмрлЛркЯрк▓ ркЕркирлЗ ркХркк, ркЪрлЛркЦрк╛ркирлЛ ркжрк╛рк░рлВ, рккрлАркгрлБркВ, ркмрк╛рк░, ркмрлЛркЯрк▓, рк░рлЗрк╕рлНркЯрлЛрк░ркирлНркЯ, рк╕рлЗркХ
ЁЯН╛ => ЁЯН╛, ркХрлЙрк░рлНркХ, ркХрлЙрк░рлНркХ ркЦрлБрк▓ркдрлА ркмрк╛ркЯрк▓рлА, ркЦрлБрк▓ркдрлА, ркбрлНрк░рк┐ркВркХ, ркмрк╛ркЯрк▓рлА, ркмрк╛рк░
ЁЯН╖ => ЁЯН╖, ркЧрлНрк▓рк╛рк╕, рккрлАркгрлБркВ, ркмрк╛рк░, рк░рлЗрк╕рлНркЯрлЛрк░ркирлНркЯ, рк╡рк╛ркЗрки, рк╡рк╛ркЗрки ркорк╛ркЯрлЗркирлЛ ркЧрлНрк▓рк╛рк╕, рк╡рк╛ркЗркиркирлЛ ркЧрлНрк▓рк╛рк╕
ЁЯН╕ => ЁЯН╕, ркХрлЛркХркЯрлЗркЗрк▓, ркХрлЛркХркЯрлЗркЗрк▓ ркЧрлНрк▓рк╛рк╕, ркмрк╛рк░, рк░рлЗрк╕рлНркЯрлЛрк░ркирлНркЯ
ЁЯН╣ => ЁЯН╣, ркЙрк╖рлНркгркХркЯрк┐ркмркВркзрлАркп, ркЙрк╖рлНркгркХркЯрк┐ркмркВркзрлАркп рккрлАркгрлБркВ, рккрлАркгрлБркВ, ркмрк╛рк░, рк░рлЗрк╕рлНркЯрлЛрк░ркирлНркЯ
ЁЯН║ => ЁЯН║, ркмрк╛рк░, ркмрлАркЕрк░, ркмрлАркЕрк░ ркоркЧ, ркоркЧ, рк░рлЗрк╕рлНркЯрлЛрк░ркирлНркЯ
ЁЯН╗ => ЁЯН╗, ркЕркбркХрк╛ркдрк╛ркВ ркмрлАркЕрк░ ркоркЧрлНрк╕, ркмрк╛рк░, ркмрлАркЕрк░, ркмрлАркЕрк░ ркоркЧ, ркоркЧ, ркоркЧрлНрк╕, рк░рлЗрк╕рлНркЯрлЛрк░ркирлНркЯ
ЁЯеВ => ЁЯеВ, ркЙркЬрк╡ркгрлА, ркХрлНрк▓рк┐ркВркХ, ркХрлНрк▓рк┐ркирлНркХрлАркВркЧ ркЧрлНрк▓рк╛рк╕, ркЧрлНрк▓рк╛рк╕, рккрлАркгрлБркВ
ЁЯеГ => ЁЯеГ, ркЧрлНрк▓рк╛рк╕, ркЯркорлНркмрлНрк▓рк░, ркЯркорлНркмрлНрк▓рк░ ркЧрлНрк▓рк╛рк╕, ркжрк╛рк░рлВ, рк╡рк┐рк╕рлНркХрлА, рк╢рлЙркЯ
ЁЯед => ЁЯед, ркЬрлВрк╕, рк╕рлЛркбрк╛, рк╕рлНркЯрлНрк░рлЙ рк╕рк╛ркерлЗ ркХркк
ЁЯев => ЁЯев, ркЪрлЙрккрлНрк╕рлНркЯрк┐ркХрлНрк╕, рк╣рк╛рк╢рлА
ЁЯН╜ => ЁЯН╜, ркХрк╛ркВркЯрлНркк, ркЫрк░рлА, ркерк╛рк│рлА, рккрлНрк▓рлЗркЯ, рккрлНрк▓рлЗркЯ рк╕рк╛ркерлЗ ркЫрк░рлА ркЕркирлЗ ркХрк╛ркВркЯрлЛ, рк░рк╕рлЛркИ
ЁЯН┤ => ЁЯН┤, ркХрк╛ркВркЯрлЛ, ркЫрк░рлА, ркЫрк░рлА ркЕркирлЗ ркХрк╛ркВркЯрлЛ, рк░рлЗрк╕рлНркЯрлЛрк░ркирлНркЯ
ЁЯеД => ЁЯеД, ркЪркоркЪрлА, ркЫрк░рлАркХрк╛ркВркЯрк╛
ЁЯФк => ЁЯФк, ркЪрк╛ркХрлБ, рк░рк╕рлЛркбрк╛ркирлЛ ркЪрк╛ркХрлБ
ЁЯП║ => ЁЯП║, ркХрлБркВркн, ркЬркЧ, ркбрлНрк░рк┐ркВркХ, рккрлАркгрлБркВ, ркмрк░ркгрлА, рк░рк╕рлЛркИ, рк░рк╛рк╢рк┐, рк╣ркерк┐ркпрк╛рк░
ЁЯМН => ЁЯМН, ркЖрклрлНрк░рк┐ркХрк╛, ркЧрлНрк▓рлЛркм, рккрлГркерлНрк╡рлА, ркпрлБрк░рлЛркк, ркпрлБрк░рлЛркк-ркЖрклрлНрк░рк┐ркХрк╛ ркмркдрк╛рк╡ркдрлА ркЧрлНрк▓рлЛркм
ЁЯМО => ЁЯМО, ркЕркорлЗрк░рк┐ркХрк╛, ркЕркорлЗрк░рк┐ркХрк╛ркЭ ркмркдрк╛рк╡ркдрлА ркЧрлНрк▓рлЛркм, ркЧрлНрк▓рлЛркм, рккрлГркерлНрк╡рлА
ЁЯМП => ЁЯМП, ркПрк╢рк┐ркпрк╛, ркПрк╢рк┐ркпрк╛-ркУрк╕рлНркЯрлНрк░рлЗрк▓рк┐ркпрк╛ ркмркдрк╛рк╡ркдрлА ркЧрлНрк▓рлЛркм, ркУрк╕рлНркЯрлНрк░рлЗрк▓рк┐ркпрк╛, ркЧрлНрк▓рлЛркм, рккрлГркерлНрк╡рлА
ЁЯМР => ЁЯМР, ркЧрлНрк▓рлЛркм, ркпрк╛ркорлНркпрлЛркдрлНркдрк░ рк╡рлГркдрлНркд, ркпрк╛ркорлНркпрлЛркдрлНркдрк░ рк╡рлГркдрлНркд ркмркдрк╛рк╡ркдрлА ркЧрлНрк▓рлЛркм
ЁЯЧ║ => ЁЯЧ║, ркиркХрк╢рлЛ, рк╡рк┐рк╢рлНрк╡, рк╡рк┐рк╢рлНрк╡ркирлЛ ркиркХрк╢рлЛ
ЁЯЧ╛ => ЁЯЧ╛, ркЬрк╛рккрк╛рки, ркЬрк╛рккрк╛ркиркирлЛ ркиркХрк╢рлЛ, ркиркХрк╢рлЛ
ЁЯПФ => ЁЯПФ, рккрк╣рк╛ркб, ркмрк░ркл, ркмрк░рклркирк╛ рк╢рк┐ркЦрк░рк╡рк╛рк│рлЛ рккрк░рлНрк╡ркд, рк╣рк┐рко
тЫ░ => тЫ░, рккрк░рлНрк╡ркд, рккрк╣рк╛ркб
ЁЯМЛ => ЁЯМЛ, ркЬрлНрк╡рк╛рк│рк╛ркорлБркЦрлА, ркЬрлНрк╡рк╛рк│рк╛ркорлБркЦрлА рк╡рк┐рк╕рлНрклрлЛркЯ
ЁЯЧ╗ => ЁЯЧ╗, рккрк░рлНрк╡ркд, ркорк╛. рклрлБркЬрлА, ркорк╛ркЙркирлНркЯ рклрлБркЬрлА
ЁЯПХ => ЁЯПХ, ркХрлЗркорлНрккрк┐ркВркЧ, ркдркВркмрлБ рк▓ркЧрк╛рк╡рк╡рлЛ
ЁЯПЦ => ЁЯПЦ, ркЫркдрлНрк░рлА, ркЫркдрлНрк░рлА рк╕рк╛ркерлЗркирлЛ рк╕ркорлБркжрлНрк░ркдркЯ
ЁЯПЬ => ЁЯПЬ, рк░ркг, рк░ркгрккрлНрк░ркжрлЗрк╢
ЁЯПЭ => ЁЯПЭ, ркЖркЗрк▓рлЗркирлНркб, ркжрлНрк╡рк┐ркк, рк░ркгркорк╛ркВ ркжрлНрк╡рк┐ркк
ЁЯПЮ => ЁЯПЮ, рккрк╛рк░рлНркХ, ркмркЧрлАркЪрлЛ, рк░рк╛рк╖рлНркЯрлНрк░рлАркп ркЙркжрлНркпрк╛рки
ЁЯПЯ => ЁЯПЯ, рк╕рлНркЯрлЗркбрк┐ркпрко
ЁЯПЫ => ЁЯПЫ, ркИркорк╛рк░ркд, ркХрлНрк▓рк╛рк╕рк┐ркХрк▓ ркмрк┐рк▓рлНркбрк┐ркВркЧ, ркЬрлВркирлА
ЁЯПЧ => ЁЯПЧ, ркИркорк╛рк░ркд, ркирк┐рк░рлНркорк╛ркг, ркмрк┐рк▓рлНркбрк┐ркВркЧ, ркмрк┐рк▓рлНркбрк┐ркВркЧркирлБркВ ркмрк╛ркВркзркХрк╛рко
ЁЯПШ => ЁЯПШ, ркИркорк╛рк░ркд, ркШрк░, ркШрк░ркирлА ркИркорк╛рк░ркдрлЛ, ркмрк┐рк▓рлНркбрк┐ркВркЧ
ЁЯПЩ => ЁЯПЩ, рк╢рк╣рлЗрк░, рк╢рк╣рлЗрк░рлА ркИркорк╛рк░ркдрлЛ
ЁЯПЪ => ЁЯПЪ, ркШрк░, рк╡рлЗрк░рк╛рки, рк╡рлЗрк░рк╛рки ркШрк░ркирлА ркмрк┐рк▓рлНркбрк┐ркВркЧ
ЁЯПа => ЁЯПа, ркИркорк╛рк░ркд, ркЧрлГрк╣, ркШрк░, ркШрк░ркирлА ркИркорк╛рк░ркд, ркмрк┐рк▓рлНркбрк┐ркВркЧ
ЁЯПб => ЁЯПб, ркИркорк╛рк░ркд, ркЧрлГрк╣, ркШрк░, ркмркЧрлАркЪрк╛рк╡рк╛рк│рлБркВ ркШрк░, ркмрк╛ркЧ
ЁЯПв => ЁЯПв, ркИркорк╛рк░ркд, ркХрк╛рк░рлНркпрк╛рк▓ркп, ркХрк╛рк░рлНркпрк╛рк▓ркпркирлА ркИркорк╛рк░ркд
ЁЯПг => ЁЯПг, ркИркорк╛рк░ркд, ркЬрк╛рккрк╛ркирлА, ркЬрк╛рккрк╛ркирлА рккрлЛрк╕рлНркЯ ркСрклрк┐рк╕, рккрлЛрк╕рлНркЯ, рккрлЛрк╕рлНркЯ ркСрклрк┐рк╕
ЁЯПд => ЁЯПд, ркИркорк╛рк░ркд, ркЬрк╛рккрк╛ркирлА, рккрлЛрк╕рлНркЯ, рккрлЛрк╕рлНркЯ ркСрклрк┐рк╕, ркпрлБрк░рлЛрккрк┐ркпрки рккрлЛрк╕рлНркЯ ркСрклрк┐рк╕
ЁЯПе => ЁЯПе, ркИркорк╛рк░ркд, рк╣рлЛрк╕рлНрккрк┐ркЯрк▓
ЁЯПж => ЁЯПж, ркИркорк╛рк░ркд, ркмрлЗркВркХ
ЁЯПи => ЁЯПи, ркИркорк╛рк░ркд, рк╣рлЛркЯрк▓
ЁЯПй => ЁЯПй, ркИркорк╛рк░ркд, рккрлНрк░рлЗрко, рккрлНрк░рлЗрко рк╣рлЛркЯрк▓, рк╣рлЛркЯрк▓
ЁЯПк => ЁЯПк, ркИркорк╛рк░ркд, рк╕рлБрк╡рк┐ркзрк╛, рк╕рлБрк╡рк┐ркзрк╛ рк╕рлНркЯрлЛрк░, рк╕рлНркЯрлЛрк░
ЁЯПл => ЁЯПл, ркИркорк╛рк░ркд, рк╢рк╛рк│рк╛, рк╢рк╛рк│рк╛ркирлА ркИркорк╛рк░ркд
ЁЯПм => ЁЯПм, ркбрлАрккрк╛рк░рлНркЯркорлЗркирлНркЯ, ркбрлАрккрк╛рк░рлНркЯркорлЗркирлНркЯ рк╕рлНркЯрлЛрк░, рк╕рлНркЯрлЛрк░
ЁЯПн => ЁЯПн, ркИркорк╛рк░ркд, рклрлЗркХрлНркЯрк░рлА
ЁЯПп => ЁЯПп, ркИркорк╛рк░ркд, ркХрк┐рк▓рлНрк▓рлЛ, ркЬрк╛рккрк╛ркирлА ркХрк┐рк▓рлНрк▓рлЛ
ЁЯП░ => ЁЯП░, ркИркорк╛рк░ркд, ркХрк┐рк▓рлНрк▓рлЛ, ркЬрк╛рккрк╛ркирлА ркХрк┐рк▓рлНрк▓рлЛ
ЁЯТТ => ЁЯТТ, ркжрлЗрк╡ркХрлБрк▓рк┐ркХрк╛, рк░рлЛркорк╛ркВрк╕, рк▓ркЧрлНрки, рк▓ркЧрлНрки ркорк╛ркЯрлЗркирлА ркжрлЗрк╡ркХрлБрк▓рк┐ркХрк╛
ЁЯЧ╝ => ЁЯЧ╝, ркЯрк╛рк╡рк░, ркЯрлЛркХрлНркпрлЛ, ркЯрлЛркХрлНркпрлЛ ркЯрк╛рк╡рк░
ЁЯЧ╜ => ЁЯЧ╜, рккрлНрк░ркдрк┐ркорк╛, рк╕рлНркЯрлЗркЪрлНркпрлБ ркСркл рк▓рк┐ркмрк░рлНркЯрлА, рк╕рлНрк╡ркдркВркдрлНрк░ркдрк╛
тЫк => тЫк, ркЪрк░рлНркЪ, ркнрк╡рки
ЁЯХМ => ЁЯХМ, ркЗрк╕рлНрк▓рк╛рко, ркзрк░рлНрко, ркорк╕рлНркЬрк┐ркж, ркорлБрк╕рлНрк▓рк┐рко
ЁЯХН => ЁЯХН, ркзрк░рлНрко, ркоркВркжрк┐рк░, ркпрк╣рлВркжрлА рккрлНрк░рк╛рк░рлНркеркирк╛ркЧрлГрк╣
тЫй => тЫй, ркЬрк╛рккрк╛ркирлА ркзрк░рлНркорк╕рлНркерк│, ркзрк░рлНрко, рк╢рк┐ркВркЯрлЛ рк╢рлНрк░рк╛ркЗрки
ЁЯХЛ => ЁЯХЛ, ркЗрк╕рлНрк▓рк╛рко, ркХрк╛ркмрк╛, ркзрк░рлНрко, ркорлБрк╕рлНрк▓рк┐рко
тЫ▓ => тЫ▓, рклрлБрк╡рк╛рк░рлЛ
тЫ║ => тЫ║, ркХрлЗркорлНрккрк┐ркВркЧ, ркдркВркмрлБ
ЁЯМБ => ЁЯМБ, ркзрлБркорлНркорк╕, ркзрлБркорлНркорк╕рк┐ркпрлБркВ
ЁЯМГ => ЁЯМГ, ркдрк╛рк░рк╛, ркдрк╛рк░рк╛ рк╕рк╛ркерлЗркирлБркВ ркЖркХрк╛рк╢, рк░рк╛ркд, рк░рк╛ркдркирк╛ ркдрк╛рк░рк╛
ЁЯМД => ЁЯМД, рккрк░рлНрк╡ркд, рккрк░рлНрк╡ркдрлЛ рккрк░ рк╕рлВрк░рлНркпрлЛркжркп, рк╕рк╡рк╛рк░ркирлЛ рк╕рлВрк░рлНркп, рк╕рлВрк░рлНркпрлЛркжркп
ЁЯМЕ => ЁЯМЕ, рк╕рк╡рк╛рк░ркирлЛ рк╕рлВрк░рлНркп, рк╕рлВрк░рлНркпрлЛркжркп
ЁЯМЖ => ЁЯМЖ, ркоркХрк╛рки, рк▓рлЗркирлНркбрк╕рлНркХрлЗркк, рк╢рк╣рлЗрк░, рк╕ркорлАрк╕рк╛ркВркЬ, рк╕рк╛ркВркЬ, рк╕рк╛ркВркЬркирк╛ рк╕ркоркпрлЗ рк╢рк╣рлЗрк░, рк╕рлВрк░рлНркпрк╛рк╕рлНркд
ЁЯМЗ => ЁЯМЗ, ркИркорк╛рк░ркд, ркИркорк╛рк░ркдрлЛ рккрк░ рк╕рлВрк░рлНркпрк╛рк╕рлНркд, рк╕ркорлАрк╕рк╛ркВркЬ, рк╕рлВрк░рлНркпрк╛рк╕рлНркд
ЁЯМЙ => ЁЯМЙ, ркирк╛ркЗркЯ ркмрлНрк░рк┐ркЬ, рк░рк╛ркд, рк░рк╛ркдркирк╛ рк╕ркоркпрлЗ ркмрлНрк░рк┐ркЬ, рк░рк╛ркдрлНрк░рлЗ рккрлБрк▓
тЩи => тЩи, ркЙркХрк│ркдрк╛ркВ, ркЧрк░рко, ркЧрк░рко рккрк╛ркгрлАркирк╛ ркЭрк░рк╛, ркЭрк░рк╛, рк╡рк░рк╛рк│ ркирлАркХрк│ркдрк╛ркВ
ЁЯММ => ЁЯММ, ркЖркХрк╛рк╢ркЧркВркЧрк╛, ркжрлВркзрк┐ркпрлБркВ
ЁЯОа => ЁЯОа, ркШрлЛркбрк╛ркирлА ркмрлЗркаркХрк╡рк╛рк│рлЛ ркЪркХркбрлЛрк│, ркШрлЛркбрлЛ, ркЪркХркбрлЛрк│, ркоркирлЛрк░ркВркЬрки
ЁЯОб => ЁЯОб, ркПркорлНркпрлБркЭркорлЗркирлНркЯ рккрк╛рк░рлНркХ, ркЪркЧркбрлЛрк│, рккрлИркбрлБркВ, рклрлЗрк░рлАрк╕, рклрлЗрк░рлАрк╕ рк╡рлНрк╣рлАрк▓, ркоркирлЛрк░ркВркЬрки
ЁЯОв => ЁЯОв, ркПркорлНркпрлБркЭркорлЗркирлНркЯ рккрк╛рк░рлНркХ, ркХрлЛрк╕рлНркЯрк░, ркоркирлЛрк░ркВркЬрки, рк░рлЛрк▓рк░, рк░рлЛрк▓рк░ ркХрлЛрк╕рлНркЯрк░
ЁЯТИ => ЁЯТИ, ркерк╛ркВркнрк▓рлЛ, рк╡рк╛рк│ркВркж, рк╡рк╛рк│ркВркжркирлА ркжрлБркХрк╛рки, рк╡рк╛рк│ркВркжркирлЛ ркерк╛ркВркнрк▓рлЛ
ЁЯОк => ЁЯОк, ркдркВркмрлБ, ркоркирлЛрк░ркВркЬрки, рк╕рк░рлНркХрк╕, рк╕рк░рлНркХрк╕ ркдркВркмрлБ, рк╕рк░рлНркХрк╕ркирлБркВ ркдркВркмрлБ
ЁЯОн => ЁЯОн, ркХрк│рк╛, ркЪрк╣рлЗрк░рк╛ркирлБркВ ркорк╣рлЛрк░рлБркВ, ркоркирлЛрк░ркВркЬрки, рк▓рк▓рк┐ркд, рк▓рк▓рк┐ркд ркХрк│рк╛
ЁЯЦ╝ => ЁЯЦ╝, ркХрк▓рк╛, ркХрк▓рк╛ркХрлГркдрк┐, ркЪрк┐ркдрлНрк░, ркЪрк┐ркдрлНрк░ рк╕рк╛ркерлЗркирлА рклрлНрк░рлЗрко, рклрлНрк░рлЗрко, рк╕ркВркЧрлНрк░рк╣рк╛рк▓ркп
ЁЯОи => ЁЯОи, ркЖрк░рлНркЯрк┐рк╕рлНркЯ, ркЖрк░рлНркЯрк┐рк╕рлНркЯ рккрлЗрк▓рлЗркЯ, ркХрк│рк╛, рккрлЗркЗркирлНркЯ рккрлЗрк▓рлЗркЯ, рккрлЗркИркирлНркЯ, рккрлЗрк▓рлЗркЯ
ЁЯО░ => ЁЯО░, рк░ркоркд, рк╕рлНрк▓рлЛркЯ, рк╕рлНрк▓рлЛркЯ ркорк╢рлАрки
ЁЯЪВ => ЁЯЪВ, ркПркирлНркЬрк┐рки, ркЯрлНрк░рлЗрки, рк╡рк░рк╛рк│ ркПркирлНркЬрк┐рки, рк╡рк╛рк╣рки
ЁЯЪГ => ЁЯЪГ, ркЗрк▓рлЗркХрлНркЯрлНрк░рк┐ркХ, ркЗрк▓рлЗркХрлНркЯрлНрк░рк┐ркХ ркЯрлНрк░рлЗрки, ркЯрлНрк░рк╛рко, ркЯрлНрк░рлЗрки, рк░рлЗрк▓рлНрк╡рлЗ, рк░рлЗрк▓рлНрк╡рлЗ ркХрк╛рк░, рк╡рк╛рк╣рки
ЁЯЪД => ЁЯЪД, ркЯрлНрк░рлЗрки, рк╡рк╛рк╣рки, рк╢рк┐ркВркХркирк╕рлЗрки, рк╣рк╛ркЗ-рк╕рлНрккрлАркб ркЯрлНрк░рлЗрки, рк╣рк╛ркЗ-рк╕рлНрккрлАркб ркЯрлНрк░рлЗрки, рк╢рк┐ркВркХркирк╕рлЗрки, ркЯрлНрк░рлЗрки, рк╡рк╛рк╣рки
ЁЯЪЕ => ЁЯЪЕ, ркЖркЧрк│ркерлА ркмрлБрк▓рлЗркЯркирк╛ ркЖркХрк╛рк░ркирлА ркЙркЪрлНркЪ-ркЧркдрк┐ркирлА ркЯрлНрк░рлЗрки, ркЯрлНрк░рлЗрки, ркмрлБрк▓рлЗркЯ ркирлЛркЭ, ркмрлБрк▓рлЗркЯ ркирлЛркЭ рк╕рк╛ркерлЗркирлБркВ рк╢рк┐ркВркХркирк╕рлЗрки, рк╡рк╛рк╣рки, рк╢рк┐ркВркХркирк╕рлЗрки, рк╣рк╛ркЗ-рк╕рлНрккрлАркб ркЯрлНрк░рлЗрки
ЁЯЪЖ => ЁЯЪЖ, ркЯрлНрк░рлЗрки, рк░рлЗрк▓рлНрк╡рлЗ, рк╡рк╛рк╣рки
ЁЯЪЗ => ЁЯЪЗ, ркорлЗркЯрлНрк░рлЛ, рк╡рк╛рк╣рки, рк╕ркмрк╡рлЗ
ЁЯЪИ => ЁЯЪИ, рк░рлЗрк▓, рк▓рк╛ркЗркЯ, рк▓рк╛ркЗркЯ рк░рлЗрк▓, рк╡рк╛рк╣рки
ЁЯЪЙ => ЁЯЪЙ, ркЯрлНрк░рлЗрки, ркЯрлНрк░рлЗрки рк╕рлНркЯрлЗрк╢рки, рк╕рлНркЯрлЗрк╢рки
ЁЯЪК => ЁЯЪК, ркЯрлНрк░рк╛рко, рк╡рк╛рк╣рки
ЁЯЪЭ => ЁЯЪЭ, ркорлЛркирлЛрк░рлЗрк▓, рк╡рк╛рк╣рки
ЁЯЪЮ => ЁЯЪЮ, ркХрк╛рк░, рккрк░рлНрк╡ркд, рккрк░рлНрк╡ркдрлЛркирлА ркХрлЕркмрк▓ ркХрк╛рк░, рккрк░рлНрк╡ркдрлЛркирлА рк░рлЗрк▓рлНрк╡рлЗ, рк░рлЗрк▓рлНрк╡рлЗ, рк╡рк╛рк╣рки
ЁЯЪЛ => ЁЯЪЛ, ркХрк╛рк░, ркЯрлНрк░рк╛рко, ркЯрлНрк░рк╛рко ркХрк╛рк░, рк╡рк╛рк╣рки
ЁЯЪМ => ЁЯЪМ, ркмрк╕, рк╡рк╛рк╣рки
ЁЯЪН => ЁЯЪН, ркЖрк╡ркирк╛рк░рлА, ркЖрк╡ркирк╛рк░рлА ркмрк╕, ркЖрк╡рлА рк░рк╣рлЗрк▓ ркмрк╕, ркмрк╕, рк╡рк╛рк╣рки
ЁЯЪО => ЁЯЪО, ркЯрлНрк░рлЛрк▓рлА, ркЯрлНрк░рлЛрк▓рлАркмрк╕, ркмрк╕, рк╡рк╛рк╣рки
ЁЯЪР => ЁЯЪР, ркмрк╕, ркорк┐ркирк┐ркмрк╕, рк╡рк╛рк╣рки
ЁЯЪС => ЁЯЪС, ркПркорлНркмрлНркпрлБрк▓ркирлНрк╕, рк╡рк╛рк╣рки
ЁЯЪТ => ЁЯЪТ, ркПркирлНркЬрк┐рки, рклрк╛ркпрк░, рклрк╛ркпрк░ ркПркирлНркЬрк┐рки, рклрк╛ркпрк░ ркЯрлНрк░ркХ, рк╡рк╛рк╣рки
ЁЯЪУ => ЁЯЪУ, рккрлЗркЯрлНрк░рлЛрк▓ ркХрк╛рк░, рккрлЛрк▓рлАрк╕, рккрлЛрк▓рлАрк╕ ркХрк╛рк░, рккрлЛрк▓рлАрк╕ркирлА ркХрк╛рк░, рк╡рк╛рк╣рки
ЁЯЪФ => ЁЯЪФ, ркЖрк╡ркирк╛рк░рлА рккрлЛрк▓рлАрк╕ ркХрк╛рк░, ркЖрк╡рлА рк░рк╣рлЗрк▓ рккрлЛрк▓рлАрк╕ ркХрк╛рк░, рккрлЛрк▓рлАрк╕, рккрлЛрк▓рлАрк╕ ркХрк╛рк░, рк╡рк╛рк╣рки
ЁЯЪХ => ЁЯЪХ, ркЯрлЕркХрлНрк╕рлА, рк╡рк╛рк╣рки
ЁЯЪЦ => ЁЯЪЦ, ркЖрк╡ркирк╛рк░рлА ркЯрлЕркХрлНрк╕рлА, ркЖрк╡рлА рк░рк╣рлЗрк▓ ркЯрлЕркХрлНрк╕рлА, ркЯрлЕркХрлНрк╕рлА, рк╡рк╛рк╣рки
ЁЯЪЧ => ЁЯЪЧ, ркСркЯрлЛркорлЛркмрк╛ркЗрк▓, ркХрк╛рк░, рк╡рк╛рк╣рки
ЁЯЪШ => ЁЯЪШ, ркЖрк╡ркирк╛рк░, ркЖрк╡ркирк╛рк░ ркСркЯрлЛркорлЛркмрк╛ркЗрк▓, ркЖрк╡ркирк╛рк░рлА ркХрк╛рк░, ркЖрк╡рлА рк░рк╣рлЗрк▓ ркСркЯрлЛркорлЛркмрк╛ркЗрк▓, ркСркЯрлЛркорлЛркмрк╛ркЗрк▓, ркХрк╛рк░, рк╡рк╛рк╣рки
ЁЯЪЩ => ЁЯЪЩ, RV, ркХрк╛рк░, ркоркирлЛрк░ркВркЬрки рк╡рк╛рк╣рки, рк╡рк╛рк╣рки
ЁЯЪЪ => ЁЯЪЪ, ркЯрлНрк░ркХ, рк╡рк╛рк╣рки, рк╡рк┐ркдрк░ркг ркЯрлНрк░ркХ
ЁЯЪЫ => ЁЯЪЫ, ркХрк▓рк╛ркдрлНркоркХ ркЦркЯрк╛рк░рлЛ, ркЦркЯрк╛рк░рлЛ, ркЯрлНрк░ркХ, ркЯрлНрк░рлЗрк▓рк░, рк╡рк╛рк╣рки, рк╕рлЗркорлА
ЁЯЪЬ => ЁЯЪЬ, ркЯрлНрк░рлЗркХрлНркЯрк░, рк╡рк╛рк╣рки
ЁЯЪ▓ => ЁЯЪ▓, ркмрк╛ркЗркХ, ркмрк╛ркЗрк╕рк┐ркХрк▓, рк╡рк╛рк╣рки, рк╕рк╛ркЗркХрк▓
ЁЯЫ┤ => ЁЯЫ┤, ркХрк┐ркХ, ркХрк┐ркХ рк╕рлНркХрлВркЯрк░, рк╕рлНркХрлВркЯрк░
ЁЯЫ╡ => ЁЯЫ╡, ркорлЛркЯрк░, ркорлЛркЯрк░ рк╕рлНркХрлВркЯрк░, рк╕рлНркХрлВркЯрк░
ЁЯЪП => ЁЯЪП, ркмрк╕, ркмрк╕ рк╕рлНркЯрлЛркк, рк╕рлНркЯрлЛркк
ЁЯЫг => ЁЯЫг, ркзрлЛрк░рлАркорк╛рк░рлНркЧ, ркорк╛рк░рлНркЧ, ркорлЛркЯрк░рк╡рлЗ, рк░рк╕рлНркдрлЛ, рк░рлЛркб, рк╣рк╛ркЗрк╡рлЗ
ЁЯЫд => ЁЯЫд, ркЯрлНрк░рлЗрки, рк░рлЗрк▓рк╡рлЗ, рк░рлЗрк▓рлНрк╡рлЗ ркЯрлНрк░рлЗркХ
тЫ╜ => тЫ╜, ркЧрлЗрк╕, ркЧрлЗрк╕ рк╕рлНркЯрлЗрк╢рки, рклрлНркпрлБркЕрк▓, рклрлНркпрлБркЕрк▓ рккркорлНркк, рк╕рлНркЯрлЗрк╢рки
ЁЯЪи => ЁЯЪи, рккрлЛрк▓рк┐рк╕ркирлА ркХрк╛рк░ркирлА рк▓рк╛ркЗркЯ, рккрлЛрк▓рлАрк╕ ркХрк╛рк░, рккрлЛрк▓рлАрк╕ ркмрлАркХрки, рккрлЛрк▓рлАрк╕ рк▓рк╛ркЗркЯ, рклрк░ркдрлА рк▓рк╛ркЗркЯ
ЁЯЪе => ЁЯЪе, ркЖркбрлА ркЯрлНрк░рк╛рклрк┐ркХ рк▓рк╛ркЗркЯ, ркЯрлНрк░рк╛рклрк┐ркХ, ркЯрлНрк░рк╛рклрк┐ркХ рк▓рк╛ркЗркЯрлНрк╕, ркЯрлНрк░рк╛рклрк┐ркХ рк╕рк┐ркЧрлНркирк▓рлНрк╕, рк▓рк╛ркЗркЯ
ЁЯЪж => ЁЯЪж, ркКркнрлА ркЯрлНрк░рк╛рклрк┐ркХ рк▓рк╛ркЗркЯ, ркЯрлНрк░рк╛рклрк┐ркХ, ркЯрлНрк░рк╛рклрк┐ркХ рк▓рк╛ркЗркЯрлНрк╕, ркЯрлНрк░рк╛рклрк┐ркХ рк╕рк┐ркЧрлНркирк▓рлНрк╕, рк▓рк╛ркЗркЯ
ЁЯЪз => ЁЯЪз, ркЪрк┐рк╣рлНрки, ркмрк╛ркВркзркХрк╛рко, ркмрк╛ркВркзркХрк╛рко рк╣рлЗркарк│ ркЫрлЗ, ркмрк╛ркВркзркХрк╛ркоркирлБркВ ркЪрк┐рк╣рлНрки
ЁЯЫС => ЁЯЫС, ркЕрк╖рлНркЯркХрлЛркг, рк░рлЛркХрлЛ, рк░рлЛркХрлЛ рк╕ркВркХрлЗркд, рк╕ркВркХрлЗркд
тЪУ => тЪУ, ркПркВркХрк░, ркЪрк┐рк╣рлНрки
тЫ╡ => тЫ╡, ркпрк╛ркЪ, рк░рк┐рк╕рлЙрк░рлНркЯ, рк╕ркврк╡рк╛рк│рлА рк╣рлЛркбрлА, рк╕ркорлБркжрлНрк░рлА рк░рк┐рк╕рлЙрк░рлНркЯ, рк╣рлЛркбрлА
ЁЯЫ╢ => ЁЯЫ╢, ркХрлЕркирлЛркИ, рк╣рлЛркбрлА
ЁЯЪд => ЁЯЪд, рк╡рк╛рк╣рки, рк╕рлНрккрлАркбркмрлЛркЯ, рк╣рлЛркбрлА
ЁЯЫ│ => ЁЯЫ│, ркпрк╛ркдрлНрк░рлА, ркпрк╛ркдрлНрк░рлА рк╡рк╣рк╛ркг, рк╡рк╣рк╛ркг, рк╡рк╛рк╣рки
тЫ┤ => тЫ┤, ркирк╛рк╡ркбрлА, рклрлЗрк░рлА, ркмрлЛркЯ, рк╣рлЛркбрлА
ЁЯЫе => ЁЯЫе, ркмрлЛркЯ, ркорлЛркЯрк░ ркмрлЛркЯ, рк╡рк╛рк╣рки
ЁЯЪв => ЁЯЪв, ркЬрк╣рк╛ркЬ, рк╡рк╣рк╛ркг, рк╡рк╛рк╣рки
тЬИ => тЬИ, ркПрк░рккрлНрк▓рлЗрки, рк╡рк┐ркорк╛рки, рк╣рк╡рк╛ркИ рк╡рк╛рк╣рки
ЁЯЫй => ЁЯЫй, ркирк╛ркирлБркВ ркПрк░рккрлНрк▓рлЗрки, рк╡рк┐ркорк╛рки
ЁЯЫл => ЁЯЫл, ркПрк░рккрлНрк▓рлЗркиркирлА рк░рк╡рк╛ркиркЧрлА, ркЪрлЗркХ-ркЗрки, рккрлНрк░рк╕рлНркерк╛рки, рк╡рк╛рк╣рки
ЁЯЫм => ЁЯЫм, ркЖрк╡рлА рк░рк╣рлНркпрлБркВ ркЫрлЗ, ркПрк░рккрлНрк▓ркиркирлБркВ ркЖркЧркорки, рк▓рлЗркирлНркбрк┐ркВркЧ, рк╡рк╛рк╣рки
ЁЯТ║ => ЁЯТ║, ркЦрлБрк░рк╢рлА, ркмрлЗркаркХ, рк╕рлАркЯ
ЁЯЪБ => ЁЯЪБ, рк╡рк╛рк╣рки, рк╣рлЗрк▓рк┐ркХрлЛрккрлНркЯрк░
ЁЯЪЯ => ЁЯЪЯ, рк░рлЗрк▓рлНрк╡рлЗ, рк╡рк╛рк╣рки, рк╕рк╕рлНрккрлЗркирлНрк╢рки, рк╕рк╕рлНрккрлЗркирлНрк╢рки рк░рлЗрк▓рлНрк╡рлЗ
ЁЯЪа => ЁЯЪа, ркХрк╛рк░, ркХрлЕркмрк▓, рккрк░рлНрк╡ркд, рккрк░рлНрк╡ркдрлЛркирлА ркХрлЕркмрк▓ ркХрк╛рк░, рккрк░рлНрк╡ркдрлЛркирлА ркХрлЕркмрк▓рк╡рлЗ, рк╡рк╛рк╣рки
ЁЯЪб => ЁЯЪб, ркХрлЕркмрк▓ ркХрк╛рк░, ркЧркВркбрлЛрк▓рк╛, ркЯрлНрк░рк╛ркорк╡рлЗ, рк░рлЛрккрк╡рлЗ, рк╡рк╛рк╣рки, рк╣рк╡рк╛ркИ, рк╣рк╡рк╛ркИ ркЯрлНрк░рк╛ркорк╡рлЗ
ЁЯЫ░ => ЁЯЫ░, ркЕрк╡ркХрк╛рк╢, рк╡рк╛рк╣рки, рк╕рлЗркЯрлЗрк▓рк╛ркЗркЯ
ЁЯЪА => ЁЯЪА, рк░рлЙркХрлЗркЯ, рк╡рк╛рк╣рки
ЁЯЫ╕ => ЁЯЫ╕, UFO, рклрлНрк▓рк╛ркЗркВркЧ рк╕рлЙрк╕рк░
ЁЯЫО => ЁЯЫО, ркШркВркЯркбрлА, ркШркВркЯрлА, ркмрлЗрк▓рк╣рлЛркк ркШркВркЯркбрлА, рк╣рлЛркЯрк▓
ЁЯЪк => ЁЯЪк, ркжрк░рк╡рк╛ркЬрлЛ
ЁЯЫП => ЁЯЫП, ркКркВркШ, ркирк┐ркВркжрлНрк░рк╛, рккркерк╛рк░рлА, рк╣рлЛркЯрк▓
ЁЯЫЛ => ЁЯЫЛ, ркХрк╛ркЙркЪ, ркХрк╛ркЙркЪ ркЕркирлЗ рк▓рлЗркорлНркк, рк▓рлЗркорлНркк, рк╕рлЛрклрлЛ, рк╣рлЛркЯрк▓
ЁЯЪ╜ => ЁЯЪ╜, ркЯрлЙркЗрк▓рлЗркЯ
ЁЯЪ┐ => ЁЯЪ┐, рк╢рк╛рк╡рк░, рк╢рлЙрк╡рк░
ЁЯЫБ => ЁЯЫБ, ркирк╛рк╣рк╡рлБркВ, ркмрк╛рке, ркмрк╛рке ркЯркм
тМЫ => тМЫ, рк░рлЗркдркШркбрлА, рк░рлЗркдрлА, рк╕ркоркп
тП│ => тП│, ркЕрк╡рк░ркЧрлНрк▓рк╛рк╕, ркЯрк╛ркЗркорк░, рк░рлЗркдркШркбрлА, рк╡рк╣рлЗркдрлА рк░рлЗркдрлА рк╕рк╛ркерлЗркирлА рк░рлЗркдркШркбрлА, рк╕ркоркп, рк╕рлЗркирлНркб ркЯрк╛ркЗркорк░
тМЪ => тМЪ, ркХрк╛ркВркбрк╛ ркШркбрк┐ркпрк╛рк│, ркШркбрк┐ркпрк╛рк│, рк╕ркоркп
тП░ => тП░, ркПрк▓рк╛рк░рлНрко, ркПрк▓рк╛рк░рлНрко ркШркбрк┐ркпрк╛рк│, ркШркбрк┐ркпрк╛рк│, рк╕ркоркп
тП▒ => тП▒, ркШркбрк┐ркпрк╛рк│, рк╕ркоркп, рк╕рлНркЯрлЛрккрк╡рлЙркЪ
тП▓ => тП▓, ркШркбрк┐ркпрк╛рк│, ркЯрк╛ркЗркорк░, ркЯрк╛ркЗркорк░ ркШркбрк┐ркпрк╛рк│, рк╕ркоркп
ЁЯХ░ => ЁЯХ░, ркШркбрк┐ркпрк╛рк│, ркорлЗркВркЯрк▓рккрлАрк╕ ркШркбрк┐ркпрк╛рк│, рк╕ркоркп
ЁЯХЫ => ЁЯХЫ, 12 рк╡рк╛ркЧрлНркпрлЗ, 12:00, ркШркбрк┐ркпрк╛рк│, ркмрк╛рк░, ркмрк╛рк░ рк╡рк╛ркЧрлНркпрлЗ
ЁЯХз => ЁЯХз, 12:30, ркШркбрк┐ркпрк╛рк│, рк╕рк╛ркбрк╛ ркмрк╛рк░
ЁЯХР => ЁЯХР, 1 рк╡рк╛ркЧрлНркпрлЗ, 1:00, ркПркХ, ркПркХ рк╡рк╛ркЧрлНркпрлЗ, ркШркбрк┐ркпрк╛рк│
ЁЯХЬ => ЁЯХЬ, 1:30, ркШркбрк┐ркпрк╛рк│, ркжрлЛркв
ЁЯХС => ЁЯХС, 2 рк╡рк╛ркЧрлНркпрлЗ, 2:00, ркШркбрк┐ркпрк╛рк│, ркмрлЗ, ркмрлЗ рк╡рк╛ркЧрлНркпрлЗ
ЁЯХЭ => ЁЯХЭ, 2:30, ркЕркврлА, ркШркбрк┐ркпрк╛рк│
ЁЯХТ => ЁЯХТ, 3 рк╡рк╛ркЧрлНркпрлЗ, 3:00, ркШркбрк┐ркпрк╛рк│, ркдрлНрк░ркг, ркдрлНрк░ркг рк╡рк╛ркЧрлНркпрлЗ
ЁЯХЮ => ЁЯХЮ, 3:30, ркШркбрк┐ркпрк╛рк│, рк╕рк╛ркбрк╛ ркдрлНрк░ркг
ЁЯХУ => ЁЯХУ, 4 рк╡рк╛ркЧрлНркпрлЗ, 4:00, ркШркбрк┐ркпрк╛рк│, ркЪрк╛рк░, ркЪрк╛рк░ рк╡рк╛ркЧрлНркпрлЗ
ЁЯХЯ => ЁЯХЯ, 4:30, ркШркбрк┐ркпрк╛рк│, рк╕рк╛ркбрк╛ ркЪрк╛рк░
ЁЯХФ => ЁЯХФ, 5 рк╡рк╛ркЧрлНркпрлЗ, 5:00, ркШркбрк┐ркпрк╛рк│, рккрк╛ркВркЪ, рккрк╛ркВркЪ рк╡рк╛ркЧрлНркпрлЗ
ЁЯХа => ЁЯХа, 5:30, ркШркбрк┐ркпрк╛рк│, рк╕рк╛ркбрк╛ рккрк╛ркВркЪ
ЁЯХХ => ЁЯХХ, 6 рк╡рк╛ркЧрлНркпрлЗ, 6:00, ркШркбрк┐ркпрк╛рк│, ркЫ, ркЫ рк╡рк╛ркЧрлНркпрлЗ
ЁЯХб => ЁЯХб, 6:30, ркШркбрк┐ркпрк╛рк│, рк╕рк╛ркбрк╛ ркЫ
ЁЯХЦ => ЁЯХЦ, 7 рк╡рк╛ркЧрлНркпрлЗ, 7:00, ркШркбрк┐ркпрк╛рк│, рк╕рк╛ркд, рк╕рк╛ркд рк╡рк╛ркЧрлНркпрлЗ
ЁЯХв => ЁЯХв, 7:30, ркШркбрк┐ркпрк╛рк│, рк╕рк╛ркбрк╛ рк╕рк╛ркд
ЁЯХЧ => ЁЯХЧ, 8 рк╡рк╛ркЧрлНркпрлЗ, 8:00, ркЖрка, ркЖрка рк╡рк╛ркЧрлНркпрлЗ, ркШркбрк┐ркпрк╛рк│
ЁЯХг => ЁЯХг, 8:30, ркШркбрк┐ркпрк╛рк│, рк╕рк╛ркбрк╛ ркЖрка
ЁЯХШ => ЁЯХШ, 9 рк╡рк╛ркЧрлНркпрлЗ, 9:00, ркШркбрк┐ркпрк╛рк│, ркирк╡, ркирк╡ рк╡рк╛ркЧрлНркпрлЗ
ЁЯХд => ЁЯХд, 9:30, ркШркбрк┐ркпрк╛рк│, рк╕рк╛ркбрк╛ ркирк╡
ЁЯХЩ => ЁЯХЩ, 10 рк╡рк╛ркЧрлНркпрлЗ, 10:00, ркШркбрк┐ркпрк╛рк│, ркжрк╕, ркжрк╕ рк╡рк╛ркЧрлНркпрлЗ
ЁЯХе => ЁЯХе, 10:30, ркШркбрк┐ркпрк╛рк│, рк╕рк╛ркбрк╛ ркжрк╕
ЁЯХЪ => ЁЯХЪ, 11 рк╡рк╛ркЧрлНркпрлЗ, 11:00, ркЕркЧрк┐ркпрк╛рк░, ркЕркЧрк┐ркпрк╛рк░ рк╡рк╛ркЧрлНркпрлЗ, ркШркбрк┐ркпрк╛рк│
ЁЯХж => ЁЯХж, 11:30, ркШркбрк┐ркпрк╛рк│, рк╕рк╛ркбрк╛ ркЕркЧрк┐ркпрк╛рк░
ЁЯМС => ЁЯМС, ркЕркорк╛рк╕, ркЪркВркжрлНрк░, ркбрк╛рк░рлНркХ, ркирк╡рлЛ, рккрлНрк░ркдрк┐рккркжрк╛ркирлЛ ркЪркВркжрлНрк░
ЁЯМТ => ЁЯМТ, ркЪркВркжрлНрк░, ркмрлАркЬ, ркмрлАркЬркирлЛ ркЪркВркжрлНрк░, рк╡ркзркдрлЛ, рк╡ркзркдрлЛ ркЪркВркжрлНрк░
ЁЯМУ => ЁЯМУ, ркЪркВркжрлНрк░, ркдрлНрк░рк┐ркорк╛рк╕рлА, ркдрлНрк░рк┐ркорк╛рк╕рлА ркЪркВркжрлНрк░, рккрлНрк░ркерко ркдрлНрк░рк┐ркорк╛рк╕рлА ркЪркВркжрлНрк░, рккрлНрк░ркерко ркдрлНрк░рк┐ркорк╛рк╕рлАркирлЛ ркЪркВркжрлНрк░
ЁЯМФ => ЁЯМФ, ркЕрк░рлНркз ркЪркВркжрлНрк░, ркЪркВркжрлНрк░, ркмрк╣рк┐рк░рлНркЧрлЛрк│, рк╡ркзркдрлЛ, рк╡ркзркдрлЛ ркЪркВркжрлНрк░
ЁЯМХ => ЁЯМХ, ркЪркВркжрлНрк░, ркдрлЗркЬрк╕рлНрк╡рлА, ркдрлЗркЬрк╕рлНрк╡рлА ркЪркВркжрлНрк░, рккрлВрк░рлНркг, рккрлВрк░рлНркг ркЪркВркжрлНрк░
ЁЯМЦ => ЁЯМЦ, ркЕрк░рлНркз ркЪркВркжрлНрк░, ркШркЯркдрлЛ, ркШркЯркдрлЛ ркЪркВркжрлНрк░, ркЪркВркжрлНрк░, ркмрк╣рк┐рк░рлНркЧрлЛрк│
ЁЯМЧ => ЁЯМЧ, ркЕркВркдрк┐рко ркдрлНрк░рк┐ркорк╛рк╕рлА ркЪркВркжрлНрк░, ркЪркВркжрлНрк░, ркЫрлЗрк▓рлНрк▓рлА ркдрлНрк░рк┐ркорк╛рк╕рлАркирлЛ ркЪркВркжрлНрк░, ркдрлНрк░рк┐ркорк╛рк╕рлА, ркдрлНрк░рк┐ркорк╛рк╕рлА ркЪркВркжрлНрк░
ЁЯМШ => ЁЯМШ, ркЕрк░рлНркзркЪркВркжрлНрк░рк╛ркХрк╛рк░, ркШркЯркдрлЛ, ркШркЯркдрлЛ ркЕрк░рлНркзркЪркВркжрлНрк░рк╛ркХрк╛рк░ ркЪркВркжрлНрк░, ркШркЯркдрлЛ ркЪркВркжрлНрк░, ркЪркВркжрлНрк░, ркмрлАркЬркирлЛ ркЪркВркжрлНрк░
ЁЯМЩ => ЁЯМЩ, ркЕрк░рлНркзркЪркВркжрлНрк░рк╛ркХрк╛рк░, ркЪркВркжрлНрк░, ркмрлАркЬркирлЛ ркЪркВркжрлНрк░, ркмрлАркЬркирлЛ ркЪрк╛ркВркж
ЁЯМЪ => ЁЯМЪ, ркЪркВркжрлНрк░, ркЪрк╣рлЗрк░рк╛ рк╕рк╛ркерлЗркирлЛ рккрлНрк░ркдрк┐рккркжрк╛ркирлЛ ркЪркВркжрлНрк░, ркЪрк╣рлЗрк░рлЛ, рккрлНрк░ркдрк┐рккркжрк╛ркирк╛ ркЪркВркжрлНрк░ркирлЛ ркЪрк╣рлЗрк░рлЛ, рккрлНрк░ркдрк┐рккркжрк╛ркирлЛ ркЪркВркжрлНрк░
ЁЯМЫ => ЁЯМЫ, ркЕрк░рлНркз ркЪркВркжрлНрк░, ркЕрк░рлНркз ркЪркВркжрлНрк░ркирлЛ ркЪрк╣рлЗрк░рлЛ, ркЪркВркжрлНрк░, ркЪрк╣рлЗрк░рк╛ рк╕рк╛ркерлЗркирлЛ ркЕрк░рлНркз ркЪркВркжрлНрк░, ркЪрк╣рлЗрк░рк╛ рк╕рк╛ркерлЗркирлЛ ркЪркВркжрлНрк░, ркЪрк╣рлЗрк░рк╛рк╡рк╛рк│рлЛ рк╢рлБркХрлНрк▓ рккркХрлНрк╖ркирлЛ ркЪркВркжрлНрк░, ркЪрк╣рлЗрк░рлЛ, рк╢рлБркХрлНрк▓ рккркХрлНрк╖ркирлЛ ркЪркВркжрлНрк░
ЁЯМЬ => ЁЯМЬ, ркЕрк░рлНркз ркЪркВркжрлНрк░, ркЕрк░рлНркз ркЪркВркжрлНрк░ркирлЛ ркЪрк╣рлЗрк░рлЛ, ркХрлГрк╖рлНркг рккркХрлНрк╖ркирлЛ ркЪркВркжрлНрк░, ркЪркВркжрлНрк░, ркЪрк╣рлЗрк░рк╛ рк╕рк╛ркерлЗркирлЛ ркЕрк░рлНркз ркЪркВркжрлНрк░, ркЪрк╣рлЗрк░рк╛ рк╕рк╛ркерлЗркирлЛ ркЪркВркжрлНрк░, ркЪрк╣рлЗрк░рк╛рк╡рк╛рк│рлЛ ркХрлГрк╖рлНркг рккркХрлНрк╖ркирлЛ ркЪркВркжрлНрк░, ркЪрк╣рлЗрк░рлЛ
ЁЯМб => ЁЯМб, ркерк░рлНркорлЛркорлАркЯрк░, рк╣рк╡рк╛ркорк╛рки
тША => тША, ркЕрк╡ркХрк╛рк╢, ркХрк┐рк░ркгрлЛ, рк╕рлВрк░рлНркп, рк╕рлВрк░рлНркпрккрлНрк░ркХрк╛рк╢, рк╣рк╡рк╛ркорк╛рки
ЁЯМЭ => ЁЯМЭ, ркЪркВркжрлНрк░, ркЪрк╣рлЗрк░рк╛рк╡рк╛рк│рлЛ ркЪркВркжрлНрк░, ркЪрк╣рлЗрк░рлЛ, рккрлВркиркоркирк╛ ркЪркВркжрлНрк░ркирлЛ ркЪрк╣рлЗрк░рлЛ, рккрлВркиркоркирк╛ ркЪркВркжрлНрк░рк╡рк╛рк│рлЛ ркЪрк╣рлЗрк░рлЛ, рккрлВркиркоркирлЛ ркЪркВркжрлНрк░, рккрлВрк░рлНркг
ЁЯМЮ => ЁЯМЮ, ркЪрк╣рлЗрк░рлЛ, рк╕рлВрк░рлНркп, рк╕рлВрк░рлНркпркирлЛ ркЪрк╣рлЗрк░рлЛ
тнР => тнР, ркдрк╛рк░рлЛ, ркоркзрлНркпрко рк╕рклрлЗркж ркдрк╛рк░рлЛ, рк╕рлНркЯрк╛рк░
ЁЯМЯ => ЁЯМЯ, ркЪркоркХркдрлЛ, ркЪркоркХркдрлЛ ркдрк╛рк░рлЛ, ркЪркоркХркжрк╛рк░, ркЪркоркХркирк╛рк░, ркЪрк│ркХрк╡рлБркВ, ркдрк╛рк░рлЛ
ЁЯМа => ЁЯМа, ркЦрк░ркдрлЛ, ркЦрк░ркдрлЛ ркдрк╛рк░рлЛ, ркдрк╛рк░рлЛ
тШБ => тШБ, рк╡рк╛ркжрк│, рк╣рк╡рк╛ркорк╛рки
тЫЕ => тЫЕ, рк╡рк╛ркжрк│, рк╡рк╛ркжрк│ рккрк╛ркЫрк│ркирлЛ рк╕рлВрк░рлН, рк╡рк╛ркжрк│ рккрк╛ркЫрк│ркирлЛ рк╕рлВрк░рлНркп, рк╡рк╛ркжрк│рлЛ рк╕рк╛ркерлЗ рк╕рлВрк░рлНркп, рк╕рлВрк░рлНркп
тЫИ => тЫИ, ркорлЗркШркЧрк░рлНркЬркирк╛, рк╡рк░рк╕рк╛ркж, рк╡рк╛ркжрк│, рк╡рлАркЬрк│рлАркирк╛ ркЪркоркХрк╛рк░рк╛ ркЕркирлЗ рк╡рк░рк╕рк╛ркж рк╕рк╛ркерлЗркирлБркВ рк╡рк╛ркжрк│, рк╡рлАркЬрк│рлАркирлЛ ркХркбрк╛ркХрлЛ, рк╣рк╡рк╛ркорк╛рки
ЁЯМд => ЁЯМд, ркирк╛ркирк╛ рк╡рк╛ркжрк│рк╛ркирлА рккрк╛ркЫрк│ рк╕рлВрк░рлНркп, рк╕рлВрк░рлНркп, рк╣рк╡рк╛ркорк╛рки
ЁЯМе => ЁЯМе, ркорлЛркЯрк╛ рк╡рк╛ркжрк│рк╛ркВркирлА рккрк╛ркЫрк│ рк╕рлВрк░рлНркп, рк╕рлВрк░рлНркп, рк╣рк╡рк╛ркорк╛рки
ЁЯМж => ЁЯМж, рк╡рк░рк╕рк╛ркж, рк╡рк░рк╕рк╛ркж рк╕рк╛ркерлЗркирк╛ рк╡рк╛ркжрк│рк╛ркирлА рккрк╛ркЫрк│ рк╕рлВрк░рлНркп, рк╕рлВрк░рлНркп, рк╣рк╡рк╛ркорк╛рки
ЁЯМз => ЁЯМз, рк╡рк░рк╕рк╛ркж, рк╡рк░рк╕рк╛ркж рк╕рк╛ркерлЗркирлЛ рк╡рк╛ркжрк│рлБркВ, рк╡рк░рлНрк╖рк╛, рк╣рк╡рк╛ркорк╛рки
ЁЯМи => ЁЯМи, ркаркВркбрлБркВ, ркмрк░ркл рк╕рк╛ркерлЗркирлБркВ рк╡рк╛ркжрк│рлБркВ, рк╢рлАркд, рк╣рк╡рк╛ркорк╛рки, рк╣рк┐ркорк╡рк░рлНрк╖рк╛
ЁЯМй => ЁЯМй, ркЪркоркХрк╛рк░рк╛ рк╕рк╛ркерлЗркирлБркВ рк╡рк╛ркжрк│рлБркВ, рк╡рлАркЬрк│рлАркирлЛ ркЪркоркХрк╛рк░рлЛ, рк╣рк╡рк╛ркорк╛рки
ЁЯМк => ЁЯМк, ркЪркХрлНрк░рк╡рк╛ркд, ркдрлЛрклрк╛рки, рк╡рк╛ркжрк│, рк╡рк╛рк╡ркВркЯрлЛрк│, рк╣рк╡рк╛ркорк╛рки
ЁЯМл => ЁЯМл, ркзрлБркорлНркорлНрк╕, рк╡рк╛ркжрк│, рк╣рк╡рк╛ркорк╛рки
ЁЯМм => ЁЯМм, ркЪрк╣рлЗрк░рлЛ, рккрк╡ркиркирлЛ ркЪрк╣рлЗрк░рлЛ, ркорлБркЦ, рк╡рк╛ркжрк│, рк╡рк╛ркпрлБ, рк╣рк╡рк╛, рк╣рк╡рк╛ркорк╛рки
ЁЯМА => ЁЯМА, ркЪркХрлНрк░рк╡рк╛ркд, ркЯрлНрк╡рк┐рк╕рлНркЯрк░, рккрлНрк░ркЪркВркб ркдрлЛрклрк╛рки, рк╡ркВркЯрлЛрк│рк┐ркпрлЛ, рк╡рк╛рк╡рк╛ркЭрлЛркбрлБ
ЁЯМИ => ЁЯМИ, рк╡рк░рк╕рк╛ркж, рк╕рккрлНркдрк░ркВркЧрлА, рк╣рк╡рк╛ркорк╛рки
ЁЯМВ => ЁЯМВ, ркЫркдрлНрк░рлА, ркмркВркз ркЫркдрлНрк░рлА, рк╡рк░рк╕рк╛ркж, рк╡рк░рк╕рк╛ркжрлА
тШВ => тШВ, ркЫркдрлНрк░рлА, рк╡рк░рк╕рк╛ркж, рк╣рк╡рк╛ркорк╛рки
тШФ => тШФ, ркЫркдрлНрк░рлА, рк╡рк░рк╕рк╛ркж, рк╡рк░рк╕рк╛ркжркирк╛ ркЯрк┐рккрк╛ рк╕рк╛ркерлЗ ркЫркдрлНрк░рлА, рк╣рк╡рк╛ркорк╛рки
тЫ▒ => тЫ▒, ркЫркдрлНрк░рлА, ркзрк░ркдрлА рккрк░ ркЫркдрлНрк░рлА, рк╕рлВрк░рлНркп, рк╣рк╡рк╛ркорк╛рки
тЪб => тЪб, ркЪрк┐рк╣рлНрки, ркнркп, рк╡рлЙрк▓рлНркЯрлЗркЬ, рк╣рк╛ркЗ рк╡рлЙрк▓рлНркЯрлЗркЬ, рк╣рк╛ркЗ рк╡рлЙрк▓рлНркЯрлЗркЬ ркЬрлЛркЦрко, рк╣рк╛ркЗ рк╡рлЙрк▓рлНркЯрлЗркЬркирлБркВ ркЪрк┐рк╣рлНрки
тЭД => тЭД, ркаркВркбрлБркВ, ркдрлБрк╖рк╛рк░, ркмрк░ркл, рк╡рк░рк╕ркдрк╛ ркмрк░рклркирлЛ рккрк╛ркдрк│рлЛ ркЯрлБркХркбрлЛ, рк╢рлАркд, рк╕рлНркирлЛ рклрлНрк▓рлЕркХ, рк╣рк╡рк╛ркорк╛рки, рк╣рк┐рко
тШГ => тШГ, ркмрк░ркл, рк╣рк╡рк╛ркорк╛рки, рк╣рк┐рко, рк╣рк┐ркоркорк╛ркирк╡
тЫД => тЫД, ркмрк░ркл рк╡ркЧрк░ркирлЛ рк╣рк┐ркоркорк╛ркирк╡, рк╣рк┐рко, рк╣рк┐рко рк╡рк┐ркирк╛ркирлЛ рк╣рк┐ркоркорк╛ркирк╡, рк╣рк┐ркоркорк╛ркирк╡
тШД => тШД, ркЕрк╡ркХрк╛рк╢, ркзрлВркоркХрлЗркдрлБ, рккрлВркВркЫркбрк┐ркпрлЛ ркдрк╛рк░рлЛ, рк╕рлНрккрлЗрк╕
ЁЯФе => ЁЯФе, ркЕркЧрлНркирк┐, ркЖркЧ, ркЬрлНркпрлЛркд
ЁЯТз => ЁЯТз, ркЯрлАрккрлБркВ, ркаркВркбрлЛ рккрк░рк╕рлЗрк╡рлЛ, рккрк░рк╕рлЗрк╡рлЛ, рккрлНрк░рк╕рлНрк╡рлЗркжркпрлБркХрлНркд, рк░ркорлВркЬрлА
ЁЯМК => ЁЯМК, ркдрк░ркВркЧ, ркжрк░рк┐ркпрк╛ркирлБ ркорлЛркЬрлБркВ, рккрк╛ркгрлАркирлА рк▓рк╣рлЗрк░, рк╕ркорлБркжрлНрк░ркирлА рк▓рк╣рлЗрк░
ЁЯОГ => ЁЯОГ, ркЙркЬрк╡ркгрлА, ркХрлЛрк│рлБркВ, ркЬрлЗркХ, ркЬрлЗркХ-ркУ-рк▓рлЗркирлНркЯрк░рлНрки, рк▓рлЗркирлНркЯрк░рлНрки, рк╣рлЗрк▓рлЛрк╡рк┐рки
ЁЯОД => ЁЯОД, ркЙркЬрк╡ркгрлА, ркирк╛ркдрк╛рк▓ рк╡рлГркХрлНрк╖, рк╡рлГркХрлНрк╖
ЁЯОЖ => ЁЯОЖ, ркЙркЬрк╡ркгрлА, рклркЯрк╛ркХркбрк╛
ЁЯОЗ => ЁЯОЗ, ркЖркдрк╢ркмрк╛ркЬрлА, ркЙркЬрк╡ркгрлА, рклркЯрк╛ркХркбрк╛, рклркЯрк╛ркХркбрк╛ рк╕рлНрккрк╛рк░рлНркХрк▓рк░, рк╕рлНрккрк╛рк░рлНркХрк▓рк░
тЬи => тЬи, ркЪркоркХркдрк╛ ркдрк╛рк░рк╛, ркЪрк│ркХрк╛ркЯ, ркдрк╛рк░рк╛, рк╣рлАрк░рлЛ
ЁЯОИ => ЁЯОИ, ркЙркЬрк╡ркгрлА, рклрлБркЧрлНркЧрлЛ
ЁЯОЙ => ЁЯОЙ, ркЙркЬрк╡ркгрлА, рккрк╛рк░рлНркЯрлА, рккрк╛рк░рлНркЯрлА рккрлЛрккрк░, рккрлЛрккрк░
ЁЯОК => ЁЯОК, ркЙркЬрк╡ркгрлА, ркХрк╛ркЧрк│ркирк╛ркВ ркЯрлБркХркбрк╛, ркХрк╛ркЧрк│ркирк╛ркВ ркжркбрлЛ, ркжркбрлЛ
ЁЯОЛ => ЁЯОЛ, ркЙркЬрк╡ркгрлА, ркХрк╛ркЧрк│ рк╕рлНркЯрлНрк░рлАрккрлНрк╕, ркЭрк╛ркб, ркЭрк╛ркб ркЕркирлЗ ркХрк╛ркЧрк│ рк╕рлНркЯрлНрк░рлАрккрлНрк╕, ркЭрк╛ркб ркЕркирлЗ ркХрк╛ркЧрк│ркирлА рккркЯрлНркЯрлАркУ, ркдрк╛рк░рк╛ ркЙркдрлНрк╕рк╡
ЁЯОН => ЁЯОН, ркЙркЬрк╡ркгрлА, ркЬрк╛рккрк╛ркирлА, ркирлВркдрки рк╡рк░рлНрк╖, рккрк╛ркЗрки, рккрк╛ркЗрки рк╢ркгркЧрк╛рк░
ЁЯОО => ЁЯОО, ркЙркдрлНрк╕рк╡, ркЬрк╛рккрк╛ркирлА, ркЬрк╛рккрк╛ркирлА ркврлАркВркЧрк▓рлАркУ, ркврлАркВркЧрк▓рлА ркЙркдрлНрк╕рк╡, ркврлАркВркЧрк▓рлАркУ
ЁЯОП => ЁЯОП, ркЙркЬрк╡ркгрлА, ркХрк╛рк░рлНркк рк╕рлНркЯрлНрк░рлАркорк░, рк╕рлНркЯрлНрк░рлАркорк░
ЁЯОР => ЁЯОР, ркЪрк╛ркЗрко, рк╡рк┐ркВркб ркЪрк╛ркЗрко
ЁЯОС => ЁЯОС, ркЙркЬрк╡ркгрлА, ркЪркВркжрлНрк░, ркЪркВркжрлНрк░ ркжрк░рлНрк╢рки, ркЪркВркжрлНрк░ ркжрк░рлНрк╢рки рк╕ркорк╛рк░ркВркн, ркжрк░рлНрк╢рки
ЁЯОА => ЁЯОА, ркЙркЬрк╡ркгрлА, рк░рк┐ркмрки
ЁЯОБ => ЁЯОБ, ркЙркЬрк╡ркгрлА, ркнрлЗркЯ, рк╡рлАркВркЯрлЗрк▓рлА, рк╡рлАркВркЯрлЗрк▓рлА рк╕рлЛркЧрк╛ркж, рк╕рлЛркЧрк╛ркж
ЁЯОЧ => ЁЯОЧ, ркЙркЬрк╡ркгрлА, рк░рк┐ркмрки, рк░рк┐ркорк╛ркЗркирлНркбрк░, рк░рк┐ркорк╛ркЗркирлНркбрк░ рк░рк┐ркмрки
ЁЯОЯ => ЁЯОЯ, ркЯрк┐ркХрк┐ркЯ, рккрлНрк░рк╡рлЗрк╢, рккрлНрк░рк╡рлЗрк╢ ркЯрк┐ркХрк┐ркЯ
ЁЯОл => ЁЯОл, ркЯрк┐ркХрк┐ркЯ, ркоркирлЛрк░ркВркЬрки
ЁЯОЦ => ЁЯОЦ, ркЙркЬрк╡ркгрлА, ркорк┐рк▓рк┐ркЯрлНрк░рлА, ркорлЗркбрк▓, рк╕рлЗркирк╛ркирлЛ ркорлЗркбрк▓
ЁЯПЖ => ЁЯПЖ, ркИркирк╛рко, ркЯрлНрк░рлЛрклрлА
ЁЯПЕ => ЁЯПЕ, ркЦрлЗрк▓-ркХрлВркж ркорк╛ркЯрлЗркирлЛ ркорлЗркбрк▓, ркорлЗркбрк▓
ЁЯеЗ => ЁЯеЗ, рккркжркХ, рккрк╣рлЗрк▓рлБркВ, рк╕рлБрк╡рк░рлНркг, рк╕рлБрк╡рк░рлНркг рккркжркХ
ЁЯеИ => ЁЯеИ, рккркжркХ, ркмрлАркЬрлБркВ, рк░ркЬркд, рк░ркЬркд рккркжркХ
ЁЯеЙ => ЁЯеЙ, ркХрк╛ркВрк╕рлНркп, ркХрк╛ркВрк╕рлНркп рккркжркХ, ркдрлНрк░рлАркЬрлБ, рккркжркХ
тЪ╜ => тЪ╜, ркмрлЙрк▓, рк╕рлЙркХрк░, рк╕рлЙркХрк░ ркмрлЙрк▓
тЪ╛ => тЪ╛, ркмрлЗркЭркмрлЛрк▓, ркмрлЗрк╕ркмрлЙрк▓
ЁЯПА => ЁЯПА, ркЦрлЗрк▓ ркХрлВркж, ркмрк╛рк╕рлНркХрлЗркЯркмрлЛрк▓, ркмрк╛рк╕рлНркХрлЗркЯркмрлЛрк▓ рк╣рлВркк, ркмрлЛрк▓, рк╣рлВркк
ЁЯПР => ЁЯПР, ркмрлЛрк▓, рк░ркоркд, рк╡рлЙрк▓рлАркмрлЛрк▓
ЁЯПИ => ЁЯПИ, ркЕркорлЗрк░рк┐ркХрки, ркЕркорлЗрк░рк┐ркХрки рклрлВркЯркмрлЛрк▓, ркЦрлЗрк▓ ркХрлВркж, ркмрлЛрк▓
ЁЯПЙ => ЁЯПЙ, ркЦрлЗрк▓ ркХрлВркж, ркмрлЛрк▓, рк░ркЧрлНркмрлА рклрлВркЯркмрлЛрк▓, рк╕рлЙркХрк░, рк╕рлЙркХрк░ ркмрлЛрк▓
ЁЯО╛ => ЁЯО╛, ркЦрлЗрк▓ ркХрлВркж, ркЯрлЗркирк┐рк╕, ркЯрлЗркирк┐рк╕ ркмрлЛрк▓, ркЯрлЗркирк┐рк╕ рк░рлЗркХрлЗркЯ ркЕркирлЗ ркмрлЛрк▓, ркмрлЛрк▓
ЁЯО▒ => ЁЯО▒, ркЖрка ркмрлЛрк▓, ркмрк┐рк▓рк┐ркпрк░рлНркб, рк░ркоркд
ЁЯО│ => ЁЯО│, ркЧрлЛрк▓ркВркжрк╛ркЬрлА, ркЧрлЛрк▓ркВркжрк╛ркЬрлАркирлЛ ркжркбрлЛ, ркжркбрлЛ, рк░ркоркд
ЁЯПП => ЁЯПП, ркХрлНрк░рк┐ркХрлЗркЯ, ркмрлЗркЯ, ркмрлЛрк▓, рк░ркоркд
ЁЯПС => ЁЯПС, рклрлАрк▓рлНркб, рклрлАрк▓рлНркб рк╣рлЙркХрлА, ркмрлЛрк▓, ркорлЗркжрк╛ркирлА, рк╕рлНркЯрк┐ркХ, рк╣рлЙркХрлА
ЁЯПТ => ЁЯПТ, ркЖркЗрк╕, ркЖркЗрк╕ рк╣рлЙркХрлА рк╕рлНркЯрк┐ркХ ркЕркирлЗ рккркХ, рккркХ, рк░ркоркд, рк╕рлНркЯрк┐ркХ, рк╣рлЙркХрлА
ЁЯПУ => ЁЯПУ, ркЯрлЗркмрк▓ ркЯрлЗркирк┐рк╕, рккрк┐ркВркЧ рккрлЛркВркЧ, рккрлЗркбрк▓, ркмрлЗркЯ, ркмрлЛрк▓, рк░ркоркд
ЁЯП╕ => ЁЯП╕, ркмрк░рлНркбрлА, ркмрлЗркбркорк┐ркВркЯрки, рк░ркоркд, рк░рлЗркХрлЗркЯ, рк╢ркЯрк▓ркХрлЙркХ
ЁЯеК => ЁЯеК, ркЧрлНрк▓рк╡, ркмрлЙркХрлНрк╕рк┐ркВркЧ, ркмрлЙркХрлНрк╕рк┐ркВркЧ ркЧрлНрк▓рк╡, рк╕рлНрккрлЙрк░рлНркЯ
ЁЯеЛ => ЁЯеЛ, ркХрк░рк╛ркЯрлЗ, ркЬрлБркбрлЛ, ркорк╛рк░рлНрк╢рк▓ ркЖркЯрк░рлНрк╕, ркорк╛рк░рлНрк╢рк▓ ркЖркЯрк░рлНрк╕ ркпрлВркирк┐рклрлЙрк░рлНрко, ркпрлВркирк┐рклрлЙрк░рлНрко, рк╕рлНрккрлЙрк░рлНркЯ
ЁЯеЕ => ЁЯеЕ, ркЧрлЛрк▓, ркЧрлЛрк▓ ркирлЗркЯ, ркирлЗркЯ, рк╕рлНрккрлЙрк░рлНркЯ
ЁЯОп => ЁЯОп, ркмрк│ркжркирлА ркЖркВркЦ, рк░ркоркд, рк▓ркХрлНрк╖рлНркп, рк▓ркХрлНрк╖рлНркп рккрк░ ркЬ, рк╕рлАркзрлА ркЬ рк╣рк┐ркЯ, рк╣рк┐ркЯ
тЫ│ => тЫ│, ркЦрк╛ркбрк╛ркорк╛ркВ ркзрлНрк╡ркЬ, ркЦрк╛ркбрлЛ, ркЧрлЛрк▓рлНркл, ркЧрлЛрк▓рлНркл ркзрлНрк╡ркЬ
тЫ╕ => тЫ╕, ркЖркЗрк╕ рк╕рлНркХрлЗркЯ, ркмрк░ркл рккрк░ рк╕рлНркХрлЗркЯрк┐ркВркЧ, рк╕рлНркХрлЗркЯ
ЁЯОг => ЁЯОг, ркЖркиркВркжрккрлНрк░ркорлЛркж, ркХрк╛ркВркЯрлЛ, ркоркирлЛрк░ркВркЬрки, ркорк╛ркЫрк▓рлА, ркорк╛ркЫрк▓рлА рккркХркбрк╡рк╛ркирлЛ ркХрк╛ркВркЯрлЛ, ркорк╛ркЫрк▓рлА рккркХркбрк╡рк╛ркирлЛ ркХрк╛ркВркЯрлЛ ркЕркирлЗ ркорк╛ркЫрк▓рлА, ркорк╛ркЫрк▓рлА рккркХркбрк╡рлА
ЁЯО╜ => ЁЯО╜, ркЦрлЗрк▓ ркХрлВркж, ркЦрлЗрк╕, ркЦрлЗрк╕ рк╕рк╛ркерлЗркирлЛ рк░ркирк┐ркВркЧ рк╢рк░рлНркЯ, ркжрлЛркб, рк░ркирк┐ркВркЧ рк╢рк░рлНркЯ, рк╢рк░рлНркЯ
ЁЯО┐ => ЁЯО┐, ркЦрлЗрк▓ ркХрлВркж, ркмрлВркЯ, рк╕рлНркХрлА, рк╕рлНркХрлА ркЕркирлЗ ркмрлВркЯ
ЁЯЫ╖ => ЁЯЫ╖, рк╕рлНрк▓рлЗркЗ, рк╕рлНрк▓рлЗркЬ, рк╕рлНрк▓рлЗркб
ЁЯеМ => ЁЯеМ, ркХрк░рлНрк▓рк┐ркВркЧ рк╕рлНркЯрлЛрки, ркЧрлЗрко, рк░рлЛркВркХ
ЁЯОо => ЁЯОо, ркЧрлЗрко, ркЧрлЗрко ркирк┐ркпркВркдрлНрк░ркХ, ркирк┐ркпркВркдрлНрк░ркХ, рк╡рк┐ркбрк┐ркУ ркЧрлЗрко
ЁЯХ╣ => ЁЯХ╣, ркЬрлЛркпрк╕рлНркЯрк┐ркХ, рк░ркоркд, рк╡рк┐ркбрк┐ркУ ркЧрлЗрко
ЁЯО▓ => ЁЯО▓, рккрк╛рк╕рк╛, рккрк╛рк╕рк╛ркирлА рк░ркоркд, рккрк╛рк╕рлЛ, рк░ркоркд, рк░ркоркдркирлЛ рккрк╛рк╕рлЛ
тЩа => тЩа, ркХрк╛рк░рлНркб, ркХрк╛рк│рлА, ркХрк╛рк│рлАркирлБркВ рккркдрлНркдрлБркВ, рккркдрлНркдрлБркВ, рк░ркоркд
тЩе => тЩе, ркХрк╛рк░рлНркб, рккркдрлНркдрлБркВ, рк░ркоркд, рк▓рк╛рк▓, рк▓рк╛рк▓ркирлБркВ рккркдрлНркдрлБркВ
тЩж => тЩж, ркХрк╛рк░рлНркб, ркЪрлЛркХркЯ, ркЪрлЛркХркЯркирлБркВ рккркдрлНркдрлБркВ, рккркдрлНркдрлБркВ, рк░ркоркд
тЩг => тЩг, ркХрк╛рк░рлНркб, рклрлБрк▓рлЗрк╡рк░, рклрлБрк▓рлЗрк╡рк░ркирлБркВ рккркдрлНркдрлБркВ, рк░ркоркд
ЁЯГП => ЁЯГП, ркЧркВркЬрлАрклрк╛ркирлБркВ рккркдрлНркдрлБркВ, ркЧркВркЬрлАрклрлЛ, ркЬрлЛркХрк░, ркЬрлЛркХрк░ркирлБркВ рккркдрлНркдрлБркВ, рккркдрлНркдрк╛ркВ
ЁЯАД => ЁЯАД, ркЯрк╛ркЗрк▓, ркбрлНрк░рлЗркЧрки, ркорк╛рк╣ркЬрлЛркВркЧ, ркорк╛рк╣ркЬрлЛркВркЧ ркЯрк╛ркЗрк▓, ркорк╛рк╣ркЬрлЛркВркЧ рк▓рк╛рк▓ ркбрлНрк░рлЗркЧрки, рк▓рк╛рк▓ ркбрлНрк░рлЗркЧрки
ЁЯО┤ => ЁЯО┤, рккркдрлНркдрк╛ркирлА рк░ркоркд, рккркдрлНркдрлБркВ, рклрлВрк▓, рклрлВрк▓рк╡рк╛рк│рлБркВ рккркдрлНркдрлБркВ, рк░ркоркд, рк╣ркирк╛рклрлВркбрк╛
ЁЯФЗ => ЁЯФЗ, ркХрлГрккрк╛ ркХрк░рлА рк╢рк╛ркВркд рк░рк╣рлЛ, ркмрлЛрк▓рк╢рлЛ ркирк╣рлАркВ, рк░ркж ркХрк░рлЗрк▓рк╛ ркЪрк┐рк╣рлНрки рк╕рк╛ркерлЗркирлБркВ рк╕рлНрккрлАркХрк░, рк╢рк╛ркВркд, рк╕рлНрккрлАркХрк░ ркмркВркз
ЁЯФИ => ЁЯФИ, рк▓рк╛ркЙркбрк╕рлНрккрлАркХрк░, рк╕рлНрккрлАркХрк░
ЁЯФЙ => ЁЯФЙ, ркУркЫрк╛ рк╡рлЙрк▓рлНркпрлВрко рк╕рк╛ркерлЗркирлБркВ рк╕рлНрккрлАркХрк░, ркУркЫрлБркВ, ркУркЫрлБркВ рк╡рлЙрк▓рлНркпрлВрко, рк╕рлНрккрлАркХрк░, рк╕рлНрккрлАркХрк░ ркЪрк╛рк▓рлБ
ЁЯФК => ЁЯФК, рк╡ркзрлБ, рк╡ркзрлБ ркЕрк╡рк╛ркЬркорк╛ркВ рк╕рлНрккрлАркХрк░, рк╡ркзрлБ рк╡рлЙрк▓рлНркпрлВрко, рк╡ркзрлБ рк╡рлЙрк▓рлНркпрлВрко рк╕рк╛ркерлЗркирлБркВ рк╕рлНрккрлАркХрк░, рк╕рлНрккрлАркХрк░
ЁЯУв => ЁЯУв, ркЬрк╛рк╣рлЗрк░ рк╕ркВркмрлЛркзрки, рк▓рк╛ркЙркбрк╕рлНрккрлАркХрк░, рк╕ркВркЪрк╛рк░, рк╣рлЗркирлНркб рк╕рлНрккрлАркХрк░
ЁЯУг => ЁЯУг, ркЪрлАркЕрк░рк┐ркВркЧ, ркорлЗркЧрк╛рклрлЛрки, рк╕ркВркЪрк╛рк░
ЁЯУп => ЁЯУп, рккрлЛрк╕рлНркЯрк▓, рккрлЛрк╕рлНркЯрк▓ рк╣рлЛрк░рлНрки, рк╣рлЛрк░рлНрки
ЁЯФФ => ЁЯФФ, ркШркВркЯ, ркжрлЗрк╡рк╛рк▓ркп
ЁЯФХ => ЁЯФХ, ркЕрк╡рк╛ркЬ ркирк╣рлАркВ, ркЕрк╡рк╛ркЬ ркмркВркз рк╕рк╛ркерлЗркирлБркВ ркШркВркЯркирлБркВ ркЪрк┐рк╣рлНрки, ркШркВркЯ, ркШркВркЯ ркирк╣рлАркВ, рк░ркж ркХрк░рлЗрк▓рк╛ ркЪрк┐рк╣рлНрки рк╕рк╛ркерлЗркирлЛ ркШркВркЯ
ЁЯО╝ => ЁЯО╝, рк▓ркЦрк╛ркг, рк╕ркВркЧрлАркд, рк╕ркВркЧрлАркд ркорк╛ркЯрлЗркирлА рк▓ркЦрк╛ркг
ЁЯО╡ => ЁЯО╡, ркирлЛркЯ, рк╕ркВркЧрлАркд, рк╕ркВркЧрлАркдркирлА ркирлЛркЯ
ЁЯО╢ => ЁЯО╢, ркирлЛркЯ, ркирлЛркЯрлНрк╕, рк╕ркВркЧрлАркд, рк╕ркВркЧрлАркдркирлА ркирлЛркЯрлНрк╕
ЁЯОЩ => ЁЯОЩ, ркорк╛ркЗркХ, ркорк╛ркЗркХрлНрк░рлЛрклрлЛрки, ркорлНркпрлБркЭрк┐ркХ, рк╕ркВркЧрлАркд, рк╕рлНркЯрлВркбрк┐ркпрлЛ, рк╕рлНркЯрлВркбрк┐ркпрлЛ ркорк╛ркЗркХрлНрк░рлЛрклрлЛрки
ЁЯОЪ => ЁЯОЪ, ркорлНркпрлБркЭрк┐ркХ, рк▓рлЗрк╡рк▓ рк╕рлНрк▓рк╛ркЗркбрк░, рк╕ркВркЧрлАркд, рк╕рлНрк▓рк╛ркЗркбрк░
ЁЯОЫ => ЁЯОЫ, ркХркирлНркЯрлНрк░рлЛрк▓, ркХркирлНркЯрлНрк░рлЛрк▓ ркирлЛркмрлНрк╕, ркирлЛркмрлНрк╕, ркорлНркпрлБркЭрк┐ркХ, рк╕ркВркЧрлАркд
ЁЯОд => ЁЯОд, ркХрк╛рк░рк╛ркУркХ, ркоркирлЛрк░ркВркЬрки, ркорк╛ркЗркХ, ркорк╛ркЗркХрлНрк░рлЛрклрлЛрки
ЁЯОз => ЁЯОз, ркоркирлЛрк░ркВркЬрки, рк╣рлЗркбрклрлЛрки
ЁЯУ╗ => ЁЯУ╗, рк░рлЗркбрк┐ркУ, рк╡рк┐ркбрк┐ркУ
ЁЯО╖ => ЁЯО╖, рк╡рк╛ркжрлНркп, рк╕ркВркЧрлАркд, рк╕ркВркЧрлАркд рк╡рк╛ркжрлНркп, рк╕рлЗркХрлНрк╕, рк╕рлЗркХрлНрк╕рлЛрклрлЛрки
ЁЯО╕ => ЁЯО╕, ркЧрк┐ркЯрк╛рк░, рк╡рк╛ркжрлНркп, рк╕ркВркЧрлАркд, рк╕ркВркЧрлАркд рк╡рк╛ркжрлНркп
ЁЯО╣ => ЁЯО╣, ркХрлА ркмрлЛрк░рлНркб, рккрк┐ркЖркирлЛ, ркорлНркпрлБркЭрк┐ркХрк▓ ркХрлАркмрлЛрк░рлНркб, рк╡рк╛ркжрлНркп, рк╕ркВркЧрлАркд, рк╕ркВркЧрлАркд ркХрлА ркмрлЛрк░рлНркб, рк╕ркВркЧрлАркд рк╡рк╛ркжрлНркп
ЁЯО║ => ЁЯО║, ркдрлБрк░рк╛ркИ, рк╡рк╛ркжрлНркп, рк╕ркВркЧрлАркд, рк╕ркВркЧрлАркд рк╡рк╛ркжрлНркп
ЁЯО╗ => ЁЯО╗, рк╡рк╛ркжрлНркп, рк╡рк╛ркпрлЛрк▓рк┐рки, рк╕ркВркЧрлАркд, рк╕ркВркЧрлАркд рк╡рк╛ркжрлНркп
ЁЯеБ => ЁЯеБ, ркбрлНрк░рко, ркбрлНрк░ркорк╕рлНркЯрк┐ркХ, рк╕ркВркЧрлАркд
ЁЯУ▒ => ЁЯУ▒, рклрлЛрки, ркорлЛркмрк╛ркЗрк▓ рклрлЛрки, рк╕рлЗрк▓ рклрлЛрки
ЁЯУ▓ => ЁЯУ▓, ркПркХ ркХрлЙрк▓ ркХрк░рлЛ, ркдрлАрк░ рк╕рк╛ркерлЗркирлЛ ркорлЛркмрк╛ркЗрк▓ рклрлЛрки, ркдрлАрк░ рк╕рк╛ркерлЗркирлЛ рк╕рлЗрк▓ рклрлЛрки, рклрлЛрки, ркорлЛркмрк╛ркЗрк▓ рклрлЛрки
тШО => тШО, ркЯрлЗрк▓рк┐рклрлЛрки, рклрлЛрки
ЁЯУЮ => ЁЯУЮ, ркЯрлЗрк▓рк┐рклрлЛрки, ркЯрлЗрк▓рк┐рклрлЛркиркирлБркВ рк░рлАрк╕рк┐рк╡рк░, рклрлЛрки, рклрлЛркиркирлБркВ рк░рлАрк╕рк┐рк╡рк░, рк╕ркВркЪрк╛рк░
ЁЯУЯ => ЁЯУЯ, рккрлЗркЬрк░, рк╕ркВркЪрк╛рк░
ЁЯУа => ЁЯУа, рклрлЕркХрлНрк╕, рклрлЕркХрлНрк╕ ркорк╢рлАрки, рк╕ркВркЪрк╛рк░
ЁЯФЛ => ЁЯФЛ, ркмрлЕркЯрк░рлА
ЁЯФМ => ЁЯФМ, ркЗрк▓рлЗркХрлНркЯрлНрк░рк┐ркХ, ркЗрк▓рлЗркХрлНркЯрлНрк░рк┐ркХ рккрлНрк▓ркЧ
ЁЯТ╗ => ЁЯТ╗, PC, ркХркорлНрккрлНркпрлБркЯрк░, рккрк░рлНрк╕ркирк▓ ркХркорлНрккрлНркпрлБркЯрк░, рк▓рлЗрккркЯрлЛркк ркХркорлНрккрлНркпрлБркЯрк░, рк╡рлНркпркХрлНркдрк┐ркЧркд
ЁЯЦе => ЁЯЦе, ркХркорлНрккрлНркпрлБркЯрк░, ркбрлЗрк╕рлНркХркЯрлЙркк, ркбрлЗрк╕рлНркХркЯрлЙркк ркХркорлНрккрлНркпрлБркЯрк░
ЁЯЦи => ЁЯЦи, ркХркорлНрккрлНркпрлБркЯрк░, рккрлНрк░рк┐ркирлНркЯрк░
тМи => тМи, ркХркорлНрккрлНркпрлБркЯрк░, ркХрлАркмрлЛрк░рлНркб
ЁЯЦ▒ => ЁЯЦ▒, 3, ркХркорлНрккрлНркпрлБркЯрк░, ркХркорлНрккрлНркпрлБркЯрк░ ркорк╛ркЙрк╕, ркдрлНрк░ркг, ркмркЯрки, ркорк╛ркЙрк╕
ЁЯЦ▓ => ЁЯЦ▓, ркХркорлНрккрлНркпрлБркЯрк░, ркЯрлНрк░рлЗркХркмрлЛрк▓
ЁЯТ╜ => ЁЯТ╜, MD, ркбрк┐рк╕рлНркХ, ркорк┐ркирк┐ ркбрк┐рк╕рлНркХ
ЁЯТ╛ => ЁЯТ╛, ркбрк┐рк╕рлНркХ, рклрлНрк▓рлЛрккрлА, рклрлНрк▓рлЛрккрлА ркбрк┐рк╕рлНркХ
ЁЯТ┐ => ЁЯТ┐, CD, DVD, ркСрккрлНркЯрк┐ркХрк▓ ркбрк┐рк╕рлНркХ, ркбрк┐рк╕рлНркХ, ркмрлНрк▓рлБ-рк░рлЗ
ЁЯУА => ЁЯУА, DVD, DVD ркбрк┐рк╕рлНркХ, ркбрк┐рк╕рлНркХ, ркбрлАрк╡рлАркбрлА
ЁЯОе => ЁЯОе, ркоркирлЛрк░ркВркЬрки, ркорлВрк╡рлА, ркорлВрк╡рлА ркХрлЕркорлЗрк░рк╛, ркорлВрк╡рлАркирлЛ ркХрлЕркорлЗрк░рлЛ, рк╕рк┐ркирлЗркорк╛
ЁЯОЮ => ЁЯОЮ, рклрк┐рк▓рлНрко, рклрк┐рк▓рлНрко рклрлНрк░рлЗркорлНрк╕, рклрлНрк░рлЗркорлНрк╕, ркорлВрк╡рлА, рк╕рк┐ркирлЗркорк╛
ЁЯУ╜ => ЁЯУ╜, рккрлНрк░рлЛркЬрлЗркХрлНркЯрк░, рклрк┐рк▓рлНрко рккрлНрк░рлЛркЬрлЗркХрлНркЯрк░, ркорлВрк╡рлА, рк╡рк┐ркбрк┐ркУ, рк╕рк┐ркирлЗркорк╛
ЁЯОм => ЁЯОм, ркХрлНрк▓рлЗрккрк░, ркХрлНрк▓рлЗрккрк░ ркмрлЛрк░рлНркб, ркХрлНрк▓рлЗрккрк░ркмрлЛрк░рлНркб, ркоркирлЛрк░ркВркЬрки, ркорлВрк╡рлА
ЁЯУ║ => ЁЯУ║, ркЯрлАрк╡рлА, ркЯрлЗрк▓рк┐рк╡рк┐ркЭрки
ЁЯУ╖ => ЁЯУ╖, ркХрлЕркорлЗрк░рк╛, рк╡рк┐ркбрк┐ркУ
ЁЯУ╕ => ЁЯУ╕, ркХркорлЗрк░рлЛ, рклрлНрк▓рлЗрк╢, рклрлНрк▓рлЗрк╢ рк╕рк╛ркерлЗркирлЛ ркХрлЕркорлЗрк░рлЛ, рк╡рк┐ркбрк┐ркУ
ЁЯУ╣ => ЁЯУ╣, ркХрлЕркорлЗрк░рлЛ, рк╡рк┐ркбрк┐ркУ, рк╡рк┐ркбрк┐ркУ ркХрлЕрко, рк╡рк┐ркбрк┐ркУ ркХрлЕркорлЗрк░рлЛ
ЁЯУ╝ => ЁЯУ╝, ркЯрлЗркк, рк╡рк┐ркбрк┐ркУ, рк╡рк┐ркбрк┐ркУ ркЯрлЗркк, рк╡рк┐ркбрк┐ркУркХрлЗрк╕рлЗркЯ
ЁЯФН => ЁЯФН, ркХрк╛ркЪ, ркбрк╛ркмрлА ркдрк░рклркирлЛ, ркбрк╛ркмрлА ркдрк░рклркирлЛ ркмрлГрк╣ркжркжрк░рлНрк╢ркХ ркХрк╛ркЪ, ркмрлГрк╣ркжркжрк░рлНрк╢ркХ ркХрк╛ркЪ, рк╢рлЛркзрлЛ
ЁЯФО => ЁЯФО, ркХрк╛ркЪ, ркЬркоркгрлА ркдрк░рклркирлЛ, ркЬркоркгрлА ркдрк░рклркирлЛ ркмрлГрк╣ркжркжрк░рлНрк╢ркХ ркХрк╛ркЪ, ркмрлГрк╣ркжркжрк░рлНрк╢ркХ ркХрк╛ркЪ, рк╢рлЛркзрлЛ
ЁЯФм => ЁЯФм, ркЯрлВрк▓, ркорк╛ркЗркХрлНрк░рлЛрк╕рлНркХрлЛркк
ЁЯФн => ЁЯФн, ркЯрлВрк▓, ркЯрлЗрк▓рк┐рк╕рлНркХрлЛркк
ЁЯУб => ЁЯУб, ркПркирлНркЯрлЗркирк╛, ркбрк┐рк╢, рк╕ркВркЪрк╛рк░, рк╕рлЗркЯрлЗрк▓рк╛ркЗркЯ, рк╕рлЗркЯрлЗрк▓рк╛ркЗркЯ ркПркирлНркЯрлЗркирк╛, рк╕рлЗркЯрлЗрк▓рк╛ркЗркЯ ркбрк┐рк╢
ЁЯХп => ЁЯХп, ркорлАркгркмркдрлНркдрлА, рк▓рк╛ркЗркЯ
ЁЯТб => ЁЯТб, ркХрлЛркорк┐ркХ, ркЧрлЛрк│рлЛ, рк▓рк╛ркЗркЯркирлЛ ркмрк▓рлНркм, рк╡рк┐ркЪрк╛рк░ ркЖрк╡рлНркпрлЛ, рк╡рлАркЬ, рк╡рлАркЬрк│рлА, рк╡рлАркЬрк│рлАркирлЛ ркЧрлЛрк│рлЛ
ЁЯФж => ЁЯФж, ркЗрк▓рлЗркХрлНркЯрлНрк░рк┐ркХ, ркЯрлЛрк░рлНркЪ, рккрлНрк░ркХрк╛рк╢, рклрлНрк▓рлЗрк╢рк▓рк╛ркЗркЯ
ЁЯПо => ЁЯПо, ркЗркЭрк╛ркХрлНркпрк╛, рклрк╛ркирк╕, ркмрк╛рк░, рк░рлЗрк╕рлНркЯрлЛрк░ркирлНркЯ, рк▓рк╛рк▓, рк▓рк╛рк▓ рклрк╛ркирк╕
ЁЯУФ => ЁЯУФ, ркХрк╡рк░, ркирлЛркЯркмрлБркХ, рк╕рлБрк╢рлЛркнркирк╡рк╛рк│рлА ркирлЛркЯркмрлБркХ, рк╕рлБрк╢рлЛркнрк┐ркд ркХрк╡рк░рк╡рк╛рк│рлА ркирлЛркЯркмрлБркХ, рк╕рлБрк╢рлЛркнрк┐ркд ркирлЛркЯркмрлБркХ
ЁЯУХ => ЁЯУХ, рккрлБрк╕рлНркдркХ, ркмркВркз рккрлБрк╕рлНркдркХ
ЁЯУЦ => ЁЯУЦ, ркЦрлБрк▓рлНрк▓рлБркВ рккрлБрк╕рлНркдркХ, рккрлБрк╕рлНркдркХ
ЁЯУЧ => ЁЯУЧ, рккрлБрк╕рлНркдркХ, рк▓рлАрк▓рлБркВ рккрлБрк╕рлНркдркХ
ЁЯУШ => ЁЯУШ, рккрлБрк╕рлНркдркХ, рк╡рк╛ркжрк│рлА рккрлБрк╕рлНркдркХ
ЁЯУЩ => ЁЯУЩ, ркирк╛рк░ркВркЧрлА рккрлБрк╕рлНркдркХ, рккрлБрк╕рлНркдркХ
ЁЯУЪ => ЁЯУЪ, рккрлБрк╕рлНркдркХ, рккрлБрк╕рлНркдркХрлЛ
ЁЯУУ => ЁЯУУ, ркирлЛркЯркмрлБркХ
ЁЯУТ => ЁЯУТ, ркЦрк╛ркдрк╛рк╡рк╣рлА, ркирлЛркЯркмрлБркХ
ЁЯУГ => ЁЯУГ, ркжрк╕рлНркдрк╛рк╡рлЗркЬ, рккрлГрк╖рлНрка, рк╡рк│рлЗрк▓рлБркВ рккрлГрк╖рлНрка
ЁЯУЬ => ЁЯУЬ, рккрлЗрккрк░ рк╕рлНркХрлНрк░рлЛрк▓, рк╕рлНркХрлНрк░рлЛрк▓
ЁЯУД => ЁЯУД, ркЪркдрлНркдрлБ, ркЪркдрлНркдрлБ рккрлГрк╖рлНрка, ркжрк╕рлНркдрк╛рк╡рлЗркЬ, рккрлГрк╖рлНрка
ЁЯУ░ => ЁЯУ░, ркХрк╛ркЧрк│, рк╕ркорк╛ркЪрк╛рк░, рк╕ркорк╛ркЪрк╛рк░рккркдрлНрк░, рк╕ркорк╛ркЪрк╛рк░рккркдрлНрк░, ркЫрк╛рккрлБркВ
ЁЯЧЮ => ЁЯЧЮ, рк╡рк╛рк│рлЗрк▓рлБркВ ркЫрк╛рккрлБркВ, рк╕ркорк╛ркЪрк╛рк░рккркдрлНрк░
ЁЯУС => ЁЯУС, ркЯрлЗркмрлНрк╕, ркмрлБркХркорк╛рк░рлНркХ, ркмрлБркХркорк╛рк░рлНркХрлНрк╕ ркЯрлЗркмрлНрк╕, ркорк╛рк░рлНркХрк░
ЁЯФЦ => ЁЯФЦ, ркмрлБркХркорк╛рк░рлНркХ, ркорк╛рк░рлНркХ
ЁЯП╖ => ЁЯП╖, рк▓рлЗркмрк▓
ЁЯТ░ => ЁЯТ░, ркбрлЙрк▓рк░ ркмрлЕркЧ, рккрлИрк╕рк╛, рккрлИрк╕рк╛ркирлА ркерлЗрк▓рлА, ркмрлЕркЧ
ЁЯТ┤ => ЁЯТ┤, ркирлЛркЯ, ркмрк┐рк▓, ркмрлЗркВркХркирлЛркЯ, ркпрлЗрки ркирлЛркЯ, ркпрлЗрки ркирлЛркЯ. ркмрлЗркВркХ ркирлЛркЯ, ркпрлЗрки. рккрлИрк╕рк╛
ЁЯТ╡ => ЁЯТ╡, ркбрлЙрк▓рк░, ркбрлЙрк▓рк░ ркирлЛркЯ, ркирлЛркЯ, рккрлИрк╕рк╛, ркмрк┐рк▓, ркмрлЗркВркХркирлЛркЯ
ЁЯТ╢ => ЁЯТ╢, ркирлЛркЯ, рккрлИрк╕рк╛, ркмрк┐рк▓, ркмрлЗркВркХркирлЛркЯ, ркпрлБрк░рлЛ, ркпрлБрк░рлЛ ркирлЛркЯ
ЁЯТ╖ => ЁЯТ╖, рккрк╛ркЙркирлНркб, рккрк╛ркЙркирлНркб ркирлЛркЯ, рккрлИрк╕рк╛, ркмрлЗркВркХркирлЛркЯ
ЁЯТ╕ => ЁЯТ╕, ркКркбркдрк╛ рккрлИрк╕рк╛, ркКркбркдрлА ркмрлЗркВркХркирлЛркЯ, ркирлЛркЯ, рккркВркЦ рк╕рк╛ркерлЗркирк╛ркВ рккрлИрк╕рк╛, рккрлИрк╕рк╛, ркмрлЗркВркХ
ЁЯТ│ => ЁЯТ│, ркХрк╛рк░рлНркб, ркХрлНрк░рлЗркбрк┐ркЯ, ркХрлНрк░рлЗркбрк┐ркЯ ркХрк╛рк░рлНркб
ЁЯТ╣ => ЁЯТ╣, ркЖрк▓рлЗркЦ, ркЙрккрк░ркирлА ркдрк░ркл, ркКркВркЪрлЗ ркЬркдрлЛ ркЖрк▓рлЗркЦ, ркКркаркдрлБркВ ркмркЬрк╛рк░, ркмркЬрк╛рк░, ркпрлЗрки рк╕рк╛ркерлЗ ркЙрккрк░ ркЬркдрлЛ ркЪрк╛рк░рлНркЯ
ЁЯТ▒ => ЁЯТ▒, рккрлИрк╕рк╛, ркорлБркжрлНрк░рк╛, ркорлБркжрлНрк░рк╛ рк╡рк┐ркирк┐ркоркп, рк╡рк┐ркирк┐ркоркп
ЁЯТ▓ => ЁЯТ▓, ркШрк╛ркЯрлБркВ ркбрлЙрк▓рк░ ркЪрк┐рк╣рлНрки, ркШрк╛ркЯрлБркВ ркбрлЙрк▓рк░ркирлБркВ ркЪрк┐рк╣рлНрки, ркбрлЙрк▓рк░, ркбрлЙрк▓рк░ ркЪрк┐рк╣рлНрки, рккрлИрк╕рк╛
тЬЙ => тЬЙ, ркЗркорлЗркЗрк▓, рккрк░ркмрлАркбрк┐ркпрлБркВ
ЁЯУз => ЁЯУз, ркЗркорлЗркЗрк▓, рккркдрлНрк░, ркорлЗркЗрк▓, рк╕ркВркЪрк╛рк░
ЁЯУи => ЁЯУи, ркЖрк╡ркирк╛рк░рлА, ркЖрк╡ркирк╛рк░рлА ркорлЗркЗрк▓, ркЗркорлЗркЗрк▓, рккркдрлНрк░, рккрк░ркмрлАркбрк┐ркпрлБркВ, рккрлНрк░рк╛рккрлНркд ркорлЗркЗрк▓, ркорлЗркЗрк▓, рк╕ркВркЪрк╛рк░
ЁЯУй => ЁЯУй, ркЗркорлЗркЗрк▓, рккркдрлНрк░, рккрк░ркмрлАркбрк┐ркпрлБркВ, ркмрк╣рк╛рк░ ркЬркдрлА, ркмрк╣рк╛рк░ ркЬркдрлА ркорлЗркЗрк▓, ркорлЗркЗрк▓, ркорлЛркХрк▓рлЗрк▓ ркорлЗркЗрк▓, рк╕ркВркЪрк╛рк░
ЁЯУд => ЁЯУд, ркЖркЙркЯркмрлЛркХрлНрк╕, ркЖркЙркЯркмрлЛркХрлНрк╕ ркЯрлНрк░рлЗ, ркЯрлНрк░рлЗ, ркмрлЛркХрлНрк╕, ркорлЗркЗрк▓, ркорлЛркХрк▓рлЗрк▓, ркорлЛркХрк▓рлЗрк▓ ркмрлЛркХрлНрк╕, ркорлЛркХрк▓рлЗрк▓ ркорлЗркЗрк▓, рк╕ркВркЪрк╛рк░
ЁЯУе => ЁЯУе, ркЗркиркмрлЛркХрлНрк╕, ркЗркиркмрлЛркХрлНрк╕ ркЯрлНрк░рлЗ, ркЯрлНрк░рлЗ, рккрлНрк░рк╛рккрлНркд, рккрлНрк░рк╛рккрлНркд ркорлЗркЗрк▓, ркмрлЛркХрлНрк╕, ркорлЗркЗрк▓, рк╕ркВркЪрк╛рк░
ЁЯУж => ЁЯУж, рккрк╛рк░рлНрк╕рк▓, рккрлЕркХрлЗркЬ, ркмрлЛркХрлНрк╕
ЁЯУл => ЁЯУл, ркзрлНрк╡ркЬ, рклрк░ркХрк╛рк╡рлЗрк▓рк╛ ркзрлНрк╡ркЬрк╡рк╛рк│рлБркВ ркорлЗркЗрк▓ркмрлЛркХрлНрк╕, ркмркВркз, ркорлЗркЗрк▓, ркорлЗркЗрк▓ркмрлЛркХрлНрк╕
ЁЯУк => ЁЯУк, ркзрлНрк╡ркЬ, ркиркорк╛рк╡рлЗрк▓ ркзрлНрк╡ркЬрк╡рк╛рк│рлБркВ ркорлЗркЗрк▓ркмрлЛркХрлНрк╕, ркмркВркз, ркорлЗркЗрк▓, ркорлЗркЗрк▓ркмрлЛркХрлНрк╕
ЁЯУм => ЁЯУм, ркЦрлБрк▓рлНрк▓рлБркВ, ркзрлНрк╡ркЬ, рклрк░ркХрк╛рк╡рлЗрк▓рк╛ ркзрлНрк╡ркЬрк╡рк╛рк│рлБркВ ркЦрлБрк▓рлНрк▓рлБркВ ркорлЗркЗрк▓ркмрлЛркХрлНрк╕, ркорлЗркЗрк▓, ркорлЗркЗрк▓ркмрлЛркХрлНрк╕
ЁЯУн => ЁЯУн, ркЦрлБрк▓рлНрк▓рлБркВ, ркзрлНрк╡ркЬ, ркиркорк╛рк╡рлЗрк▓ ркзрлНрк╡ркЬрк╡рк╛рк│рлБркВ ркЦрлБрк▓рлНрк▓рлБркВ ркорлЗркЗрк▓ркмрлЛркХрлНрк╕, ркорлЗркЗрк▓, ркорлЗркЗрк▓ркмрлЛркХрлНрк╕
ЁЯУо => ЁЯУо, рккрлЛрк╕рлНркЯркмрлЙркХрлНрк╕, ркорлЗркЗрк▓, ркорлЗркЗрк▓ркмрлЙркХрлНрк╕
ЁЯЧ│ => ЁЯЧ│, ркмрлЙркХрлНрк╕, ркоркдркжрк╛рки, ркоркдркжрк╛рки рк╕рк╛ркерлЗ ркоркдркжрк╛рки ркмрлЙркХрлНрк╕
тЬП => тЬП, рккрлЕркирлНрк╕рк┐рк▓
тЬТ => тЬТ, ркирк┐ркм, рккрлЕрки, ркмрлНрк▓рлЗркХ ркирк┐ркм
ЁЯЦЛ => ЁЯЦЛ, рккрлЕрки, рклрк╛ркЙркирлНркЯрки, рклрк╛ркЙркирлНркЯрки рккрлЕрки
ЁЯЦК => ЁЯЦК, рккрлЕрки, ркмрлЛрк▓рккрлЙркЗркирлНркЯ
ЁЯЦМ => ЁЯЦМ, ркЪрк┐ркдрлНрк░ркХрк│рк╛, рккрлЗркЗркирлНркЯркмрлНрк░рк╢
ЁЯЦН => ЁЯЦН, ркХрлНрк░рлЗркпрлЛрки, рк░ркВркЧрлАрки ркЪрк╛ркХ
ЁЯУЭ => ЁЯУЭ, ркорлЗркорлЛ, ркорлЗркорлЛ рккрлБрк╕рлНркдркХ, рк╕ркВркЪрк╛рк░
ЁЯТ╝ => ЁЯТ╝, ркмрлНрк░рлАрклркХрлЗрк╕
ЁЯУБ => ЁЯУБ, рклрк╛ркЗрк▓, рклрк╛ркЗрк▓ рклрлЛрк▓рлНркбрк░
ЁЯУВ => ЁЯУВ, ркЦрлБрк▓рлНрк▓рлБркВ, ркЦрлБрк▓рлНрк▓рлБркВ рклрк╛ркЗрк▓ рклрлЛрк▓рлНркбрк░, ркЦрлБрк▓рлНрк▓рлБркВ рклрлЛрк▓рлНркбрк░, рклрк╛ркЗрк▓, рклрлЛрк▓рлНркбрк░
ЁЯЧВ => ЁЯЧВ, ркЗркирлНркбрлЗркХрлНрк╕, ркХрк╛рк░рлНркб, ркХрк╛рк░рлНркб ркЗркирлНркбрлЗркХрлНрк╕ ркбрк┐рк╡рк╛ркЗркбрк░рлНрк╕, ркбрк┐рк╡рк╛ркЗркбрк░рлНрк╕
ЁЯУЕ => ЁЯУЕ, ркХрлЕрк▓рлЗркирлНркбрк░, ркХрлЗрк▓рлЗркирлНркбрк░
ЁЯУЖ => ЁЯУЖ, ркХрлЗрк▓рлЗркирлНркбрк░, ркдрк╛рк░рлАркЦрк┐ркпрлБркВ
ЁЯЧТ => ЁЯЧТ, ркирлЛркЯ, рккрлЗркб, рк╕рлНрккрк╛ркЗрк░рк▓, рк╕рлНрккрк╛ркЗрк░рк▓ ркирлЛркЯрккрлЗркб
ЁЯЧУ => ЁЯЧУ, ркХрлЕрк▓рлЗркирлНркбрк░, рккрлЗркб, рк╕рлНрккрк╛ркЗрк░рк▓, рк╕рлНрккрк╛ркЗрк░рк▓ ркХрлЕрк▓рлЗркирлНркбрк░
ЁЯУЗ => ЁЯУЗ, ркЗркирлНркбрлЗркХрлНрк╕, ркХрк╛рк░рлНркб ркЕркирлБркХрлНрк░рко, рк░рлЛрк▓рлЛркбрлЗркХрлНрк╕
ЁЯУИ => ЁЯУИ, ркЖрк▓рлЗркЦ, ркЙркВркЪрлЗ ркЬркдрлЛ ркЪрк╛рк░рлНркЯ, ркЙркВркЪрлЗркирк╛ рк╡рк▓ркгркирлЛ ркЪрк╛рк░рлНркЯ, ркЙркВркЪрлЗркирлБркВ рк╡рк▓ркг, ркЙрккрк░ркирлА ркдрк░ркл, ркЪрк╛рк░рлНркЯ
ЁЯУЙ => ЁЯУЙ, ркЖрк▓рлЗркЦ, ркЙркВркЪрлЗркирк╛ рк╡рк▓ркгркирлЛ ркЪрк╛рк░рлНркЯ, ркЪрк╛рк░рлНркЯ, ркирлАркЪрлЗ ркЬркдрлЛ ркЪрк╛рк░рлНркЯ, ркирлАркЪрлЗркирлА ркдрк░ркл, ркирлАркЪрлЗркирлБркВ рк╡рк▓ркг
ЁЯУК => ЁЯУК, ркЪрк╛рк░рлНркЯ, ркмрк╛рк░ ркЪрк╛рк░рлНркЯ, рк╕рлНркдркВркн ркЖрк▓рлЗркЦ
ЁЯУЛ => ЁЯУЛ, ркХрлНрк▓рк┐рккркмрлЙрк░рлНркб
ЁЯУМ => ЁЯУМ, рккрк┐рки, рккрлБрк╢рккрк┐рки
ЁЯУН => ЁЯУН, ркЧрлЛрк│рк╛ркХрк╛рк░ рккрлБрк╢рккрк┐рки, рккрк┐рки, рккрлБрк╢рккрк┐рки
ЁЯУО => ЁЯУО, ркХрлНрк▓рк┐ркк, рккрлЗрккрк░ркХрлНрк▓рк┐ркк
ЁЯЦЗ => ЁЯЦЗ, рккрлЗрккрк░ркХрлНрк▓рк┐ркк, рк▓рк┐ркВркХ ркХрк░рлЗрк▓ рккрлЗрккрк░ркХрлНрк▓рк┐рккрлНрк╕
ЁЯУП => ЁЯУП, ркЖркВркХркгрлА, рк╕рлАркзрлА ркЖркВркХркгрлА
ЁЯУР => ЁЯУР, ркЖркВркХркгрлА, ркХрк╛ркЯркЦрлВркгрк┐ркпрлБркВ, ркдрлНрк░рк┐ркХрлЛркг, ркдрлНрк░рк┐ркХрлЛркг ркЖркВркХркгрлА
тЬВ => тЬВ, ркХрк╛ркдрк░, рк╕рк╛ркзрки
ЁЯЧГ => ЁЯЧГ, ркХрк╛рк░рлНркб рклрк╛ркЗрк▓ ркмрлЙркХрлНрк╕, рклрк╛ркЗрк▓
ЁЯЧД => ЁЯЧД, ркХрлЕркмрк┐ркирлЗркЯ, рклрк╛ркЗрк▓, рклрк╛ркЗрк▓ ркХрлЕркмрк┐ркирлЗркЯ
ЁЯЧС => ЁЯЧС, ркХркЪрк░рк╛рккрлЗркЯрлА
ЁЯФТ => ЁЯФТ, ркдрк╛рк│рлБркВ, ркмркВркз ркдрк╛рк│рлБркВ
ЁЯФУ => ЁЯФУ, ркЦрлБрк▓рлНрк▓рлБркВ ркдрк╛рк│рлБркВ, ркдрк╛рк│рлБркВ
ЁЯФП => ЁЯФП, ркЗркВркХ рккрлЗрки, ркЗркВркХ рккрлЗрки рк╕рк╛ркерлЗ рк▓рлЙркХ, ркЧрлЛрккркирлАркпркдрк╛, рккрлЗрки рк╕рк╛ркерлЗ рк▓рлЙркХ, рк▓рлЙркХ ркХрк░рлЛ
ЁЯФР => ЁЯФР, ркЪрк╛рк╡рлА рк╕рк╛ркерлЗ ркдрк╛рк│рлБркВ, ркЪрк╛рк╡рлА рк╕рк╛ркерлЗ ркмркВркз ркдрк╛рк│рлБркВ, ркмркВркз ркдрк╛рк│рлБркВ, рк╕рлБрк░ркХрлНрк╖рк┐ркд
ЁЯФС => ЁЯФС, ркХрлА, ркЪрк╛рк╡рлА, рккрк╛рк╕рк╡рк░рлНркб
ЁЯЧЭ => ЁЯЧЭ, ркХрк│, ркЬрлВркирлА ркЪрк╛рк╡рлА, ркдрк╛рк│рлБркВ
ЁЯФи => ЁЯФи, рк╕рк╛ркзрки, рк╣ркерлЛркбрлА
тЫП => тЫП, ркЦркирки, ркдрлАркХрко, рк╕рк╛ркзрки
тЪТ => тЪТ, ркдрк┐ркХрко, рк╕рк╛ркзрки, рк╣ркерлЛркбрлА, рк╣ркерлЛркбрлА ркЕркирлЗ ркдрк┐ркХрко
ЁЯЫа => ЁЯЫа, рк╕рк╛ркзрки, рк╣ркерлЛркбрлА ркЕркирлЗ рккрк╛ркирлБркВ
ЁЯЧб => ЁЯЧб, ркХркЯрк╛рк░, ркЪрк╛ркХрлБ, рк╣ркерк┐ркпрк╛рк░
тЪФ => тЪФ, ркХрлНрк░рлЛрк╕ ркмркирк╛рк╡ркдрлА ркдрк▓рк╡рк╛рк░рлЛ, рк╣ркерк┐ркпрк╛рк░
ЁЯФл => ЁЯФл, ркЧрки, рккрк┐рк╕рлНркдрлЛрк▓, рк░рлАрк╡рлЛрк▓рлНрк╡рк░
ЁЯП╣ => ЁЯП╣, ркдрлАрк░ ркЕркирлЗ ркХркорк╛рки, ркдрлАрк░ркВркжрк╛ркЬ, рк░рк╛рк╢рк┐, рк╕рк╛ркзрки, рк╣ркерк┐ркпрк╛рк░
ЁЯЫб => ЁЯЫб, ркврк╛рк▓, рк╣ркерк┐ркпрк╛рк░
ЁЯФз => ЁЯФз, рккрк╛ркирлБркВ, рк░рлЗркВркЪ, рк╕рк╛ркзрки
ЁЯФй => ЁЯФй, ркиркЯ, ркиркЯ ркЕркирлЗ ркмрлЛрк▓рлНркЯ, ркмрлЛрк▓рлНркЯ, рк╕рк╛ркзрки
тЪЩ => тЪЩ, ркЧрк┐ркпрк░, рк╕рк╛ркзрки
ЁЯЧЬ => ЁЯЧЬ, ркХркорлНрккрлНрк░рлЗрк╢рки, рк╕рк╛ркзрки
тЪЧ => тЪЧ, ркЕрк▓рлЗркорлНркмрк┐ркХ, рк╡рк░рк╛рк│ ркарк╛рк░рлАркирлЗ рккрлНрк░рк╡рк╛рк╣рлА рк╢рлБркжрлНркз ркХрк░рк╡рк╛ркирлБркВ рк╕рк╛ркзрки
тЪЦ => тЪЦ, ркдрк░рк╛ркЬрлБ, ркдрлБрк▓рк╛, ркирлНркпрк╛ркп, ркорк╛ркк, рк░рк╛рк╢рк┐, рк╡ркЬрки
ЁЯФЧ => ЁЯФЧ, ркмрлЗ рк░рк┐ркВркЧрлНрк╕, рк▓рк┐ркВркХ, рк▓рк┐ркВркХркирлБркВ ркЪрк┐рк╣рлНрки, рк▓рк┐ркВркХрлНрк╕
тЫУ => тЫУ, рк╕рк╛ркВркХрк│
ЁЯТЙ => ЁЯТЙ, ркбрлЛркХрлНркЯрк░, ркжрк╡рк╛, рк╢рлЛркЯ, рк╕рлАрк░рк┐ркВркЬ, рк╕рлЛркп
ЁЯТК => ЁЯТК, ркЧрлЛрк│рлА, ркЧрлЛрк│рлА, ркЯрк┐ркХркбрлА, ркбрлЛркХрлНркЯрк░, ркжрк╡рк╛
ЁЯЪм => ЁЯЪм, ркЪрк┐рк╣рлНрки, ркзрлВркорлНрк░рккрк╛рки, ркзрлВркорлНрк░рккрк╛ркиркирлА ркЕркирлБркоркдрк┐, ркзрлВркорлНрк░рккрк╛ркиркирлБркВ ркЪрк┐рк╣рлНрки
тЪ░ => тЪ░, ркХрлЙрклрк┐рки, ркорлГркдрлНркпрлБ
тЪ▒ => тЪ▒, ркЕркВркдрк┐ркоркпрк╛ркдрлНрк░рк╛, ркЕрк╕рлНркерк┐ ркХрк│рк╢
ЁЯЧ┐ => ЁЯЧ┐, рккрлНрк░ркдрк┐ркорк╛, ркорлЛркпрк╛ркИ, ркорлЛркпрк╛ркИркирлА рккрлНрк░ркдрк┐ркорк╛
ЁЯЫв => ЁЯЫв, ркЯрк╛ркВркХрлА, ркдрлЗрк▓, ркдрлЗрк▓ркирлБркВ ркбрлНрк░рко
ЁЯФо => ЁЯФо, ркжркбрлЛ, ркнрк╛ркЧрлНркп, ркнрк╛ркЧрлНркп ркХркерки, рк╕рлНрклркЯрк┐ркХ, рк╕рлНрклркЯрк┐ркХркирлЛ ркжркбрлЛ
ЁЯЫТ => ЁЯЫТ, ркХрк╛рк░рлНркЯ, ркЯрлНрк░рлЙрк▓рлА, рк╢рлЙрккрк┐ркВркЧ, рк╢рлЙрккрк┐ркВркЧ ркХрк╛рк░рлНркЯ
ЁЯПз => ЁЯПз, ркПркЯрлАркПрко, ркСркЯрлЛркорлЗркЯрлЗркб, ркСркЯрлЛркорлЗркЯрлЗркб ркЯрлЗрк▓рк░, ркЯрлЗрк▓рк░
ЁЯЪо => ЁЯЪо, ркХркЪрк░рк╛ рккрлЗркЯрлА, ркХркЪрк░рк╛ркирлЗ ркдрлЗркирк╛ рк╕рлНркерк╛ркирлЗ ркирк╛ркВркЦрлЛ, ркХркЪрк░рк╛рккрлЗркЯрлАркирлБркВ ркЪрк┐рк╣рлНрки, ркХркЪрк░рлЛ ркХркЪрк░рк╛рккрлЗркЯрлАркорк╛ркВ ркирк╛ркВркЦрлЛркирлБркВ ркЪрк┐рк╣рлНрки, ркЪрк┐рк╣рлНрки
ЁЯЪ░ => ЁЯЪ░, рккрлАрк╡рк╛ ркорк╛ркЯрлЗркирлБркВ рккрк╛ркгрлА, рккрлАрк╡рк╛ркирк╛ркВ рккрк╛ркгрлАркирлБркВ ркЪрк┐рк╣рлНрки, рккрлАрк╡рк╛ркирлБркВ рккрк╛ркгрлА
тЩ┐ => тЩ┐, ркЕтАНрлЕркХрлНрк╕рлЗрк╕, ркЪрк┐рк╣рлНрки, рк╡рлНрк╣рлАрк▓ркЪрлЗрк░, рк╡рлНрк╣рлАрк▓ркЪрлЗрк░ ркЕтАНрлЕркХрлНрк╕рлЗрк╕, рк╡рлНрк╣рлАрк▓ркЪрлЗрк░ркирлБркВ рккрлНрк░ркдрлАркХ
ЁЯЪ╣ => ЁЯЪ╣, ркЪрк┐рк╣рлНрки, рккрлБрк░рлБрк╖рлЛркирлБркВ ркЪрк┐рк╣рлНрки, рккрлБрк░рлБрк╖рлЛркирлБркВ ркЪрк┐рк╣рлНрки, рккрлБрк░рлБрк╖рлЛркирлЛ ркЦркВркб, рккрлБрк░рлБрк╖рлЛркирлБркВ рккрлНрк░ркдрлАркХ, рккрлБрк░рлБрк╖рлЛркирлЛ ркЦркВркб
ЁЯЪ║ => ЁЯЪ║, ркЪрк┐рк╣рлНрки, ркорк╣рк┐рк▓рк╛ркУркирлБркВ ркЪрк┐рк╣рлНрки, ркорк╣рк┐рк▓рк╛ркУркирлБркВ ркЪрк┐рк╣рлНрки, ркорк╣рк┐рк▓рк╛ркУркирлЛ ркЦркВркб, ркорк╣рк┐рк▓рк╛ркУркирлБркВ рккрлНрк░ркдрлАркХ, ркорк╣рк┐рк▓рк╛ркУркирлЛ ркЦркВркб
ЁЯЪ╗ => ЁЯЪ╗, wc, рк░рлЗрк╕рлНркЯрк░рлВрко, рк░рлЗрк╕рлНркЯрк░рлВрко ркЪрк┐рк╣рлНрки, рк╢рлМркЪрк╛рк▓ркп
ЁЯЪ╝ => ЁЯЪ╝, ркЕркВркжрк░ ркмрк╛рк│ркХ ркЫрлЗ, ркмрк╛рк│ркХ, ркмрк╛рк│ркХркирк╛ рк╡рк╕рлНркдрлНрк░ ркмркжрк▓рк╡рк╛ркирлБркВ рк╕рлНркерк╛рки, ркмрк╛рк│ркХркирлБркВ ркЪрк┐рк╣рлНрки
ЁЯЪ╛ => ЁЯЪ╛, WC, рк░рлЗрк╕рлНркЯрк░рлВрко, рк╡рлЙркЯрк░ ркХрлНрк▓рлЛркЭрлЗркЯ, рк╢рлМркЪрк╛рк▓ркп
ЁЯЫВ => ЁЯЫВ, ркХркирлНркЯрлНрк░рлЛрк▓, рккрк╛рк╕рккрлЛрк░рлНркЯ, рккрк╛рк╕рккрлЛрк░рлНркЯ ркХркирлНркЯрлНрк░рлЛрк▓
ЁЯЫГ => ЁЯЫГ, ркХрк╕рлНркЯркорлНрк╕
ЁЯЫД => ЁЯЫД, ркмрлЕркЧрлЗркЬ, ркмрлЕркЧрлЗркЬ ркжрк╛рк╡рлЛ, ркмрлЕркЧрлЗркЬркирлЛ ркжрк╛рк╡рлЛ
ЁЯЫЕ => ЁЯЫЕ, ркмрлЕркЧрлЗркЬ, ркмрлЕркЧрлЗркЬ рк╕рлЗрк╡рк╛, рк╕рк╛ркорк╛рки, рк╕рк╛ркорк╛рки ркорлВркХрлЛ
тЪа => тЪа, ркЪрк┐рк╣рлНрки, ркЪрлЗркдрк╡ркгрлА, ркЪрлЗркдрк╡ркгрлАркирлБркВ ркЪрк┐рк╣рлНрки
ЁЯЪ╕ => ЁЯЪ╕, ркХрлНрк░рлЛрк╕рк┐ркВркЧ, ркЪрк┐рк╣рлНрки, ркмрк╛рк│ркХрлЛ, ркмрк╛рк│ркХрлЛ ркорк╛ркЯрлЗркирлБркВ ркХрлНрк░рлЛрк╕рк┐ркВркЧ, ркмрк╛рк│ркХрлЛ ркорк╛ркЯрлЗркирлБркВ ркХрлНрк░рлЛрк╕рк┐ркВркЧркирлБркВ ркЪрк┐рк╣рлНрки
тЫФ => тЫФ, ркЪрк┐рк╣рлНрки, ркирк╣рлАркВ, ркирк┐рк╖рлЗркз, рккрлНрк░рк╡рлЗрк╢ ркирк┐рк╖рлЗркз, рккрлНрк░рк╡рлЗрк╢ ркирк┐рк╖рлЗркзркирлБркВ ркЪрк┐рк╣рлНрки
ЁЯЪл => ЁЯЪл, ркЪрк┐рк╣рлНрки, ркирк┐рк╖рк┐ркжрлНркз, рккрлНрк░рк╡рлЗрк╢ ркирк┐рк╖рлЗркз, рккрлНрк░рк╡рлЗрк╢ ркирк┐рк╖рлЗркз ркЪрк┐рк╣рлНрки
ЁЯЪ│ => ЁЯЪ│, ркмрк╛ркЗркХ, ркмрк╛ркЗркХ ркирк╣рлАркВ, рк╡рк╛рк╣рки, рк╕рк╛ркЗркХрк▓ ркирк╣рлАркВ, рк╕рк╛ркЗркХрк▓ркирлЗ ркоркВркЬрлВрк░рлА ркиркерлА
ЁЯЪн => ЁЯЪн, ркЪрк┐рк╣рлНрки, ркзрлВркорлНрк░рккрк╛рки ркирк┐рк╖рлЗркз, ркзрлВркорлНрк░рккрк╛рки ркирк┐рк╖рлЗркзркирлБркВ ркЪрк┐рк╣рлНрки
ЁЯЪп => ЁЯЪп, ркХркЪрк░рлЛ ркХрк░рк╢рлЛ ркирк╣рлАркВ, ркХркЪрк░рлЛ рклрлЗркВркХрк╡рлЛ ркирк╣рлАркВ, ркХркЪрк░рлЛ рклрлЗркВркХрк╢рлЛ ркирк╣рлАркВркирлБркВ ркЪрк┐рк╣рлНрки, ркЪрк┐рк╣рлНрки
ЁЯЪ▒ => ЁЯЪ▒, рккрк╛ркгрлА, рккрлАрк╡рк╛ ркпрлЛркЧрлНркп рккрк╛ркгрлА ркиркерлА, рккрлАрк╡рк╛ркирлБркВ рккрк╛ркгрлА ркирк╣рлАркВ, рккрлЗркп ркирк╣рлАркВ
ЁЯЪ╖ => ЁЯЪ╖, ркЪрк┐рк╣рлНрки, рккркжркпрк╛ркдрлНрк░рлА, рккркжркпрк╛ркдрлНрк░рлАркУ ркирк╣рлАркВ, рккркжркпрк╛ркдрлНрк░рлАркУркирлЗ ркоркВркЬрлВрк░рлА ркиркерлА, рк░рк╛рк╣ркжрк╛рк░рлА
ЁЯУ╡ => ЁЯУ╡, ркХрлЙрк▓рлНрк╕ ркирк╣рлАркВ, ркХрлЛркИ ркорлЛркмрк╛ркЗрк▓ рклрлЛрки ркирк╣рлАркВ, рклрлЛрки, ркорлЛркмрк╛ркЗрк▓, рк╕рлЗрк▓ рклрлЛрки ркирк╣рлАркВ
ЁЯФЮ => ЁЯФЮ, 18, 18 ркерлА ркирлАркЪрлЗркирк╛, 18 ркерлА ркирлАркЪрлЗркирк╛ рккрлНрк░ркдрк┐ркмркВркзрк┐ркд, 18 ркирлА ркирлАркЪрлЗркирлБркВ ркХрлЛркИ ркирк╣рлАркВ, ркЕркврк╛рк░ рк╡рк░рлНрк╖ркерлА ркирлАркЪрлЗркирк╛ рккрлНрк░ркдрк┐ркмркВркзрк┐ркд
тШв => тШв, рк░рлЗркбрк┐ркУркНркХрлНркЯрк┐рк╡, рк╕ркВркХрлЗркд
тШг => тШг, ркмрк╛ркпрлЛрк╣ркЭрк╛рк░рлНркб, рк╕ркВркХрлЗркд
тмЖ => тмЖ, ркЙркдрлНркдрк░, ркЙрккрк░ ркдрлАрк░, ркдрлАрк░, ркжрк┐рк╢рк╛
тЖЧ => тЖЧ, ркЙркдрлНркдрк░рккрлВрк░рлНрк╡, ркЙрккрк░-ркЬркоркгрлБркВ ркдрлАрк░, ркдрлАрк░, ркжрк┐рк╢рк╛
тЮб => тЮб, ркЬркоркгрлБркВ ркдрлАрк░, ркдрлАрк░, ркжрк┐рк╢рк╛, рккрлВрк░рлНрк╡
тЖШ => тЖШ, ркдрлАрк░, ркжркХрлНрк╖рк┐ркгрккрлВрк░рлНрк╡, ркжрк┐рк╢рк╛, ркирлАркЪрлЗ-ркЬркоркгрлБркВ ркдрлАрк░
тмЗ => тмЗ, ркдрлАрк░, ркжркХрлНрк╖рк┐ркг, ркжрк┐рк╢рк╛, ркирлАркЪрлЗ, ркирлАркЪрлЗ ркдрлАрк░
тЖЩ => тЖЩ, ркдрлАрк░, ркжркХрлНрк╖рк┐ркгрккрк╢рлНркЪрк┐рко, ркирлАркЪрлЗ-ркбрк╛ркмрлБркВ ркдрлАрк░
тмЕ => тмЕ, ркбрк╛ркмрлБркВ ркдрлАрк░, ркжрк┐рк╢рк╛, рккрк╢рлНркЪрк┐рко
тЖЦ => тЖЦ, ркЙрккрк░-ркбрк╛ркмрлБркВ ркдрлАрк░, рккрлВрк░рлНрк╡рккрк╢рлНркЪрк┐рко
тЖХ => тЖХ, ркЙрккрк░-ркирлАркЪрлЗ ркдрлАрк░, ркдрлАрк░
тЖФ => тЖФ, ркбрк╛ркмрлБркВ-ркЬркоркгрлБркВ ркдрлАрк░, ркдрлАрк░
тЖй => тЖй, ркбрк╛ркмрлЗ рк╡рк│ркдрлБркВ ркЬркоркгрлБркВ ркдрлАрк░, ркдрлАрк░
тЖк => тЖк, ркЬркоркгрлЗ рк╡рк│ркдрлБркВ ркбрк╛ркмрлБркВ ркдрлАрк░, ркдрлАрк░
тд┤ => тд┤, ркЙрккрк░ рк╡рк│ркдрлБркВ ркЬркоркгрлБркВ ркдрлАрк░, ркдрлАрк░
тд╡ => тд╡, ркдрлАрк░, ркирлАркЪрлЗ рк╡рк│ркдрлБркВ ркЬркоркгрлБркВ ркдрлАрк░
ЁЯФГ => ЁЯФГ, ркКркнрк╛ ркжркХрлНрк╖рк┐ркгрк╛рк╡рк░рлНркдрлА ркдрлАрк░, ркдрлАрк░, рклрк░рлАркерлА рк▓рлЛркб ркХрк░рлЛ, рклрк░рлАркерлА рк▓рлЛркб ркХрк░рлЛркирлБркВ ркЪрк┐рк╣рлНрки
ЁЯФД => ЁЯФД, ркдрлАрк░, рк╡рк╛ркорк╛рк╡рк░рлНркдрлА, рк╡рк╛ркорк╛рк╡рк░рлНркдрлА ркдрлАрк░, рк╡рк╛ркорк╛рк╡рк░рлНркдрлА ркдрлАрк░ ркмркЯрки
ЁЯФЩ => ЁЯФЩ, ркбрк╛ркмрк╛ ркдрлАрк░ рк╕рк╛ркерлЗ рккрк╛ркЫрк│, ркбрк╛ркмрлБркВ ркдрлАрк░, ркдрлАрк░, рккрк╛ркЫрк│, рккрк╛ркЫрк│ ркдрлАрк░
ЁЯФЪ => ЁЯФЪ, ркбрк╛ркмрк╛ ркдрлАрк░ рк╕рк╛ркерлЗ рк╕ркорк╛рккрлНркдрк┐, ркбрк╛ркмрлБркВ ркдрлАрк░, ркдрлАрк░, рк╕ркорк╛рккрлНркдрк┐, рк╕ркорк╛рккрлНркдрк┐ ркдрлАрк░
ЁЯФЫ => ЁЯФЫ, ркЙркжрлНркЧрк╛рк░рк╡рк╛ркЪркХ, ркЙркжрлНркЧрк╛рк░рк╡рк╛ркЪркХ ркЪрк┐рк╣рлНрки, ркЙркжрлНркЧрк╛рк░рк╡рк╛ркЪркХ ркЪрк┐рк╣рлНрки ркЕркирлЗ ркдрлАрк░ рк╕рк╛ркерлЗ ркЪрк╛рк▓рлБ, ркЪрк╛рк▓рлБ ркдрлАрк░, ркЪрк╛рк▓рлБ! ркдрлАрк░, ркдрлАрк░
ЁЯФЬ => ЁЯФЬ, ркЬркоркгрк╛ркВ ркдрлАрк░ рк╕рк╛ркерлЗ ркЬрк▓рлНркжрлА, ркЬрк▓рлНркжрлА, ркЬрк▓рлНркжрлАркирлБркВ ркЪрк┐рк╣рлНрки, ркЬрк▓рлНркжрлАркирлБркВ ркдрлАрк░, ркдрлАрк░
ЁЯФЭ => ЁЯФЭ, ркЙрккрк░, ркЙрккрк░ ркдрлАрк░, ркЙрккрк░ркирк╛ркВ ркдрлАрк░ рк╕рк╛ркерлЗ ркЯрлЛркЪ, ркЯрлЛркЪ, ркЯрлЛркЪркирлБркВ ркЪрк┐рк╣рлНрки
ЁЯЫР => ЁЯЫР, ркЖрк░рк╛ркзркирк╛ рк╕рлНркерк│, ркзрк░рлНрко, рккрлНрк░рк╛рк░рлНркеркирк╛
тЪЫ => тЪЫ, ркЕркгрлБркВ, ркЕркгрлБркВркирлБркВ рккрлНрк░ркдрлАркХ
ЁЯХЙ => ЁЯХЙ, рлР, ркзрк░рлНрко, рк╣рк┐ркирлНркжрлБ
тЬб => тЬб, ркбрлЗрк╡рк┐ркб, ркбрлЗрк╡рк┐ркбркирлЛ ркдрк╛рк░рлЛ, ркдрк╛рк░рлЛ, ркзрк░рлНрко, ркпрк╣рлЛркжрлА
тШ╕ => тШ╕, ркЪркХрлНрк░, ркзрк░рлНрко, ркзрк░рлНрко ркЪркХрлНрк░, ркмрлМркжрлНркз
тШп => тШп, ркдрк╛ркУ, ркзрк░рлНрко, ркпрк╛ркВркЧ, ркпрк┐рки, ркпрк┐рки ркпрк╛ркВркЧ
тЬЭ => тЬЭ, ркХрлНрк░рлЛрк╕, ркЦрлНрк░рк┐рк╕рлНркдрлА, ркзрк░рлНрко, рк▓рлЗркЯрк┐рки ркХрлНрк░рлЛрк╕
тШж => тШж, ркСрк░рлНркерлЛркбрлЛркХрлНрк╕ ркХрлНрк░рлЛрк╕, ркХрлНрк░рлЛрк╕, ркзрк░рлНрко
тШк => тШк, ркЗрк╕рлНрк▓рк╛рко, ркЪрк╛ркВркж ркЕркирлЗ ркдрк╛рк░рлЛ, ркзрк░рлНрко, ркорлБрк╕рлНрк▓рк┐рко
тШо => тШо, рк╢рк╛ркВркдрк┐, рк╢рк╛ркВркдрк┐ркирлБркВ рккрлНрк░ркдрлАркХ
ЁЯХО => ЁЯХО, ркХрлЗркирлНркбрк▓рк╕рлНркЯрк┐ркХ, ркзрк░рлНрко, ркорлЗркирлЛрк░рк╛рк╣
ЁЯФп => ЁЯФп, ркЫ-рккрлЛркЗркВркЯрк╡рк╛рк│рлЛ, ркЫ-рккрлЛркЗркВркЯрк╡рк╛рк│рлЛ ркдрк╛рк░рлЛ, ркдрк╛рк░рлЛ, ркнрк╛ркЧрлНркп, ркнрк╛ркЧрлНркп ркХркерки
тЩИ => тЩИ, ркорлЗрк╖, рк░рк╛рк╢рк┐ркЪркХрлНрк░
тЩЙ => тЩЙ, рк░рк╛рк╢рк┐ркЪркХрлНрк░, рк╡рлГрк╖ркн
тЩК => тЩК, ркорк┐ркерлБрки, рк░рк╛рк╢рк┐ркЪркХрлНрк░
тЩЛ => тЩЛ, ркХрк░рлНркХ, рк░рк╛рк╢рк┐ркЪркХрлНрк░
тЩМ => тЩМ, рк░рк╛рк╢рк┐ркЪркХрлНрк░, рк╕рк┐ркВрк╣
тЩН => тЩН, ркХркирлНркпрк╛, рк░рк╛рк╢рк┐ркЪркХрлНрк░
тЩО => тЩО, ркдрлБрк▓рк╛, рк░рк╛рк╢рк┐ркЪркХрлНрк░
тЩП => тЩП, рк░рк╛рк╢рк┐ркЪркХрлНрк░, рк╡рлГрк╢рлНркЪрк┐ркХ, рк╕рлНркХрлЛрк░рлНрккрк┐ркЕрк╕
тЩР => тЩР, ркзркирлБ, рк░рк╛рк╢рк┐ркЪркХрлНрк░
тЩС => тЩС, ркоркХрк░, рк░рк╛рк╢рк┐ркЪркХрлНрк░
тЩТ => тЩТ, ркХрлБркВркн, рк░рк╛рк╢рк┐ркЪркХрлНрк░
тЩУ => тЩУ, ркорлАрки, рк░рк╛рк╢рк┐ркЪркХрлНрк░
тЫО => тЫО, ркдрлЗрк░ркорлА рк░рк╛рк╢рк┐ (ркСрклрк┐ркХрк╕), рк░рк╛рк╢рк┐ркЪркХрлНрк░
ЁЯФА => ЁЯФА, ркХрлНрк░рлЛрк╕ ркХрк░рлЗрк▓ ркЬркоркгрк╛ркВ ркдрлАрк░, ркХрлНрк░рлЛрк╕ ркХрк░рлЗрк▓рк╛ ркдрлАрк░, ркЯрлНрк░рлЗркХрлНрк╕ рк╢рклрк▓ ркХрк░рлЛ ркмркЯрки, ркдрлАрк░
ЁЯФБ => ЁЯФБ, ркдрлАрк░, ркжркХрлНрк╖рк┐ркгрк╛рк╡рк░рлНркдрлА, ркжркХрлНрк╖рк┐ркгрк╛рк╡рк░рлНркдрлА ркдрлАрк░, рккрлБркирк░рк╛рк╡рк░рлНркдрки ркХрк░рлЛ ркмркЯрки
ЁЯФВ => ЁЯФВ, ркПркХрк▓ рккрлБркирк░рк╛рк╡рк░рлНркдрки ркХрк░рлЛ ркмркЯрки, ркдрлАрк░, ркжркХрлНрк╖рк┐ркгрк╛рк╡рк░рлНркдрлА, ркжркХрлНрк╖рк┐ркгрк╛рк╡рк░рлНркдрлА ркдрлАрк░, ркиркВркмрк░ 1, ркиркВркмрк░ 1 рк╕рк╛ркерлЗркирк╛ ркжркХрлНрк╖рк┐ркгрк╛рк╡рк░рлНркдрлА ркдрлАрк░
тЦ╢ => тЦ╢, ркЪрк▓рк╛рк╡рлЛ, ркЪрк▓рк╛рк╡рлЛ ркмркЯрки, ркЬркоркгрлБркВ, ркдрлАрк░, ркдрлНрк░рк┐ркХрлЛркг
тПй => тПй, ркЬркоркгрлБркВ, ркбркмрк▓ ркЬркоркгрк╛ркВ ркдрлАрк░, ркдрлАрк░, рклрк╛рк╕рлНркЯ рклрлЛрк░рк╡рк░рлНркб ркХрк░рлЛ, рклрк╛рк╕рлНркЯ рклрлЛрк░рк╡рк░рлНркб ркХрк░рлЛ ркмркЯрки
тПн => тПн, ркЖркЧрк▓рлБркВ ркжрлГрк╢рлНркп, ркЖркЧрк▓рлЛ ркЯрлНрк░рлЗркХ, ркЖркЧрк▓рлЛ ркЯрлНрк░рлЗркХ ркмркЯрки, ркдрлНрк░рк┐ркХрлЛркг
тПп => тПп, ркЪрк▓рк╛рк╡рлЛ ркЕркерк╡рк╛ ркерлЛркнрк╛рк╡рлЛ ркмркЯрки, ркЬркоркгрлБркВ, ркдрлАрк░, ркдрлНрк░рк┐ркХрлЛркг
тЧА => тЧА, ркбрк╛ркмрлБркВ, ркдрлАрк░, ркдрлНрк░рк┐ркХрлЛркг, рккрк▓ркЯрк╛рк╡рлЛ, рк░рк┐рк╡рк░рлНрк╕ ркХрк░рлЛ ркмркЯрки
тПк => тПк, ркбркмрк▓ ркбрк╛ркмрк╛ ркдрлАрк░, ркбрк╛ркмрлБркВ, ркдрлАрк░, рклрк╛рк╕рлНркЯ рк░рк┐рк╡рк░рлНрк╕ ркХрк░рлЛ ркмркЯрки, рк░рк┐рк╡рк╛ркЗркирлНркб ркХрк░рлЛ
тПо => тПо, ркЫрлЗрк▓рлНрк▓рлЛ ркЯрлНрк░рлЗркХ ркмркЯрки, ркдрлАрк░, ркдрлНрк░рк┐ркХрлЛркг, рккрк╣рлЗрк▓рк╛ркирлЛ ркЯрлНрк░рлЗркХ, рккрк╛ркЫрк▓рлБркВ ркжрлГрк╢рлНркп
ЁЯФ╝ => ЁЯФ╝, ркЙрккрк░ ркдрлНрк░рк┐ркХрлЛркг, ркЙрккрк░ ркдрлНрк░рк┐ркХрлЛркг ркмркЯрки, ркЙрккрк░ ркмркЯрки, ркдрлНрк░рк┐ркХрлЛркг, ркмркЯрки
тПл => тПл, ркЙрккрк░, ркЙрккрк░ркирлБркВ ркдрлАрк░, ркбркмрк▓ ркЙрккрк▓рк╛ ркдрлАрк░, ркдрлАрк░, ркмрлЗ ркЙрккрк░ ркдрлАрк░ рк╕рк╛ркерлЗркирлБркВ ркмркЯрки
ЁЯФ╜ => ЁЯФ╜, ркдрлНрк░рк┐ркХрлЛркг, ркирлАркЪрлЗ ркдрлНрк░рк┐ркХрлЛркг, ркирлАркЪрлЗ ркдрлНрк░рк┐ркХрлЛркг ркмркЯрки, ркирлАркЪрлЗ ркмркЯрки, ркмркЯрки
тПм => тПм, ркбркмрк▓ ркирлАркЪрк▓рк╛ ркдрлАрк░, ркдрлАрк░, ркирлАркЪрлЗ, ркирлАркЪрлЗркирлБркВ ркдрлАрк░, ркмрлЗ ркирлАркЪрлЗ ркдрлАрк░ рк╕рк╛ркерлЗркирлБркВ ркмркЯрки
тП╕ => тП╕, ркКркнрлА, ркерлЛркнрк╛рк╡рлЛ, ркерлЛркнрк╛рк╡рлЛ ркмркЯрки, рккркЯрлНркЯрлА
тП╣ => тП╣, ркЪрлЛрк░рк╕, рк░рлЛркХрлЛ, рк░рлЛркХрлЛ ркмркЯрки
тП║ => тП║, ркЧрлЛрк│, рк░рлЗркХрлЛрк░рлНркб ркХрк░рлЛ, рк░рлЗркХрлЛрк░рлНркб ркХрк░рлЛ ркмркЯрки
тПП => тПП, ркХрк╛ркврлА ркирк╛ркВркЦрлЛ, ркХрк╛ркврлА ркирк╛ркВркЦрлЛ ркмркЯрки
ЁЯОж => ЁЯОж, ркорлВрк╡рлА, ркорлВрк╡рлА ркЪрк┐рк╣рлНрки, рк╕рк┐ркирлЗркорк╛
ЁЯФЕ => ЁЯФЕ, ркУркЫрлА, ркУркЫрлА ркЪркоркХ, ркУркЫрлА ркЪркоркХркирлБркВ ркЪрк┐рк╣рлНрки, ркУркЫрлА ркЪркоркХркирлБркВ ркмркЯрки, ркЪркоркХ, ркоркВркж
ЁЯФЖ => ЁЯФЖ, ркЪркоркХ, ркдрлЗркЬрк╕рлНрк╡рлА, рк╡ркзрлБ ркЪркоркХ, рк╡ркзрлБ ркЪркоркХркирлБркВ ркЪрк┐рк╣рлНрки, рк╡ркзрлБ ркЪркоркХркирлБркВ ркмркЯрки
ЁЯУ╢ => ЁЯУ╢, ркПркирлНркЯрлЗркирк╛, ркПркирлНркЯрлЗркирк╛ ркмрк╛рк░рлНрк╕, рклрлЛрки, ркорлЛркмрк╛ркЗрк▓, ркорлЛркмрк╛ркЗрк▓ рк╕рк┐ркЧрлНркирк▓рлНрк╕, рк╕рк┐ркЧрлНркирк▓, рк╕рк┐ркЧрлНркирк▓ркирлА рккрлНрк░ркмрк│ркдрк╛, рк╕рлНркдркВркнрк╡рк╛рк│рлЛ ркПркирлНркЯрлЗркирк╛
ЁЯУ│ => ЁЯУ│, ркХркВрккрки ркорлЛркб, рклрлЛрки, ркорлЛркб, ркорлЛркмрк╛ркЗрк▓, рк╡рк╛ркЗркмрлНрк░рлЗрк╢рки ркорлЛркб, рк╕рлЗрк▓ рклрлЛрки
ЁЯУ┤ => ЁЯУ┤, рклрлЛрки, рклрлЛрки ркмркВркз, ркмркВркз, ркорлЛркмрк╛ркЗрк▓, ркорлЛркмрк╛ркЗрк▓ рклрлЛрки ркмркВркз, рк╕рлЗрк▓ рклрлЛрки, рк╕рлЗрк▓ рклрлЛрки ркмркВркз
тЩА => тЩА, ркорк╣рк┐рк▓рк╛, рк╕рлНркдрлНрк░рлА, рк╕рлНркдрлНрк░рлА ркЪрк┐рк╣рлНрки
тЩВ => тЩВ, рккрлБрк░рлБрк╖, рккрлБрк░рлБрк╖ ркЪрк┐рк╣рлНрки
тЪХ => тЪХ, ркжрк╡рк╛, ркорлЗркбрк┐ркХрк▓ рк╕рк┐ркорлНркмрк▓, рк╕рлНркЯрк╛ркл
тЩ╗ => тЩ╗, ркЪрк┐рк╣рлНрки, ркиркХрлНркХрк░ рк╕рк╛рк░рлНрк╡ркдрлНрк░рк┐ркХ рк░рк┐рк╕рк╛ркпркХрлНрк▓рк┐ркВркЧркирлБркВ рккрлНрк░ркдрлАркХ, рк░рк┐рк╕рк╛ркпркХрлНрк▓рк┐ркВркЧ, рк░рк┐рк╕рк╛ркпркХрлНрк▓рк┐ркВркЧркирлБркВ рккрлНрк░ркдрлАркХ, рк╕рк╛рк░рлНрк╡ркдрлНрк░рк┐ркХ
тЪЬ => тЪЬ, рклрлНрк▓рлЗркЙрк░-ркжрлЗ-рк▓рк┐рк╕
ЁЯФ▒ => ЁЯФ▒, ркПркВркХрк░, ркдрлНрк░рк┐рк╢рлВрк│, ркдрлНрк░рк┐рк╢рлВрк│ркирлБркВ ркЪрк┐рк╣рлНрки, рк╕ркВркЬрлНркЮрк╛
ЁЯУЫ => ЁЯУЫ, ркирк╛рко, ркирк╛ркоркирлЛ ркмрлЗркЬ, ркмрлЗркЬ
ЁЯФ░ => ЁЯФ░, ркЬрк╛рккрк╛ркирлАркЭ, рккрлНрк░рк╛рк░ркВркнркХрк░рлНркдрк╛, рккрлНрк░рк╛рк░ркВркнркХрк░рлНркдрк╛ ркорк╛ркЯрлЗ ркЬрк╛рккрк╛ркирлА рккрлНрк░ркдрлАркХ, рк▓рлАрк▓рлБркВ ркЕркирлЗ рккрлАрк│рлБркВ, рк▓рлАрк▓рлБркВ ркЕркирлЗ рккрлАрк│рлБркВ рккрк╛ркВркжркбрлБ
тнХ => тнХ, o, ркЧрлЛрк│
тЬЕ => тЬЕ, ркЪрлЗркХ, ркЪрлЗркХ ркорк╛рк░рлНркХ, рк╕рклрлЗркж ркЪрлЗркХ ркорк╛рк░рлНркХркирлБркВ ркЪрк┐рк╣рлНрки, рк╣рлЗрк╡рлА ркЪрлЗркХ ркорк╛рк░рлНркХ
тШС => тШС, ркЪрлЗркХ, ркЪрлЗркХ рк╕рк╛ркерлЗ ркоркд рккркдрлНрк░ркирлБркВ ркЪрк┐рк╣рлНрки, рккрлЗркЯрк╛, ркмрлЛркХрлНрк╕, ркоркд
тЬФ => тЬФ, ркШрк╛ркЯрлБркВ ркЪрлЗркХ ркорк╛рк░рлНркХркирлБркВ ркЪрк┐рк╣рлНрки, ркЪрк┐рк╣рлНрки, ркЪрлЗркХ
тЬЦ => тЬЦ, ркЧрлБркгрк╛ркХрк╛рк░, ркШрк╛ркЯрлБркВ ркЧрлБркгрк╛ркХрк╛рк░ x ркирлБркВ ркЪрк┐рк╣рлНрки, рк░ркж ркХрк░рлЛ
тЭМ => тЭМ, тАЬXтАЭ, ркХрлНрк░рлЛрк╕ркирлБркВ ркЪрк┐рк╣рлНрки, ркЪрлЛркХркбрлАркирлБркВ ркЪрк┐рк╣рлНрки
тЭО => тЭО, ркХрлНрк░рлЛрк╕ркирлБркВ ркЪрк┐рк╣рлНрки, ркЪрлЛркХркбрлАркирлБркВ ркмркЯрки, ркЪрлЛрк░рк╕ркорк╛ркВ тАЬXтАЭ
тЮХ => тЮХ, ркШрк╛ркЯрлБркВ рк╡ркдрлНркдрк╛ркирлБркВ ркЪрк┐рк╣рлНрки, ркЪрк┐рк╣рлНрки, ркнрк╛рк░рлЗ рк╡ркдрлНркдрк╛ркирлБркВ ркЪрк┐рк╣рлНрки, рк╡ркдрлНркдрк╛, рк╡ркдрлНркдрк╛ркирлБркВ ркЪрк┐рк╣рлНрки
тЮЦ => тЮЦ, ркШрк╛ркЯрлБркВ ркмрк╛ркжркмрк╛ркХрлАркирлБркВ ркЪрк┐рк╣рлНрки, ркЪрк┐рк╣рлНрки, ркмрк╛ркжркмрк╛ркХрлА, ркмрк╛ркжркмрк╛ркХрлАркирлБркВ ркЪрк┐рк╣рлНрки, ркнрк╛рк░рлЗ ркмрк╛ркжркмрк╛ркХрлАркирлБркВ ркЪрк┐рк╣рлНрки
тЮЧ => тЮЧ, ркШрк╛ркЯрлБркВ ркнрк╛ркЧрк╛ркХрк╛рк░ркирлБркВ ркЪрк┐рк╣рлНрки, ркЪрк┐рк╣рлНрки, ркнрк╛ркЧрк╛ркХрк╛рк░, ркнрк╛ркЧрк╛ркХрк╛рк░ркирлБркВ ркЪрк┐рк╣рлНрки, ркнрк╛рк░рлЗ ркнрк╛ркЧрк╛ркХрк╛рк░ркирлБркВ ркЪрк┐рк╣рлНрки
тЮ░ => тЮ░, рк▓рлВркк, рк╡рк│рк╛ркВркХ, рк╡рк╛ркВркХркбрк┐ркпрлБ рк▓рлВркк
тЮ┐ => тЮ┐, ркЬрк╛рккрк╛рки, ркбркмрк▓ рк╡рк╛ркВркХркбрк┐ркпрлБркВ рк▓рлВркк, рклрлНрк░рлА ркбрк╛ркпрк▓, рк╡рк╛ркВркХркбрк┐ркпрлБ рк▓рлВркк
уА╜ => уА╜, ркЪрк┐рк╣рлНрки, ркЬрк╛рккрк╛ркирлА ркЪрк┐рк╣рлНрки, ркнрк╛ркЧ
тЬ│ => тЬ│, ркЖрка ркХрк┐ркирк╛рк░рлАрк╡рк╛рк│рлБркВ ркдрк╛рк░рк╛ркирлБркВ ркЪрк┐рк╣рлНрки, ркдрк╛рк░рлЛ
тЬ┤ => тЬ┤, ркЖрка ркХрк┐ркирк╛рк░рлАрк╡рк╛рк│рлЛ ркдрк╛рк░рлЛ, ркдрк╛рк░рлЛ
тЭЗ => тЭЗ, ркЪркоркХ, рк╕рлНрккрк╛рк░рлНркХрк▓
тА╝ => тА╝, ркЪрк┐рк╣рлНрки, ркмрлЗ ркЙркжрлНркЧрк╛рк░ ркЪрк┐рк╣рлНрки, рк╡рк┐рк░рк╛ркоркЪрк┐рк╣рлНрки
тБЙ => тБЙ, ркЙркжрлНркЧрк╛рк░ рккрлНрк░рк╢рлНркирк╛рк░рлНрке ркЪрк┐рк╣рлНрки, рккрлНрк░рк╢рлНрки, рк╡рк┐рк░рк╛ркоркЪрк┐рк╣рлНрки
тЭУ => тЭУ, рккрлНрк░рк╢рлНрки, рккрлНрк░рк╢рлНркирк╛рк░рлНрке ркЪрк┐рк╣рлНрки
тЭФ => тЭФ, рккрлНрк░рк╢рлНрки, рккрлНрк░рк╢рлНркирк╛рк░рлНрке ркЪрк┐рк╣рлНрки, рк╕рклрлЗркж рккрлНрк░рк╢рлНркирк╛рк░рлНрке ркЪрк┐рк╣рлНрки
тЭХ => тЭХ, ркЙркжрлНркЧрк╛рк░рк╡рк╛ркЪркХ, ркЙркжрлНркЧрк╛рк░рк╡рк╛ркЪркХ ркЪрк┐рк╣рлНрки, рк╕рклрлЗркж ркЙркжрлНркЧрк╛рк░ ркЪрк┐рк╣рлНрки
тЭЧ => тЭЧ, ркЙркжрлНркЧрк╛рк░ ркЪрк┐рк╣рлНрки, рк╡рк┐рк░рк╛ркоркЪрк┐рк╣рлНрки
уА░ => уА░, ркбрлЗрк╢, рк▓рк╣рлЗрк░рк╛ркдрлБркВ, рк▓рк╣рлЗрк░рк╛ркдрлЛ ркбрлЗрк╢, рк▓рк╛ркВркмрлБркВ ркзрлНрк╡ркирк┐ ркЪрк┐рк╣рлНрки
┬й => ┬й, ркХрлЙрккрк┐рк░рк╛ркЗркЯ, ркХрлЙрккрк┐рк░рк╛ркЗркЯркирлБркВ ркЪрк┐рк╣рлНрки
┬о => ┬о, ркирлЛркВркзрк╛ркпрлЗрк▓, ркирлЛркВркзрк╛ркпрлЗрк▓ркирлБркВ ркЪрк┐рк╣рлНрки
тДв => тДв, ркЪрк┐рк╣рлНрки, ркЯрлНрк░рлЗркб ркорк╛рк░рлНркХ, ркЯрлНрк░рлЗркб ркорк╛рк░рлНркХркирлБркВ ркЪрк┐рк╣рлНрки
ЁЯТп => ЁЯТп, 100, 100 рккрлЛркЗркирлНркЯрлНрк╕, рккрлВрк░рлНркг рк╕рлНркХрлЛрк░, рк╕рлЛ рккрлЛркЗркирлНркЯрлНрк╕, рк╕рлНркХрлЛрк░
ЁЯФа => ЁЯФа, ркЕрккрк░ркХрлЗрк╕, ркЕрккрк░ркХрлЗрк╕ ркЕркХрлНрк╖рк░рлЛ, ркЕрккрк░ркХрлЗрк╕ рк▓рлЗркЯрк┐рки, ркЕрккрк░ркХрлЗрк╕ рк▓рлЗркЯрк┐рки ркЗркирккрлБркЯ ркХрк░рлЛ, рк▓рлЗркЯрк┐рки
ЁЯФб => ЁЯФб, рк▓рлЗркЯрк┐рки, рк▓рлЛркЕрк░ркХрлЗрк╕, рк▓рлЛркЕрк░ркХрлЗрк╕ ркЕркХрлНрк╖рк░рлЛ, рк▓рлЛркЕрк░ркХрлЗрк╕ рк▓рлЗркЯрк┐рки, рк▓рлЛркЕрк░ркХрлЗрк╕ рк▓рлЗркЯрк┐рки ркЗркирккрлБркЯ ркХрк░рлЛ
ЁЯФв => ЁЯФв, ркиркВркмрк░рлНрк╕, ркиркВркмрк░рлНрк╕ ркЗркирккрлБркЯ ркХрк░рлЛ
ЁЯФг => ЁЯФг, рккрлНрк░ркдрлАркХрлЛ, рккрлНрк░ркдрлАркХрлЛ ркЗркирккрлБркЯ ркХрк░рлЛ
ЁЯФд => ЁЯФд, ABC, ркЕркВркЧрлНрк░рлЗркЬрлА, рк▓рлЗркЯрк┐рки, рк▓рлЗркЯрк┐рки ркорлВрк│рк╛ркХрлНрк╖рк░, рк▓рлЗркЯрк┐рки ркорлВрк│рк╛ркХрлНрк╖рк░ ркЗркирккрлБркЯ ркХрк░рлЛ
ЁЯЕ░ => ЁЯЕ░, A, рккрлНрк░ркХрк╛рк░ A, рк▓рлЛрк╣рлА, рк▓рлЛрк╣рлАркирлЛ рккрлНрк░ркХрк╛рк░, рк▓рлЛрк╣рлАркирлЛ рккрлНрк░ркХрк╛рк░ A
ЁЯЖО => ЁЯЖО, AB, рккрлНрк░ркХрк╛рк░ AB, рк▓рлЛрк╣рлА, рк▓рлЛрк╣рлАркирлЛ рккрлНрк░ркХрк╛рк░, рк▓рлЛрк╣рлАркирлЛ рккрлНрк░ркХрк╛рк░ AB
ЁЯЕ▒ => ЁЯЕ▒, B, рккрлНрк░ркХрк╛рк░ B, рк▓рлЛрк╣рлА, рк▓рлЛрк╣рлАркирлЛ рккрлНрк░ркХрк╛рк░, рк▓рлЛрк╣рлАркирлЛ рккрлНрк░ркХрк╛рк░ B
ЁЯЖС => ЁЯЖС, CL, CL ркирлБркВ ркЪрк┐рк╣рлНрки, рк╕рк╛ркл ркХрк░рлЛ
ЁЯЖТ => ЁЯЖТ, ркХрлВрк▓, ркХрлВрк▓ркирлБркВ ркЪрк┐рк╣рлНрки, ркаркВркбрк╛ркирлБркВ ркЪрк┐рк╣рлНрки
ЁЯЖУ => ЁЯЖУ, ркЪрк┐рк╣рлНрки, ркорклркд, ркорклркдркирлБркВ ркЪрк┐рк╣рлНрки, рк╢рлБрк▓рлНркХ рк░рк╣рк┐ркд
тД╣ => тД╣, ркЖркЗ, ркорк╛рк╣рк┐ркдрлА, ркорк╛рк╣рк┐ркдрлАркирлЛ рк╕рлНрк░рлЛркд
ЁЯЖФ => ЁЯЖФ, ID, ID ркирлБркВ ркЪрк┐рк╣рлНрки, ркУрк│ркЦ, ркУрк│ркЦркирлБркВ ркЪрк┐рк╣рлНрки, ркЪрк┐рк╣рлНрки
тУВ => тУВ, ркПрко, ркЧрлЛрк│, ркЧрлЛрк│ркорк╛ркВ ркЕркХрлНрк╖рк░ ркПрко
ЁЯЖХ => ЁЯЖХ, ркЪрк┐рк╣рлНрки, ркЪрлЛрк░рк╕ркорк╛ркВ ркирк╡рк╛ркирлБркВ ркЪрк┐рк╣рлНрки, ркирк╡рк╛ркирлБркВ ркЪрк┐рк╣рлНрки, ркирк╡рлБркВ
ЁЯЖЦ => ЁЯЖЦ, NG, NG ркЪрк┐рк╣рлНрки, ркЪрк┐рк╣рлНрки, ркЪрлЛрк░рк╕ркорк╛ркВ ркарлАркХ ркирк╣рлАркВркирлБркВ ркЪрк┐рк╣рлНрки
ЁЯЕ╛ => ЁЯЕ╛, O, рккрлНрк░ркХрк╛рк░ O, рк▓рлЛрк╣рлА, рк▓рлЛрк╣рлАркирлЛ рккрлНрк░ркХрк╛рк░, рк▓рлЛрк╣рлАркирлЛ рккрлНрк░ркХрк╛рк░ O
ЁЯЖЧ => ЁЯЖЧ, ркСркХрлЗ, ркСркХрлЗркирлБркВ ркЪрк┐рк╣рлНрки
ЁЯЕ┐ => ЁЯЕ┐, рккрк╛рк░рлНркХрк┐ркВркЧ, рккрк╛рк░рлНркХрк┐ркВркЧ рк╕рлНркерк│
ЁЯЖШ => ЁЯЖШ, SOS, SOS ркирлБркВ ркЪрк┐рк╣рлНрки, ркЪрк┐рк╣рлНрки, ркоркжркж, ркоркжркжркирлБркВ ркЪрк┐рк╣рлНрки
ЁЯЖЩ => ЁЯЖЩ, UP!, UP! ркЪрк┐рк╣рлНрки, ркЙрккрк░ркирлБркВ ркЪрк┐рк╣рлНрки, ркЪрк┐рк╣рлНрки
ЁЯЖЪ => ЁЯЖЪ, ркЪрк┐рк╣рлНрки, рк╡рк┐., рк╡рк┐. ркирлБркВ ркЪрк┐рк╣рлНрки, рк╡рк┐рк░рлБркжрлНркз
ЁЯИБ => ЁЯИБ, ркЪрлЛрк░рк╕ркорк╛ркВ ркЕрк╣рлАркВ ркорк╛ркЯрлЗркирлБркВ ркЬрк╛рккрк╛ркирлА ркЪрк┐рк╣рлНрки, ркЬрк╛рккрк╛ркирлА рк╢ркмрлНркж
ЁЯИВ => ЁЯИВ, ркЪрлЛрк░рк╕ркорк╛ркВ ркЕрк╣рлАркВ рк╣рлЗркдрлБ ркЬрк╛рккрк╛ркирлА ркЪрк┐рк╣рлНрки, ркЬрк╛рккрк╛ркирлА рк╢ркмрлНркж
ЁЯИ╖ => ЁЯИ╖, ркЪрлЛрк░рк╕ркорк╛ркВ ркЪркВркжрлНрк░ ркорк╛ркЯрлЗ ркЬрк╛рккрк╛ркирлА ркЪрк┐рк╣рлНрки, ркЬрк╛рккрк╛ркирлА рк╢ркмрлНркж
ЁЯИ╢ => ЁЯИ╢, ркЪрлЛрк░рк╕ркорк╛ркВ ркЕрк╕рлНркдрк┐ркдрлНрк╡ ркорк╛ркЯрлЗ ркЬрк╛рккрк╛ркирлА ркЪрк┐рк╣рлНрки, ркЬрк╛рккрк╛ркирлА рк╢ркмрлНркж
ЁЯИп => ЁЯИп, ркЪрлЛрк░рк╕ркорк╛ркВ ркЖркВркЧрк│рлА ркорк╛ркЯрлЗ ркЬрк╛рккрк╛ркирлА рк╢ркмрлНркж, ркЬрк╛рккрк╛ркирлА рк╢ркмрлНркж
ЁЯЙР => ЁЯЙР, ркЧрлЛрк│ркорк╛ркВ рк▓рк╛ркн ркорк╛ркЯрлЗ ркЬрк╛рккрк╛ркирлА рк╢ркмрлНркж, ркЬрк╛рккрк╛ркирлА рк╢ркмрлНркж
ЁЯИ╣ => ЁЯИ╣, ркЪрлЛрк░рк╕ркорк╛ркВ рк╡рк┐ркнрк╛ркЬрки ркорк╛ркЯрлЗ ркЬрк╛рккрк╛ркирлА рк╢ркмрлНркж, ркЬрк╛рккрк╛ркирлА рк╢ркмрлНркж
ЁЯИЪ => ЁЯИЪ, ркЪрлЛрк░рк╕ркорк╛ркВ ркирк┐рк╖рлЗркз ркорк╛ркЯрлЗ ркЬрк╛рккрк╛ркирлА рк╢ркмрлНркж, ркЬрк╛рккрк╛ркирлА рк╢ркмрлНркж
ЁЯИ▓ => ЁЯИ▓, ркЪрлЛрк░рк╕ркорк╛ркВ ркирк┐рк╖рк┐ркжрлНркз ркорк╛ркЯрлЗ ркЬрк╛рккрк╛ркирлА рк╢ркмрлНркж, ркЬрк╛рккрк╛ркирлА рк╢ркмрлНркж
ЁЯЙС => ЁЯЙС, ркЧрлЛрк│ркорк╛ркВ рк╕рлНрк╡рлАркХрлГркдрк┐ ркорк╛ркЯрлЗ ркЪрлАркирлА рк╢ркмрлНркж, ркЪрлАркирлА рк╢ркмрлНркж
ЁЯИ╕ => ЁЯИ╕, ркЪрлАркирлА рк╢ркмрлНркж, ркЪрлЛрк░рк╕ркорк╛ркВ рк▓рк╛ркЧрлБ ркХрк░рлЛ ркорк╛ркЯрлЗ ркЪрлАркирлА рк╢ркмрлНркж
ЁЯИ┤ => ЁЯИ┤, ркЪрлАркирлА рк╢ркмрлНркж, ркЪрлЛрк░рк╕ркорк╛ркВ ркПркХрк╕рк╛ркерлЗ ркорк╛ркЯрлЗ ркЪрлАркирлА рк╢ркмрлНркж
ЁЯИ│ => ЁЯИ│, ркЪрлАркирлА рк╢ркмрлНркж, ркЪрлЛрк░рк╕ркорк╛ркВ ркЦрк╛рк▓рлА ркорк╛ркЯрлЗ ркЪрлАркирлА рк╢ркмрлНркж
уКЧ => уКЧ, ркЖркЗркбрк┐ркпрлЛркЧрлНрк░рк╛ркл, ркЧрлЛрк│ркорк╛ркВ ркЕркнрк┐ркиркВркжрки ркЖрккркдрлЛ ркЖркЗркбрк┐ркпрлЛркЧрлНрк░рк╛ркл, ркЪрлАркирлАтАШ ркЕркнрк┐ркиркВркжрки
уКЩ => уКЩ, ркЖркЗркбрк┐ркпрлЛркЧрлНрк░рк╛ркл, ркЧрлБрккрлНркд, ркЧрлЛрк│ркорк╛ркВ ркЧрлБрккрлНркд ркЖркЗркбрк┐ркпрлЛркЧрлНрк░рк╛ркл, ркЪрлАркирлА
ЁЯИ║ => ЁЯИ║, ркЧрлЛрк│ркорк╛ркВ рк╕ркВркЪрк╛рк▓рки ркорк╛ркЯрлЗ ркЪрлАркирлА рк╢ркмрлНркж, ркЪрлАркирлА рк╢ркмрлНркж
ЁЯИ╡ => ЁЯИ╡, ркЧрлЛрк│ркорк╛ркВ рк╕ркВрккрлВрк░рлНркгркдрк╛ ркорк╛ркЯрлЗ ркЪрлАркирлА рк╢ркмрлНркж, ркЪрлАркирлА рк╢ркмрлНркж
тЦк => тЦк, ркХрк╛рк│рлЛ ркирк╛ркирлЛ ркЪрлЛрк░рк╕, ркЪрлЛрк░рк╕, ркнрлМркорк┐ркдрк┐ркХ
тЦл => тЦл, ркЪрлЛрк░рк╕, ркнрлМркорк┐ркдрк┐ркХ, рк╕рклрлЗркж ркирк╛ркирлЛ ркЪрлЛрк░рк╕
тЧ╗ => тЧ╗, ркЪрлЛрк░рк╕, ркнрлМркорк┐ркдрк┐ркХ, рк╕рклрлЗркж ркоркзрлНркпрко ркЪрлЛрк░рк╕
тЧ╝ => тЧ╝, ркХрк╛рк│рлЛ ркоркзрлНркпрко ркЪрлЛрк░рк╕, ркЪрлЛрк░рк╕, ркнрлМркорк┐ркдрк┐ркХ
тЧ╜ => тЧ╜, ркЪрлЛрк░рк╕, ркнрлМркорк┐ркдрк┐ркХ, рк╕рклрлЗркж ркоркзрлНркпрко-ркирк╛ркирлЛ ркЪрлЛрк░рк╕
тЧ╛ => тЧ╛, ркХрк╛рк│рлЛ ркоркзрлНркпрко-ркирк╛ркирлЛ ркЪрлЛрк░рк╕, ркЪрлЛрк░рк╕, ркнрлМркорк┐ркдрк┐ркХ
тмЫ => тмЫ, ркХрк╛рк│рлЛ ркорлЛркЯрлЛ ркЪрлЛрк░рк╕, ркЪрлЛрк░рк╕, ркнрлМркорк┐ркдрк┐ркХ
тмЬ => тмЬ, ркЪрлЛрк░рк╕, ркнрлМркорк┐ркдрк┐ркХ, рк╕рклрлЗркж ркорлЛркЯрлЛ ркЪрлЛрк░рк╕
ЁЯФ╢ => ЁЯФ╢, ркирк╛рк░ркВркЧрлА, ркорлЛркЯрлЛ ркирк╛рк░ркВркЧрлА рк╣рлАрк░рлЛ, ркорлЛркЯрлЛ рк╣рлАрк░рлЛ, рк╣рлАрк░рлЛ
ЁЯФ╖ => ЁЯФ╖, ркорлЛркЯрлЛ рк╡рк╛ркжрк│рлА рк╣рлАрк░рлЛ, ркорлЛркЯрлЛ рк╣рлАрк░рлЛ, рк╡рк╛ркжрк│рлА, рк╣рлАрк░рлЛ
ЁЯФ╕ => ЁЯФ╕, ркирк╛ркирлЛ ркирк╛рк░ркВркЧрлА рк╣рлАрк░рлЛ, ркирк╛ркирлЛ рк╣рлАрк░рлЛ, ркирк╛рк░ркВркЧрлА, рк╣рлАрк░рлЛ
ЁЯФ╣ => ЁЯФ╣, ркирк╛ркирлЛ рк╡рк╛ркжрк│рлА рк╣рлАрк░рлЛ, ркирк╛ркирлЛ рк╣рлАрк░рлЛ, рк╡рк╛ркжрк│рлА, рк╣рлАрк░рлЛ
ЁЯФ║ => ЁЯФ║, ркЙрккрк░ ркдрлНрк░рк┐ркХрлЛркг, ркЙрккрк░ рк▓рк╛рк▓ ркдрлНрк░рк┐ркХрлЛркг, ркдрлНрк░рк┐ркХрлЛркг
ЁЯФ╗ => ЁЯФ╗, ркдрлНрк░рк┐ркХрлЛркг, ркирлАркЪрлЗ ркдрлНрк░рк┐ркХрлЛркг, ркирлАркЪрлЛ рк▓рк╛рк▓ ркдрлНрк░рк┐ркХрлЛркг
ЁЯТа => ЁЯТа, ркбрк╛ркпркоркВркб, ркбрк╛ркпркоркВркб ркЖркХрк╛рк░, рккрлБрк╖рлНркк, рккрлБрк╖рлНрккркирлА рккрк╛ркВркЦркбрлА, рк▓рк╛ркЧркгрлА, рк╕рлБркВркжрк░
ЁЯФШ => ЁЯФШ, ркмркЯрки, рк░рлЗркбрк┐ркУ, рк░рлЗркбрк┐ркУ ркмркЯрки
ЁЯФ▓ => ЁЯФ▓, ркХрк╛рк│рлЛ ркЪрлЛрк░рк╕ ркмркЯрки, ркЪрлЛрк░рк╕, ркЪрлЛрк░рк╕ ркмркЯрки, ркмркЯрки
ЁЯФ│ => ЁЯФ│, ркЪрлЛрк░рк╕, ркЪрлЛрк░рк╕ ркмркЯрки, ркмркЯрки, рк╕рклрлЗркж ркЪрлЛрк░рк╕ ркмркЯрки
тЪк => тЪк, ркЧрлЛрк│, ркнрлМркорк┐ркдрк┐ркХ, рк╕рклрлЗркж ркЧрлЛрк│
тЪл => тЪл, ркХрк╛рк│рлБркВ ркЧрлЛрк│, ркЧрлЛрк│, ркнрлМркорк┐ркдрк┐ркХ
ЁЯФ┤ => ЁЯФ┤, ркорлЛркЯрлБркВ рк▓рк╛рк▓ рк╡рк░рлНркдрлБрк│, ркорлЛркЯрлБркВ рк╡рк░рлНркдрлБрк│, рк▓рк╛рк▓, рк▓рк╛рк▓ ркЧрлЛрк│, рк╡рк░рлНркдрлБрк│
ЁЯФ╡ => ЁЯФ╡, ркорлЛркЯрлБркВ рк╡рк░рлНркдрлБрк│, ркорлЛркЯрлБркВ рк╡рк╛ркжрк│рлА рк╡рк░рлНркдрлБрк│, рк╡рк░рлНркдрлБрк│, рк╡рк╛ркжрк│рлА, рк╡рк╛ркжрк│рлА ркЧрлЛрк│
ЁЯПБ => ЁЯПБ, ркЦрлЗрк▓ ркХрлВркж, ркЪрлЛркХркбрлАрк╡рк╛рк│рлЛ, ркЪрлЛркХркбрлАрк╡рк╛рк│рлЛ ркзрлНрк╡ркЬ, ркзрлНрк╡ркЬ, рк╣рк░рлАрклрк╛ркИ
ЁЯЪй => ЁЯЪй, ркдрлНрк░рк┐ркХрлЛркг ркзрлНрк╡ркЬ, ркдрлНрк░рк┐ркХрлЛркг рк╕рлНркерк╛рки ркзрлНрк╡ркЬ, ркдрлНрк░рк┐ркХрлЛркгрк╛ркХрк╛рк░ ркзрлНрк╡ркЬ, ркзрлНрк╡ркЬ, рк╕рлНркерк╛рки, рк╕рлНркерк╛рки ркзрлНрк╡ркЬ, рк╕рлНркерк╛рки ркорк╛рк╣рк┐ркдрлАркирлЛ ркзрлНрк╡ркЬ
ЁЯОМ => ЁЯОМ, ркЙркЬрк╡ркгрлА, ркЪрлЛркХркбрлАрк╡рк╛рк│рк╛ ркзрлНрк╡ркЬ, ркЪрлЛркХркбрлАрк╡рк╛рк│рлЛ, ркЪрлЛркХркбрлАрк╡рк╛рк│рлЛ ркзрлНрк╡ркЬ, ркЬрк╛рккрк╛ркиркирлЛ ркЪрлЛркХркбрлАрк╡рк╛рк│рлЛ ркзрлНрк╡ркЬ, ркзрлНрк╡ркЬ
ЁЯП┤ => ЁЯП┤, рк▓рк╣рлЗрк░ркдрлЛ ркХрк╛рк│рлЛ ркЭркВркбрлЛ, рк▓рк╣рлЗрк░рк╡рлБркВ
ЁЯП│ => ЁЯП│, рк▓рк╣рлЗрк░ркдрлЛ рк╕рклрлЗркж ркЭркВркбрлЛ, рк▓рк╣рлЗрк░рк╡рлБркВ
ЁЯП│тАНЁЯМИ => ЁЯП│тАНЁЯМИ, ркЭркВркбрлЛ, рк╕рккрлНркдрк░ркВркЧрлА, рк╕рккрлНркдрк░ркВркЧрлА ркЭркВркбрлЛ
ЁЯЗжЁЯЗи => ЁЯЗжЁЯЗи, ркПрк╕рлЗркирлНрк╢рки ркЖркЗрк▓рлЗркирлНркб
ЁЯЗжЁЯЗй => ЁЯЗжЁЯЗй, ркНркВркбрлЛрк░рк╛
ЁЯЗжЁЯЗк => ЁЯЗжЁЯЗк, ркпрлБркирк╛ркЗркЯрлЗркб ркЖрк░ркм ркЕркорлАрк░рк╛ркд
ЁЯЗжЁЯЗл => ЁЯЗжЁЯЗл, ркЕрклркШрк╛ркирк┐рк╕рлНркдрк╛рки
ЁЯЗжЁЯЗм => ЁЯЗжЁЯЗм, ркНркирлНркЯрк┐ркЧрлБркЖ ркЕркирлЗ ркмрк░рлНркорлБркбрк╛
ЁЯЗжЁЯЗо => ЁЯЗжЁЯЗо, ркНркВркЧрлНрк╡рк┐рк▓рк╛
ЁЯЗжЁЯЗ▒ => ЁЯЗжЁЯЗ▒, ркЕрк▓рлНркмрлЗркирк┐ркпрк╛
ЁЯЗжЁЯЗ▓ => ЁЯЗжЁЯЗ▓, ркЖрк░рлНркорлЗркирк┐ркпрк╛
ЁЯЗжЁЯЗ┤ => ЁЯЗжЁЯЗ┤, ркЕркВркЧрлЛрк▓рк╛
ЁЯЗжЁЯЗ╢ => ЁЯЗжЁЯЗ╢, ркПркирлНркЯрк╛рк░рлНркХркЯрк┐ркХрк╛
ЁЯЗжЁЯЗ╖ => ЁЯЗжЁЯЗ╖, ркЖрк░рлНркЬрлЗркирлНркЯрлАркирк╛
ЁЯЗжЁЯЗ╕ => ЁЯЗжЁЯЗ╕, ркЕркорлЗрк░рк┐ркХрки рк╕ркорлЛркЖ
ЁЯЗжЁЯЗ╣ => ЁЯЗжЁЯЗ╣, ркСрк╕рлНркЯрлНрк░рк┐ркпрк╛
ЁЯЗжЁЯЗ║ => ЁЯЗжЁЯЗ║, ркСрк╕рлНркЯрлНрк░рлЗрк▓рк┐ркпрк╛
ЁЯЗжЁЯЗ╝ => ЁЯЗжЁЯЗ╝, ркЕрк░рлБркмрк╛
ЁЯЗжЁЯЗ╜ => ЁЯЗжЁЯЗ╜, ркСрк▓рлЗркирлНркб ркЖркЗрк▓рлЗркирлНркбрлНрк╕
ЁЯЗжЁЯЗ┐ => ЁЯЗжЁЯЗ┐, ркЕркЭрк░ркмрлИркЬрк╛рки
ЁЯЗзЁЯЗж => ЁЯЗзЁЯЗж, ркмрлЛрк╕рлНркирк┐ркпрк╛ ркЕркирлЗ рк╣рк░рлНркЭрлЗркЧрлЛрк╡рк┐ркирк╛
ЁЯЗзЁЯЗз => ЁЯЗзЁЯЗз, ркмрк╛рк░ркмрк╛ркбрлЛрк╕
ЁЯЗзЁЯЗй => ЁЯЗзЁЯЗй, ркмрк╛ркВркЧрлНрк▓рк╛ркжрлЗрк╢
ЁЯЗзЁЯЗк => ЁЯЗзЁЯЗк, ркмрлЗрк▓рлНркЬрлАркпрко
ЁЯЗзЁЯЗл => ЁЯЗзЁЯЗл, ркмрлБрк░рлНркХрк┐ркирк╛ рклрк╛рк╕рлЛ
ЁЯЗзЁЯЗм => ЁЯЗзЁЯЗм, ркмрк▓рлНркЧрлЗрк░рк┐ркпрк╛
ЁЯЗзЁЯЗн => ЁЯЗзЁЯЗн, ркмрлЗрк╣рк░рлАрки
ЁЯЗзЁЯЗо => ЁЯЗзЁЯЗо, ркмрлБрк░рлБркВркбрлА
ЁЯЗзЁЯЗп => ЁЯЗзЁЯЗп, ркмрлЗркирк┐рки
ЁЯЗзЁЯЗ▒ => ЁЯЗзЁЯЗ▒, рк╕рлЗркВркЯ ркмрк╛рк░рлНркерлЗрк▓рлЗркорлА
ЁЯЗзЁЯЗ▓ => ЁЯЗзЁЯЗ▓, ркмрк░рлНркорлБркбрк╛
ЁЯЗзЁЯЗ│ => ЁЯЗзЁЯЗ│, ркмрлНрк░рлБркирлЗркЗ
ЁЯЗзЁЯЗ┤ => ЁЯЗзЁЯЗ┤, ркмрлЛрк▓рк┐рк╡рк┐ркпрк╛
ЁЯЗзЁЯЗ╢ => ЁЯЗзЁЯЗ╢, ркХрлЗрк░рлЗркмрк┐ркпрки ркирлЗркзрк░рк▓рлЗркирлНркбрлНркЭ
ЁЯЗзЁЯЗ╖ => ЁЯЗзЁЯЗ╖, ркмрлНрк░рк╛ркЭрк┐рк▓
ЁЯЗзЁЯЗ╕ => ЁЯЗзЁЯЗ╕, ркмрк╣рк╛ркорк╛рк╕
ЁЯЗзЁЯЗ╣ => ЁЯЗзЁЯЗ╣, ркнрлВркЯрк╛рки
ЁЯЗзЁЯЗ╗ => ЁЯЗзЁЯЗ╗, ркмрлМрк╡рлЗркд ркЖркЗрк▓рлЗркирлНркб
ЁЯЗзЁЯЗ╝ => ЁЯЗзЁЯЗ╝, ркмрлЛркдрлНрк╕рлНрк╡рк╛ркирк╛
ЁЯЗзЁЯЗ╛ => ЁЯЗзЁЯЗ╛, ркмрлЗрк▓рк╛рк░рлБрк╕
ЁЯЗзЁЯЗ┐ => ЁЯЗзЁЯЗ┐, ркмрлЗрк▓рлАркЭ
ЁЯЗиЁЯЗж => ЁЯЗиЁЯЗж, ркХрлЗркирлЗркбрк╛
ЁЯЗиЁЯЗи => ЁЯЗиЁЯЗи, ркХрлЛркХрлЛркЭ (ркХрлАрк▓рлАркВркЧ) ркЖркЗрк▓рлЗркирлНркбрлНрк╕
ЁЯЗиЁЯЗй => ЁЯЗиЁЯЗй, ркХрлЛркВркЧрлЛ - ркХрк┐ркВрк╢рк╛рк╕рк╛
ЁЯЗиЁЯЗл => ЁЯЗиЁЯЗл, рк╕рлЗркирлНркЯрлНрк░рк▓ ркЖрклрлНрк░рк┐ркХрки рк░рк┐рккркмрлНрк▓рк┐ркХ
ЁЯЗиЁЯЗм => ЁЯЗиЁЯЗм, ркХрлЛркВркЧрлЛ - ркмрлНрк░рк╛ркЭрк╛рк╡рк┐рк▓рлЗ
ЁЯЗиЁЯЗн => ЁЯЗиЁЯЗн, рк╕рлНрк╡рк┐ркЯрлНркЭрк░рлНрк▓рлЕркирлНркб
ЁЯЗиЁЯЗо => ЁЯЗиЁЯЗо, ркХрлЛркЯ ркбрлАркЖркЗрк╡рк░рлА
ЁЯЗиЁЯЗ░ => ЁЯЗиЁЯЗ░, ркХрлБркХ ркЖркЗрк▓рлЗркирлНркбрлНрк╕
ЁЯЗиЁЯЗ▒ => ЁЯЗиЁЯЗ▒, ркЪрк┐рк▓рлА
ЁЯЗиЁЯЗ▓ => ЁЯЗиЁЯЗ▓, ркХрлЕркорк░рлВрки
ЁЯЗиЁЯЗ│ => ЁЯЗиЁЯЗ│, ркЪрлАрки
ЁЯЗиЁЯЗ┤ => ЁЯЗиЁЯЗ┤, ркХрлЛрк▓ркорлНркмрк┐ркпрк╛
ЁЯЗиЁЯЗ╡ => ЁЯЗиЁЯЗ╡, ркХрлНрк▓рк┐рккрк░ркЯрки ркЖркЗрк▓рлЗркирлНркб
ЁЯЗиЁЯЗ╖ => ЁЯЗиЁЯЗ╖, ркХрлЛрк╕рлНркЯрк╛ рк░рк┐ркХрк╛
ЁЯЗиЁЯЗ║ => ЁЯЗиЁЯЗ║, ркХрлНркпрлБркмрк╛
ЁЯЗиЁЯЗ╗ => ЁЯЗиЁЯЗ╗, ркХрлЕркк рк╡рк░рлНркбрлЗ
ЁЯЗиЁЯЗ╝ => ЁЯЗиЁЯЗ╝, ркХрлНркпрлБрк░рк╛рк╕рк╛ркУ
ЁЯЗиЁЯЗ╜ => ЁЯЗиЁЯЗ╜, ркХрлНрк░рк┐рк╕ркорк╕ ркЖркЗрк▓рлЗркирлНркб
ЁЯЗиЁЯЗ╛ => ЁЯЗиЁЯЗ╛, рк╕рк╛ркпрккрлНрк░рк╕
ЁЯЗиЁЯЗ┐ => ЁЯЗиЁЯЗ┐, ркЪрлЗркХрлАркпрк╛
ЁЯЗйЁЯЗк => ЁЯЗйЁЯЗк, ркЬрк░рлНркоркирлА
ЁЯЗйЁЯЗм => ЁЯЗйЁЯЗм, ркбрк┐ркПркЧрлЛ ркЧрк╛рк░рк╕рк┐ркЖ
ЁЯЗйЁЯЗп => ЁЯЗйЁЯЗп, ркЬрлАркмрлМркЯрлА
ЁЯЗйЁЯЗ░ => ЁЯЗйЁЯЗ░, ркбрлЗркиркорк╛рк░рлНркХ
ЁЯЗйЁЯЗ▓ => ЁЯЗйЁЯЗ▓, ркбрлЛркорк┐ркирк┐ркХрк╛
ЁЯЗйЁЯЗ┤ => ЁЯЗйЁЯЗ┤, ркбрлЛркорк┐ркирк┐ркХрки рк░рк┐рккркмрлНрк▓рк┐ркХ
ЁЯЗйЁЯЗ┐ => ЁЯЗйЁЯЗ┐, ркЕрк▓рлНркЬрлАрк░рк┐ркпрк╛
ЁЯЗкЁЯЗж => ЁЯЗкЁЯЗж, рк╕рлНркпрлБркЯрк╛ ркЕркирлЗ ркорлЗрк▓рк┐рк▓рк╛
ЁЯЗкЁЯЗи => ЁЯЗкЁЯЗи, ркПркХрлНрк╡рк╛ркбрлЛрк░
ЁЯЗкЁЯЗк => ЁЯЗкЁЯЗк, ркПрк╕рлНркЯрлЛркирк┐ркпрк╛
ЁЯЗкЁЯЗм => ЁЯЗкЁЯЗм, ркЗркЬрк┐рккрлНркд
ЁЯЗкЁЯЗн => ЁЯЗкЁЯЗн, рккрк╢рлНркЪрк┐ркорлА рк╕рк╣рк╛рк░рк╛
ЁЯЗкЁЯЗ╖ => ЁЯЗкЁЯЗ╖, ркПрк░рк┐ркЯрлНрк░рк┐ркпрк╛
ЁЯЗкЁЯЗ╕ => ЁЯЗкЁЯЗ╕, рк╕рлНрккрлЗрки
ЁЯЗкЁЯЗ╣ => ЁЯЗкЁЯЗ╣, ркЗркерк┐ркУрккрк┐ркпрк╛
ЁЯЗкЁЯЗ║ => ЁЯЗкЁЯЗ║, ркпрлБрк░рлЛрккрк┐ркпрки рк╕ркВркШ
ЁЯЗкЁЯЗ┐ => ЁЯЗкЁЯЗ┐, ркпрлБрк░рлЛркЭрлЛрки
ЁЯЗлЁЯЗо => ЁЯЗлЁЯЗо, рклрк┐ркирк▓рлЗркирлНркб
ЁЯЗлЁЯЗп => ЁЯЗлЁЯЗп, рклрлАркЬрлА
ЁЯЗлЁЯЗ░ => ЁЯЗлЁЯЗ░, рклрлЙркХрк▓рлЗркирлНркб ркЖркЗрк▓рлЗркирлНркбрлНрк╕
ЁЯЗлЁЯЗ▓ => ЁЯЗлЁЯЗ▓, ркорк╛ркЗркХрлНрк░рлЛркирлЗрк╢рк┐ркпрк╛
ЁЯЗлЁЯЗ┤ => ЁЯЗлЁЯЗ┤, рклрлЗрк░рлЛ ркЖркЗрк▓рлЗркирлНркбрлНрк╕
ЁЯЗлЁЯЗ╖ => ЁЯЗлЁЯЗ╖, рклрлНрк░рк╛ркВрк╕
ЁЯЗмЁЯЗж => ЁЯЗмЁЯЗж, ркЧрлЗркмрки
ЁЯЗмЁЯЗз => ЁЯЗмЁЯЗз, ркпрлБркирк╛ркЗркЯрлЗркб ркХрк┐ркВркЧркбрко
ЁЯЗмЁЯЗй => ЁЯЗмЁЯЗй, ркЧрлНрк░рлЗркирлЗркбрк╛
ЁЯЗмЁЯЗк => ЁЯЗмЁЯЗк, ркЬрлНркпрлЛрк░рлНркЬрк┐ркпрк╛
ЁЯЗмЁЯЗл => ЁЯЗмЁЯЗл, рклрлНрк░рлЗркВркЪ ркЧркпрк╛ркирк╛
ЁЯЗмЁЯЗм => ЁЯЗмЁЯЗм, ркЧрлНрк╡рлЗрк░рлНркирк╕рлЗ
ЁЯЗмЁЯЗн => ЁЯЗмЁЯЗн, ркШрк╛ркирк╛
ЁЯЗмЁЯЗо => ЁЯЗмЁЯЗо, ркЬрлАркмрлНрк░рк╛рк▓рлНркЯрк░
ЁЯЗмЁЯЗ▒ => ЁЯЗмЁЯЗ▒, ркЧрлНрк░рлАркирк▓рлЗркирлНркб
ЁЯЗмЁЯЗ▓ => ЁЯЗмЁЯЗ▓, ркЧрлЗркорлНркмрк┐ркпрк╛
ЁЯЗмЁЯЗ│ => ЁЯЗмЁЯЗ│, ркЧрк┐ркирлА
ЁЯЗмЁЯЗ╡ => ЁЯЗмЁЯЗ╡, ркЧрлНрк╡рк╛ркбрлЗрк▓рлЛркк
ЁЯЗмЁЯЗ╢ => ЁЯЗмЁЯЗ╢, ркЗркХрлНрк╡рлЗркЯрлЛрк░рк┐ркпрк▓ ркЧрк┐ркирлА
ЁЯЗмЁЯЗ╖ => ЁЯЗмЁЯЗ╖, ркЧрлНрк░рлАрк╕
ЁЯЗмЁЯЗ╕ => ЁЯЗмЁЯЗ╕, ркжркХрлНрк╖рк┐ркг ркЬрлНркпрлЛрк░рлНркЬрк┐ркпрк╛ ркЕркирлЗ ркжркХрлНрк╖рк┐ркг рк╕рлЗркирлНркбрк╡рк┐ркЪ ркЖркЗрк▓рлЗркирлНркбрлНрк╕
ЁЯЗмЁЯЗ╣ => ЁЯЗмЁЯЗ╣, ркЧрлНрк╡рк╛ркЯрлЗркорк╛рк▓рк╛
ЁЯЗмЁЯЗ║ => ЁЯЗмЁЯЗ║, ркЧрлНрк╡рк╛рко
ЁЯЗмЁЯЗ╝ => ЁЯЗмЁЯЗ╝, ркЧрк┐ркирлА-ркмрк┐рк╕рк╛ркЙ
ЁЯЗмЁЯЗ╛ => ЁЯЗмЁЯЗ╛, ркЧркпрк╛ркирк╛
ЁЯЗнЁЯЗ░ => ЁЯЗнЁЯЗ░, рк╣рлЛркВркЧркХрлЛркВркЧ sar ркЪрлАрки
ЁЯЗнЁЯЗ▓ => ЁЯЗнЁЯЗ▓, рк╣рк░рлНркб ркЕркирлЗ ркорлЗркХркбрлЛркирк╛рк▓рлНркб ркЖркЗрк▓рлЗркирлНркбрлНрк╕
ЁЯЗнЁЯЗ│ => ЁЯЗнЁЯЗ│, рк╣рлЛркирлНркбрлБрк░рк╕
ЁЯЗнЁЯЗ╖ => ЁЯЗнЁЯЗ╖, ркХрлНрк░рлЛркПрк╢рк┐ркпрк╛
ЁЯЗнЁЯЗ╣ => ЁЯЗнЁЯЗ╣, рк╣рлИркдрк┐
ЁЯЗнЁЯЗ║ => ЁЯЗнЁЯЗ║, рк╣ркВркЧрлЗрк░рлА
ЁЯЗоЁЯЗи => ЁЯЗоЁЯЗи, ркХрлЕркирлЗрк░рлА ркЖркЗрк▓рлЗркирлНркбрлНрк╕
ЁЯЗоЁЯЗй => ЁЯЗоЁЯЗй, ркЗркирлНркбрлЛркирлЗрк╢рк┐ркпрк╛
ЁЯЗоЁЯЗк => ЁЯЗоЁЯЗк, ркЖркпрк░рлНрк▓рлЗркирлНркб
ЁЯЗоЁЯЗ▒ => ЁЯЗоЁЯЗ▒, ркЗркЭрк░рк╛ркЗрк▓
ЁЯЗоЁЯЗ▓ => ЁЯЗоЁЯЗ▓, ркЖркЗрк▓ ркСркл ркорлЗрки
ЁЯЗоЁЯЗ│ => ЁЯЗоЁЯЗ│, ркнрк╛рк░ркд
ЁЯЗоЁЯЗ┤ => ЁЯЗоЁЯЗ┤, ркмрлНрк░рк┐ркЯрк┐рк╢ ркЗркирлНркбрк┐ркпрки ркУрк╢рки ркЯрлЗрк░рк┐ркЯрк░рлА
ЁЯЗоЁЯЗ╢ => ЁЯЗоЁЯЗ╢, ркЗрк░рк╛ркХ
ЁЯЗоЁЯЗ╖ => ЁЯЗоЁЯЗ╖, ркИрк░рк╛рки
ЁЯЗоЁЯЗ╕ => ЁЯЗоЁЯЗ╕, ркЖркЗрк╕рк▓рлЗркирлНркб
ЁЯЗоЁЯЗ╣ => ЁЯЗоЁЯЗ╣, ркЗркЯрк╛рк▓рлА
ЁЯЗпЁЯЗк => ЁЯЗпЁЯЗк, ркЬрк░рлНрк╕рлА
ЁЯЗпЁЯЗ▓ => ЁЯЗпЁЯЗ▓, ркЬркорлИркХрк╛
ЁЯЗпЁЯЗ┤ => ЁЯЗпЁЯЗ┤, ркЬрлЛрк░рлНркбрки
ЁЯЗпЁЯЗ╡ => ЁЯЗпЁЯЗ╡, ркЬрк╛рккрк╛рки
ЁЯЗ░ЁЯЗк => ЁЯЗ░ЁЯЗк, ркХрлЗркирлНркпрк╛
ЁЯЗ░ЁЯЗм => ЁЯЗ░ЁЯЗм, ркХрк┐рк░рлНркЧрк┐ркЭрлНрк╕рлНркдрк╛рки
ЁЯЗ░ЁЯЗн => ЁЯЗ░ЁЯЗн, ркХркВркмрлЛркбрк┐ркпрк╛
ЁЯЗ░ЁЯЗо => ЁЯЗ░ЁЯЗо, ркХрк┐рк░рк┐ркмрк╛ркЯрлА
ЁЯЗ░ЁЯЗ▓ => ЁЯЗ░ЁЯЗ▓, ркХрлЛркорлЛрк░рк╕
ЁЯЗ░ЁЯЗ│ => ЁЯЗ░ЁЯЗ│, рк╕рлЗркВркЯ ркХрк┐ркЯрлНрк╕ ркЕркирлЗ ркирлЗрк╡рк┐рк╕
ЁЯЗ░ЁЯЗ╡ => ЁЯЗ░ЁЯЗ╡, ркЙркдрлНркдрк░ ркХрлЛрк░рк┐ркпрк╛
ЁЯЗ░ЁЯЗ╖ => ЁЯЗ░ЁЯЗ╖, ркжркХрлНрк╖рк┐ркг ркХрлЛрк░рк┐ркпрк╛
ЁЯЗ░ЁЯЗ╝ => ЁЯЗ░ЁЯЗ╝, ркХрлБрк╡рлИркд
ЁЯЗ░ЁЯЗ╛ => ЁЯЗ░ЁЯЗ╛, ркХрлЗркорлЗрки ркЖркЗрк▓рлЗркирлНркбрлНрк╕
ЁЯЗ░ЁЯЗ┐ => ЁЯЗ░ЁЯЗ┐, ркХркЭрк╛ркХрк┐рк╕рлНркдрк╛рки
ЁЯЗ▒ЁЯЗж => ЁЯЗ▒ЁЯЗж, рк▓рк╛ркУрк╕
ЁЯЗ▒ЁЯЗз => ЁЯЗ▒ЁЯЗз, рк▓рлЗркмркирлЛрки
ЁЯЗ▒ЁЯЗи => ЁЯЗ▒ЁЯЗи, рк╕рлЗркВркЯ рк▓рлБрк╕рк┐ркпрк╛
ЁЯЗ▒ЁЯЗо => ЁЯЗ▒ЁЯЗо, рк▓рлИркЪркЯрлЗркВрк╕рлНркЯрлЗркЗрки
ЁЯЗ▒ЁЯЗ░ => ЁЯЗ▒ЁЯЗ░, рк╢рлНрк░рлАрк▓ркВркХрк╛
ЁЯЗ▒ЁЯЗ╖ => ЁЯЗ▒ЁЯЗ╖, рк▓рк╛ркЗркмрлЗрк░рк┐ркпрк╛
ЁЯЗ▒ЁЯЗ╕ => ЁЯЗ▒ЁЯЗ╕, рк▓рлЗрк╕рлЛркерлЛ
ЁЯЗ▒ЁЯЗ╣ => ЁЯЗ▒ЁЯЗ╣, рк▓рк┐ркерлБркЖркирк┐ркпрк╛
ЁЯЗ▒ЁЯЗ║ => ЁЯЗ▒ЁЯЗ║, рк▓ркХрлНркЭркоркмрк░рлНркЧ
ЁЯЗ▒ЁЯЗ╗ => ЁЯЗ▒ЁЯЗ╗, рк▓рк╛ркдрлНрк╡рк┐ркпрк╛
ЁЯЗ▒ЁЯЗ╛ => ЁЯЗ▒ЁЯЗ╛, рк▓рк┐ркмрк┐ркпрк╛
ЁЯЗ▓ЁЯЗж => ЁЯЗ▓ЁЯЗж, ркорлЛрк░рлЛркХрлНркХрлЛ
ЁЯЗ▓ЁЯЗи => ЁЯЗ▓ЁЯЗи, ркорлЛркирк╛ркХрлЛ
ЁЯЗ▓ЁЯЗй => ЁЯЗ▓ЁЯЗй, ркорлЛрк▓ркбрлЛрк╡рк╛
ЁЯЗ▓ЁЯЗк => ЁЯЗ▓ЁЯЗк, ркорлЙркирлНркЯрлЗркирлЗркЧрлНрк░рлЛ
ЁЯЗ▓ЁЯЗл => ЁЯЗ▓ЁЯЗл, рк╕рлЗркВркЯ ркорк╛рк░рлНркЯрк┐рки
ЁЯЗ▓ЁЯЗм => ЁЯЗ▓ЁЯЗм, ркорлЗркбрк╛ркЧрк╛рк╕рлНркХрк░
ЁЯЗ▓ЁЯЗн => ЁЯЗ▓ЁЯЗн, ркорк╛рк░рлНрк╢рк▓ ркЖркЗрк▓рлЗркирлНркбрлНрк╕
ЁЯЗ▓ЁЯЗ░ => ЁЯЗ▓ЁЯЗ░, ркорлЗрк╕рлЗркбрлЛркирк┐ркпрк╛
ЁЯЗ▓ЁЯЗ▒ => ЁЯЗ▓ЁЯЗ▒, ркорк╛рк▓рлА
ЁЯЗ▓ЁЯЗ▓ => ЁЯЗ▓ЁЯЗ▓, ркорлНркпрк╛ркВркорк╛рк░ (ркмрк░рлНркорк╛)
ЁЯЗ▓ЁЯЗ│ => ЁЯЗ▓ЁЯЗ│, ркоркВркЧрлЛрк▓рк┐ркпрк╛
ЁЯЗ▓ЁЯЗ┤ => ЁЯЗ▓ЁЯЗ┤, ркоркХрк╛ркЙ sar ркЪрлАрки
ЁЯЗ▓ЁЯЗ╡ => ЁЯЗ▓ЁЯЗ╡, ркЙркдрлНркдрк░рлА ркорк╛рк░рк┐ркпрк╛ркирк╛ ркЖркЗрк▓рлЗркирлНркбрлНрк╕
ЁЯЗ▓ЁЯЗ╢ => ЁЯЗ▓ЁЯЗ╢, ркорк╛рк░рлНркЯрлАркирлАркХ
ЁЯЗ▓ЁЯЗ╖ => ЁЯЗ▓ЁЯЗ╖, ркорлМрк░рк┐ркЯрк╛ркирк┐ркпрк╛
ЁЯЗ▓ЁЯЗ╕ => ЁЯЗ▓ЁЯЗ╕, ркорлЛркВркЯрк╕рлЗрк░рк╛ркд
ЁЯЗ▓ЁЯЗ╣ => ЁЯЗ▓ЁЯЗ╣, ркорк╛рк▓рлНркЯрк╛
ЁЯЗ▓ЁЯЗ║ => ЁЯЗ▓ЁЯЗ║, ркорлЛрк░рк┐рк╢рк┐ркпрк╕
ЁЯЗ▓ЁЯЗ╗ => ЁЯЗ▓ЁЯЗ╗, ркорк╛рк▓ркжрк┐рк╡рлНрк╕
ЁЯЗ▓ЁЯЗ╝ => ЁЯЗ▓ЁЯЗ╝, ркорк╛рк▓рк╛рк╡рлА
ЁЯЗ▓ЁЯЗ╜ => ЁЯЗ▓ЁЯЗ╜, ркорлЗркХрлНрк╕рк┐ркХрлЛ
ЁЯЗ▓ЁЯЗ╛ => ЁЯЗ▓ЁЯЗ╛, ркорк▓рлЗрк╢рк┐ркпрк╛
ЁЯЗ▓ЁЯЗ┐ => ЁЯЗ▓ЁЯЗ┐, ркорлЛркЭрк╛ркорлНркмрк┐ркХ
ЁЯЗ│ЁЯЗж => ЁЯЗ│ЁЯЗж, ркирк╛ркорк┐ркмрк┐ркпрк╛
ЁЯЗ│ЁЯЗи => ЁЯЗ│ЁЯЗи, ркирлНркпрлБ рк╕рлЗрк▓рлЗркбрлЛркирк┐ркпрк╛
ЁЯЗ│ЁЯЗк => ЁЯЗ│ЁЯЗк, ркирк╛ркЗркЬрк░
ЁЯЗ│ЁЯЗл => ЁЯЗ│ЁЯЗл, ркирлЛрк░рклрлЛркХ ркЖркЗрк▓рлЗркирлНркбрлНрк╕
ЁЯЗ│ЁЯЗм => ЁЯЗ│ЁЯЗм, ркирк╛ркЗркЬрлЗрк░рк┐ркпрк╛
ЁЯЗ│ЁЯЗо => ЁЯЗ│ЁЯЗо, ркирк┐ркХрк╛рк░рк╛ркЧрлБркЖ
ЁЯЗ│ЁЯЗ▒ => ЁЯЗ│ЁЯЗ▒, ркирлЗркзрк░рк▓рлЗркирлНркбрлНрк╕
ЁЯЗ│ЁЯЗ┤ => ЁЯЗ│ЁЯЗ┤, ркирлЙрк░рлНрк╡рлЗ
ЁЯЗ│ЁЯЗ╡ => ЁЯЗ│ЁЯЗ╡, ркирлЗрккрк╛рк│
ЁЯЗ│ЁЯЗ╖ => ЁЯЗ│ЁЯЗ╖, ркирлМрк░рлБ
ЁЯЗ│ЁЯЗ║ => ЁЯЗ│ЁЯЗ║, ркирлАркпрлБ
ЁЯЗ│ЁЯЗ┐ => ЁЯЗ│ЁЯЗ┐, ркирлНркпрлБркЭрлАрк▓рлЗркирлНркб
ЁЯЗ┤ЁЯЗ▓ => ЁЯЗ┤ЁЯЗ▓, ркУркорк╛рки
ЁЯЗ╡ЁЯЗж => ЁЯЗ╡ЁЯЗж, рккркирк╛ркорк╛
ЁЯЗ╡ЁЯЗк => ЁЯЗ╡ЁЯЗк, рккрлЗрк░рлБ
ЁЯЗ╡ЁЯЗл => ЁЯЗ╡ЁЯЗл, рклрлНрк░рлЗркВркЪ рккрлЛрк▓рк┐ркирлЗрк╢рк┐ркпрк╛
ЁЯЗ╡ЁЯЗм => ЁЯЗ╡ЁЯЗм, рккрк╛рккрлБркЖ ркирлНркпрлВ ркЧрк┐ркирлА
ЁЯЗ╡ЁЯЗн => ЁЯЗ╡ЁЯЗн, рклрк┐рк▓рк┐рккрк┐ркирлНрк╕
ЁЯЗ╡ЁЯЗ░ => ЁЯЗ╡ЁЯЗ░, рккрк╛ркХрк┐рк╕рлНркдрк╛рки
ЁЯЗ╡ЁЯЗ▒ => ЁЯЗ╡ЁЯЗ▒, рккрлЛрк▓рлЗркВркб
ЁЯЗ╡ЁЯЗ▓ => ЁЯЗ╡ЁЯЗ▓, рк╕рлЗркВркЯ рккрлАркПрк░рлА ркЕркирлЗ ркорк┐ркХрлНркпрлБрк▓рлЛрки
ЁЯЗ╡ЁЯЗ│ => ЁЯЗ╡ЁЯЗ│, рккрлАркЯркХрлИрк░рлНрки ркЖркЗрк▓рлЗркирлНркбрлНрк╕
ЁЯЗ╡ЁЯЗ╖ => ЁЯЗ╡ЁЯЗ╖, рккрлНркпрлБркЕрк░рлНркЯрлЛ рк░рк┐ркХрлЛ
ЁЯЗ╡ЁЯЗ╕ => ЁЯЗ╡ЁЯЗ╕, рккрлЗрк▓рлЗрк╕рлНркЯрк┐ркирк┐ркпрки ркЯрлЗрк░рк┐ркЯрк░рлА
ЁЯЗ╡ЁЯЗ╣ => ЁЯЗ╡ЁЯЗ╣, рккрлЛрк░рлНркЯрлБркЧрк▓
ЁЯЗ╡ЁЯЗ╝ => ЁЯЗ╡ЁЯЗ╝, рккрк▓рк╛ркЙ
ЁЯЗ╡ЁЯЗ╛ => ЁЯЗ╡ЁЯЗ╛, рккрлЗрк░рк╛ркЧрлНрк╡рлЗ
ЁЯЗ╢ЁЯЗж => ЁЯЗ╢ЁЯЗж, ркХркдрк╛рк░
ЁЯЗ╢ЁЯЗ┤ => ЁЯЗ╢ЁЯЗ┤, ркЖркЙркЯрк▓рк╛ркИркирлНркЧ ркУрк╢ркирк┐ркпрк╛
ЁЯЗ╖ЁЯЗк => ЁЯЗ╖ЁЯЗк, рк░рлАркпрлБркирк┐ркпрки
ЁЯЗ╖ЁЯЗ┤ => ЁЯЗ╖ЁЯЗ┤, рк░рлЛркорк╛ркирк┐ркпрк╛
ЁЯЗ╖ЁЯЗ╕ => ЁЯЗ╖ЁЯЗ╕, рк╕рк░рлНркмрк┐ркпрк╛
ЁЯЗ╖ЁЯЗ║ => ЁЯЗ╖ЁЯЗ║, рк░рк╢рк┐ркпрк╛
ЁЯЗ╖ЁЯЗ╝ => ЁЯЗ╖ЁЯЗ╝, рк░рк╡рк╛ркВркбрк╛
ЁЯЗ╕ЁЯЗж => ЁЯЗ╕ЁЯЗж, рк╕рк╛ркЙркжрлА ркЕрк░рлЗркмрк┐ркпрк╛
ЁЯЗ╕ЁЯЗз => ЁЯЗ╕ЁЯЗз, рк╕рлЛрк▓рлЛркорки ркЖркЗрк▓рлЗркирлНркбрлНрк╕
ЁЯЗ╕ЁЯЗи => ЁЯЗ╕ЁЯЗи, рк╕рлЗрк╢рлЗрк▓рлНрк╕
ЁЯЗ╕ЁЯЗй => ЁЯЗ╕ЁЯЗй, рк╕рлБркжрк╛рки
ЁЯЗ╕ЁЯЗк => ЁЯЗ╕ЁЯЗк, рк╕рлНрк╡рлАркбрки
ЁЯЗ╕ЁЯЗм => ЁЯЗ╕ЁЯЗм, рк╕рк┐ркВркЧрк╛рккрлБрк░
ЁЯЗ╕ЁЯЗн => ЁЯЗ╕ЁЯЗн, рк╕рлЗркВркЯ рк╣рлЗрк▓рлЗркирк╛
ЁЯЗ╕ЁЯЗо => ЁЯЗ╕ЁЯЗо, рк╕рлНрк▓рлЛрк╡рлЗркирк┐ркпрк╛
ЁЯЗ╕ЁЯЗп => ЁЯЗ╕ЁЯЗп, рк╕рлНрк╡рк╛рк▓ркмрк░рлНркб ркЕркирлЗ ркЬрлЗрки ркорлЗркпрки
ЁЯЗ╕ЁЯЗ░ => ЁЯЗ╕ЁЯЗ░, рк╕рлНрк▓рлЛрк╡рлЗркХрк┐ркпрк╛
ЁЯЗ╕ЁЯЗ▒ => ЁЯЗ╕ЁЯЗ▒, рк╕рлАркПрк░рк╛ рк▓рлЗркУрки
ЁЯЗ╕ЁЯЗ▓ => ЁЯЗ╕ЁЯЗ▓, рк╕рлЕрки ркорлЗрк░рк┐ркирлЛ
ЁЯЗ╕ЁЯЗ│ => ЁЯЗ╕ЁЯЗ│, рк╕рлЗркирлЗркЧрк▓
ЁЯЗ╕ЁЯЗ┤ => ЁЯЗ╕ЁЯЗ┤, рк╕рлЛркорк╛рк▓рк┐ркпрк╛
ЁЯЗ╕ЁЯЗ╖ => ЁЯЗ╕ЁЯЗ╖, рк╕рлБрк░рлАркирк╛рко
ЁЯЗ╕ЁЯЗ╕ => ЁЯЗ╕ЁЯЗ╕, ркжркХрлНрк╖рк┐ркг рк╕рлБркжрк╛рки
ЁЯЗ╕ЁЯЗ╣ => ЁЯЗ╕ЁЯЗ╣, рк╕рк╛ркУ ркЯрлЙрко ркЕркирлЗ рккрлНрк░рк┐ркВрк╕рк┐рккрлЗ
ЁЯЗ╕ЁЯЗ╗ => ЁЯЗ╕ЁЯЗ╗, ркПрк▓ рк╕рлЗрк▓рлНрк╡рк╛ркбрлЛрк░
ЁЯЗ╕ЁЯЗ╜ => ЁЯЗ╕ЁЯЗ╜, рк╕рк┐ркВркЯ ркорк╛рк░рлНркЯрлЗрки
ЁЯЗ╕ЁЯЗ╛ => ЁЯЗ╕ЁЯЗ╛, рк╕рлАрк░рк┐ркпрк╛
ЁЯЗ╕ЁЯЗ┐ => ЁЯЗ╕ЁЯЗ┐, рк╕рлНрк╡рк╛ркЭрк┐рк▓рлЗркирлНркб
ЁЯЗ╣ЁЯЗж => ЁЯЗ╣ЁЯЗж, ркдрлНрк░рк┐рк╕рлНркдрк╛рки ркжрк╛ ркХрлБркирлНрк╣рк╛
ЁЯЗ╣ЁЯЗи => ЁЯЗ╣ЁЯЗи, ркдрлБрк░рлНркХрлНрк╕ ркЕркирлЗ ркХрлЗркХрлЛркЭ ркЖркЗрк▓рлЗркирлНркбрлНрк╕
ЁЯЗ╣ЁЯЗй => ЁЯЗ╣ЁЯЗй, ркЪрк╛ркб
ЁЯЗ╣ЁЯЗл => ЁЯЗ╣ЁЯЗл, рклрлНрк░рлЗркВркЪ рк╕ркзрк░рлНрки ркЯрлЗрк░рк┐ркЯрк░рлАркЭ
ЁЯЗ╣ЁЯЗм => ЁЯЗ╣ЁЯЗм, ркЯрлЛркЧрлЛ
ЁЯЗ╣ЁЯЗн => ЁЯЗ╣ЁЯЗн, ркерк╛ркЗрк▓рлЗркВркб
ЁЯЗ╣ЁЯЗп => ЁЯЗ╣ЁЯЗп, ркдрк╛ркЬрлАркХрк┐рк╕рлНркдрк╛рки
ЁЯЗ╣ЁЯЗ░ => ЁЯЗ╣ЁЯЗ░, ркЯрлЛркХрлЗрк▓рк╛ркЙ
ЁЯЗ╣ЁЯЗ▒ => ЁЯЗ╣ЁЯЗ▒, ркдрк┐ркорлЛрк░-рк▓рлЗрк╕рлНркдрлЗ
ЁЯЗ╣ЁЯЗ▓ => ЁЯЗ╣ЁЯЗ▓, ркдрлБрк░рлНркХркорлЗркирк┐рк╕рлНркдрк╛рки
ЁЯЗ╣ЁЯЗ│ => ЁЯЗ╣ЁЯЗ│, ркЯрлНркпрлБркирк┐рк╢рк┐ркпрк╛
ЁЯЗ╣ЁЯЗ┤ => ЁЯЗ╣ЁЯЗ┤, ркЯрлЛркВркЧрк╛
ЁЯЗ╣ЁЯЗ╖ => ЁЯЗ╣ЁЯЗ╖, ркдрлБрк░рлНркХрлА
ЁЯЗ╣ЁЯЗ╣ => ЁЯЗ╣ЁЯЗ╣, ркЯрлНрк░рк┐ркирлАркжрк╛ркж ркЕркирлЗ ркЯрлЛркмрлЗркЧрлЛ
ЁЯЗ╣ЁЯЗ╗ => ЁЯЗ╣ЁЯЗ╗, ркдрлБрк╡рк╛рк▓рлБ
ЁЯЗ╣ЁЯЗ╝ => ЁЯЗ╣ЁЯЗ╝, ркдрк╛ркЗрк╡рк╛рки
ЁЯЗ╣ЁЯЗ┐ => ЁЯЗ╣ЁЯЗ┐, ркдрк╛ркВркЭрк╛ркирк┐ркпрк╛
ЁЯЗ║ЁЯЗж => ЁЯЗ║ЁЯЗж, ркпрлБркХрлНрк░рлЗрки
ЁЯЗ║ЁЯЗм => ЁЯЗ║ЁЯЗм, ркпрлБркЧрк╛ркВркбрк╛
ЁЯЗ║ЁЯЗ▓ => ЁЯЗ║ЁЯЗ▓, ркпрлБ.ркПрк╕. ркЖркЙркЯрк▓рк╛ркЗркирк┐ркВркЧ ркЖркЗрк▓рлЗркирлНркбрлНрк╕
ЁЯЗ║ЁЯЗ│ => ЁЯЗ║ЁЯЗ│, рк╕ркВркпрлБркХрлНркд рк░рк╛рк╖рлНркЯрлНрк░
ЁЯЗ║ЁЯЗ╕ => ЁЯЗ║ЁЯЗ╕, ркпрлБркирк╛ркЗркЯрлЗркб рк╕рлНркЯрлЗркЯрлНрк╕
ЁЯЗ║ЁЯЗ╛ => ЁЯЗ║ЁЯЗ╛, ркЙрк░рлБркЧрлНрк╡рлЗ
ЁЯЗ║ЁЯЗ┐ => ЁЯЗ║ЁЯЗ┐, ркЙркЭрлНркмрлЗркХрк┐рк╕рлНркдрк╛рки
ЁЯЗ╗ЁЯЗж => ЁЯЗ╗ЁЯЗж, рк╡рлЗркЯрк┐ркХрки рк╕рк┐ркЯрлА
ЁЯЗ╗ЁЯЗи => ЁЯЗ╗ЁЯЗи, рк╕рлЗркВркЯ рк╡рк┐ркирлНрк╕рлЗркВркЯ ркЕркирлЗ ркЧрлНрк░рлЗркирлЗркбрк╛ркЗркВрк╕
ЁЯЗ╗ЁЯЗк => ЁЯЗ╗ЁЯЗк, рк╡рлЗркирлЗркЭрлБркПрк▓рк╛
ЁЯЗ╗ЁЯЗм => ЁЯЗ╗ЁЯЗм, ркмрлНрк░рк┐ркЯрк┐рк╢ рк╡рк░рлНркЬрк┐рки ркЖркЗрк▓рлЗркирлНркбрлНрк╕
ЁЯЗ╗ЁЯЗо => ЁЯЗ╗ЁЯЗо, ркпрлБркПрк╕ рк╡рк░рлНркЬрк┐рки ркЖркЗрк▓рлЗркирлНркбрлНрк╕
ЁЯЗ╗ЁЯЗ│ => ЁЯЗ╗ЁЯЗ│, рк╡рк┐ркпрлЗркдркирк╛рко
ЁЯЗ╗ЁЯЗ║ => ЁЯЗ╗ЁЯЗ║, рк╡рк╛ркирлБркЖркдрлБ
ЁЯЗ╝ЁЯЗл => ЁЯЗ╝ЁЯЗл, рк╡рлЙрк▓рк┐рк╕ ркЕркирлЗ рклрлНркпрлБркЪрлБркирк╛
ЁЯЗ╝ЁЯЗ╕ => ЁЯЗ╝ЁЯЗ╕, рк╕ркорлЛркЖ
ЁЯЗ╜ЁЯЗ░ => ЁЯЗ╜ЁЯЗ░, ркХрлЛрк╕рлЛрк╡рлЛ
ЁЯЗ╛ЁЯЗк => ЁЯЗ╛ЁЯЗк, ркпркорки
ЁЯЗ╛ЁЯЗ╣ => ЁЯЗ╛ЁЯЗ╣, ркорлЗркпрлЛркЯ
ЁЯЗ┐ЁЯЗж => ЁЯЗ┐ЁЯЗж, ркжркХрлНрк╖рк┐ркг ркЖрклрлНрк░рк┐ркХрк╛
ЁЯЗ┐ЁЯЗ▓ => ЁЯЗ┐ЁЯЗ▓, ркЭрк╛ркорлНркмрк┐ркпрк╛
ЁЯЗ┐ЁЯЗ╝ => ЁЯЗ┐ЁЯЗ╝, ркЭрк┐ркорлНркмрк╛ркмрлНрк╡рлЗ
ЁЯЗ┐ЁЯЗ┐ => ЁЯЗ┐ЁЯЗ┐, ркЕркЬрлНркЮрк╛ркд рккрлНрк░ркжрлЗрк╢