тЩА => тЩА, рокрпЖрогрпН, роороХро│ро┐ро░рпН, роЪро┐ройрпНройроорпН
тЩВ => тЩВ, роЖрогрпН, роЖроЯро╡ро░рпН, роЪро┐ройрпНройроорпН
тЪХ => тЪХ, рооро░рпБродрпНродрпБро╡ро░рпН, роЯро╛роХрпНроЯро░рпН
ЁЯХ║ => ЁЯХ║, роироЯройроорпН, роЖрогрпН, рооройро┐родройрпН
ЁЯЦд => ЁЯЦд, роХро░рпБрокрпНрокрпБ, роХрпЛрокроорпН, роХрпЖроЯрпНроЯ, родрпАроп
ЁЯдЩ => ЁЯдЩ, роЕро┤рпИ, роХрпИ
ЁЯдЪ => ЁЯдЪ, роХрпИ, роЙропро░рпНродрпНродрпБродро▓рпН
ЁЯдЫ => ЁЯдЫ, роХрпИ, роХрпБродрпНродрпБ, роЗроЯрокрпНрокроХрпНроХроорпН
ЁЯдЬ => ЁЯдЬ, роХрпИ, роХрпБродрпНродрпБ, ро╡ро▓рокрпНрокроХрпНроХроорпН
ЁЯдЭ => ЁЯдЭ, роХрпИроХрпБро▓рпБроХрпНроХро▓рпН, роТрокрпНрокроирпНродроорпН, роЪроирпНродро┐рокрпНрокрпБ, роХрпИ
ЁЯдЮ => ЁЯдЮ, роЕродро┐ро░рпНро╖рпНроЯроорпН, ро╡ро┐ро░ро▓рпН, роХрпИ
ЁЯда => ЁЯда, ро╡рпЗроЯрпНроЯрпИ, родрпКрокрпНрокро┐, ро╡рпЗроЯрпНроЯрпИроХрпНроХро╛ро░ройрпН, роорпБроХроорпН
ЁЯдб => ЁЯдб, роХрпЛрооро╛ро│ро┐, роорпБроХроорпН
ЁЯдв => ЁЯдв, ро╡ро╛роирпНродро┐, роорпБроХроорпН
ЁЯдг => ЁЯдг, роЪро┐ро░ро┐рокрпНрокрпБ, роХро╛роорпЖроЯро┐, роорпБроХроорпН
ЁЯдд => ЁЯдд, роЬрпКро│рпНро│рпБ, роорпБроХроорпН
ЁЯде => ЁЯде, рокрпКропрпН, роорпБроХроорпН, роПрооро╛ро▒рпНро▒рпБро╡рпЗро▓рпИ
ЁЯдж => ЁЯдж, ро╡ро┐ро░роХрпНродро┐, роПрооро╛ро▒рпНро▒роорпН
ЁЯджтАНтЩА => ЁЯджтАНтЩА, ро╡ро┐ро░роХрпНродро┐, рокрпЖрогрпН, роПрооро╛ро▒рпНро▒роорпН
ЁЯджтАНтЩВ => ЁЯджтАНтЩВ, ро╡ро┐ро░роХрпНродро┐, роЖрогрпН, роПрооро╛ро▒рпНро▒роорпН
ЁЯдз => ЁЯдз, родрпБроорпНрооро▓рпН, роорпБроХроорпН
ЁЯд░ => ЁЯд░, роХро░рпБродрпНродро░ро┐рокрпНрокрпБ, рокрпЖрогрпН
ЁЯд│ => ЁЯд│, роЪрпЖро▓рпНроГрокро┐, роХрпЗрооро░ро╛, роорпКрокрпИро▓рпН
ЁЯд┤ => ЁЯд┤, роЗро│ро╡ро░роЪро┐
ЁЯд╡ => ЁЯд╡, роХрпЛроЯрпНроЯрпБ, роЪрпВроЯрпНроЯрпБ, рооро╛рокрпНрокро┐ро│рпНро│рпИ
ЁЯд╢ => ЁЯд╢, роХро┐ро▒ро┐ро╕рпНродрпБрооро╕рпН, роЪро╛ройрпНроЯро╛, родро╛родрпНродро╛, рокро╛роЯрпНроЯро┐
ЁЯд╖ => ЁЯд╖, роЪроирпНродрпЗроХроорпН, родрпЖро░ро┐ропро╡ро┐ро▓рпНро▓рпИ, роЕро▒ро┐ропро╛роорпИ
ЁЯд╖тАНтЩА => ЁЯд╖тАНтЩА, родрпЖро░ро┐ропро╛родрпБ, роЪроирпНродрпЗроХроорпН, рокрпЖрогрпН
ЁЯд╖тАНтЩВ => ЁЯд╖тАНтЩВ, родрпЖро░ро┐ропро╛родрпБ, роЪроирпНродрпЗроХроорпН, роЖрогрпН
ЁЯд╕ => ЁЯд╕, роЬро┐роорпНройро╛ро╕рпНроЯро┐роХрпНро╕рпН, ро╡ро┐ро│рпИропро╛роЯрпНроЯрпБ
ЁЯд╕тАНтЩА => ЁЯд╕тАНтЩА, роЬро┐роорпНройро╛ро╕рпНроЯро┐роХрпНро╕рпН, рокрпЖрогрпН, ро╡ро┐ро│рпИропро╛роЯрпНроЯрпБ
ЁЯд╕тАНтЩВ => ЁЯд╕тАНтЩВ, роЬро┐роорпНройро╛ро╕рпНроЯро┐роХрпНро╕рпН, роЖрогрпН, ро╡ро┐ро│рпИропро╛роЯрпНроЯрпБ
ЁЯд╣ => ЁЯд╣, роЬроХрпНро│ро┐роЩрпН, родро┐ро▒ройрпН
ЁЯд╣тАНтЩА => ЁЯд╣тАНтЩА, роЬроХрпНро│ро┐роЩрпН, рокрпЖрогрпН, родро┐ро▒ройрпН
ЁЯд╣тАНтЩВ => ЁЯд╣тАНтЩВ, роЬроХрпНро│ро┐роЩрпН, роЖрогрпН, родро┐ро▒ройрпН
ЁЯд║ => ЁЯд║, роХрпВро░рпНро╡ро╛ро│рпН, ро╡ро┐ро│рпИропро╛роЯрпНроЯрпБ
ЁЯд╝ => ЁЯд╝, рооро▓рпНропрпБродрпНродроорпН, ро╡ро┐ро│рпИропро╛роЯрпНроЯрпБ
ЁЯд╝тАНтЩА => ЁЯд╝тАНтЩА, рооро▓рпНропрпБродрпНродроорпН, ро╡ро┐ро│рпИропро╛роЯрпНроЯрпБ, рокрпЛроЯрпНроЯро┐, рокрпЖрогрпНроХро│рпН
ЁЯд╝тАНтЩВ => ЁЯд╝тАНтЩВ, рооро▓рпНропрпБродрпНродроорпН, ро╡ро┐ро│рпИропро╛роЯрпНроЯрпБ, рокрпЛроЯрпНроЯро┐, роЖрогрпНроХро│рпН
ЁЯд╜ => ЁЯд╜, рокрпЛро▓рпЛ, родрогрпНрогрпАро░рпН, ро╡ро┐ро│рпИропро╛роЯрпНроЯрпБ
ЁЯд╜тАНтЩА => ЁЯд╜тАНтЩА, ро╡ро╛роЯрпНроЯро░рпН рокрпЛро▓рпЛ, ро╡ро┐ро│рпИропро╛роЯрпНроЯрпБ, родрогрпНрогрпАро░рпН, роирпАроЪрпНроЪро▓рпНроХрпБро│роорпН, рокрпЖрогрпН
ЁЯд╜тАНтЩВ => ЁЯд╜тАНтЩВ, ро╡ро╛роЯрпНроЯро░рпН рокрпЛро▓рпЛ, ро╡ро┐ро│рпИропро╛роЯрпНроЯрпБ, родрогрпНрогрпАро░рпН, роирпАроЪрпНроЪро▓рпНроХрпБро│роорпН, роЖрогрпН
ЁЯд╛ => ЁЯд╛, роХрпИропрпЖро▒ро┐, рокроирпНродрпБ, ро╡ро┐ро│рпИропро╛роЯрпНроЯрпБ
ЁЯд╛тАНтЩА => ЁЯд╛тАНтЩА, роХрпИрокрпНрокроирпНродрпБ, ро╡ро┐ро│рпИропро╛роЯрпНроЯрпБ, рокрпЖрогрпН
ЁЯд╛тАНтЩВ => ЁЯд╛тАНтЩВ, роХрпИрокрпНрокроирпНродрпБ, ро╡ро┐ро│рпИропро╛роЯрпНроЯрпБ, роЖрогрпН
ЁЯеА => ЁЯеА, ро╡ро╛роЯро┐ропродрпБ, рокрпВ
ЁЯеБ => ЁЯеБ, роорпЗро│роорпН, роЗроЪрпИ
ЁЯеВ => ЁЯеВ, роЪро┐ропро░рпНро╕рпН, рокро╛ройроорпН, роХрпКрогрпНроЯро╛роЯрпНроЯроорпН
ЁЯеГ => ЁЯеГ, ро╡ро┐ро╕рпНроХро┐, роородрпБ
ЁЯеД => ЁЯеД, роХро░рогрпНроЯро┐
ЁЯеЕ => ЁЯеЕ, роХрпЛро▓рпН, роХро╛ро▓рпНрокроирпНродрпБ, ро╡ро┐ро│рпИропро╛роЯрпНроЯрпБ
ЁЯеЗ => ЁЯеЗ, роорпБродро▓рпН, рокро░ро┐роЪрпБ, рокродроХрпНроХроорпН
ЁЯеИ => ЁЯеИ, роЗро░рогрпНроЯро╛ро╡родрпБ, рокро░ро┐роЪрпБ, рокродроХрпНроХроорпН
ЁЯеЙ => ЁЯеЙ, роорпВройрпНро▒ро╛ро╡родрпБ, рокро░ро┐роЪрпБ, рокродроХрпНроХроорпН
ЁЯеК => ЁЯеК, роХрпБродрпНродрпБроЪрпНроЪрогрпНроЯрпИ, роХрпИропрпБро▒рпИ
ЁЯеЛ => ЁЯеЛ, роХро░ро╛родрпНродрпЗ, роЬрпВроЯрпЛ, роЙроЯрпИ
ЁЯеР => ЁЯеР, рооро╛ро╡рпБрокрпН рокрогрпНроЯроорпН, роЙрогро╡рпБ
ЁЯеС => ЁЯеС, ро╡рпЖрогрпНрогрпИрокрпНрокро┤роорпН, роЙрогро╡рпБ, рокро┤роорпН
ЁЯеТ => ЁЯеТ, ро╡рпЖро│рпНро│ро░ро┐, роХро╛ропрпНроХро▒ро┐, роЙрогро╡рпБ
ЁЯеУ => ЁЯеУ, рокройрпНро▒ро┐, роЗро▒рпИроЪрпНроЪро┐, роЙрогро╡рпБ, роЕроЪрпИро╡роорпН
ЁЯеФ => ЁЯеФ, роЙро░рпБро│рпИ, роХро╛ропрпНроХро▒ро┐, роЙрогро╡рпБ
ЁЯеХ => ЁЯеХ, роХрпЗро░роЯрпН, роХро╛ропрпНроХро▒ро┐, роЙрогро╡рпБ
ЁЯеЦ => ЁЯеЦ, ро░рпКроЯрпНроЯро┐, роЙрогро╡рпБ
ЁЯеЧ => ЁЯеЧ, роЪро╛ро▓роЯрпН, роЙрогро╡рпБ
ЁЯеШ => ЁЯеШ, роХроЯро╛ропрпН, роЙрогро╡рпБ
ЁЯеЩ => ЁЯеЩ, ро░рпКроЯрпНроЯро┐, роЙрогро╡рпБ
ЁЯеЪ => ЁЯеЪ, роорпБроЯрпНроЯрпИ, роЙрогро╡рпБ
ЁЯеЫ => ЁЯеЫ, рокро╛ро▓рпН, рокро╛ройроорпН
ЁЯеЬ => ЁЯеЬ, ро╡рпЗро░рпНроХрпНроХроЯро▓рпИ, роХроЯро▓рпИ, роЙрогро╡рпБ, роХро╛ропрпНроХро▒ро┐
ЁЯеЭ => ЁЯеЭ, роХро┐ро╡ро┐, рокро┤роорпН, роЙрогро╡рпБ
ЁЯеЮ => ЁЯеЮ, рокрпЗройрпНроХрпЗроХрпН, роЙрогро╡рпБ
ЁЯжЕ => ЁЯжЕ, роХро┤рпБроХрпБ, рокро▒ро╡рпИ
ЁЯжЖ => ЁЯжЖ, ро╡ро╛родрпНродрпБ, рокро▒ро╡рпИ
ЁЯжЗ => ЁЯжЗ, ро╡рпМро╡ро╛ро▓рпН, ро╡ро┐ро▓роЩрпНроХрпБ
ЁЯжИ => ЁЯжИ, роЪрпБро▒ро╛, роорпАройрпН
ЁЯжЙ => ЁЯжЙ, роЖроирпНродрпИ, рокро▒ро╡рпИ
ЁЯжК => ЁЯжК, роиро░ро┐, ро╡ро┐ро▓роЩрпНроХрпБ, роорпБроХроорпН
ЁЯжЛ => ЁЯжЛ, рокроЯрпНроЯро╛роорпНрокрпВроЪрпНроЪро┐, ро╡рогрпНрогроорпН, рокрпВроЪрпНроЪро┐
ЁЯжМ => ЁЯжМ, рооро╛ройрпН, ро╡ро┐ро▓роЩрпНроХрпБ
ЁЯжН => ЁЯжН, роХрпКро░ро┐ро▓рпНро▓ро╛, ро╡ро┐ро▓роЩрпНроХрпБ
ЁЯжО => ЁЯжО, рокро▓рпНро▓ро┐
ЁЯжП => ЁЯжП, роХро╛рогрпНроЯро╛рооро┐ро░рпБроХроорпН, ро╡ро┐ро▓роЩрпНроХрпБ
ЁЯжР => ЁЯжР, роХрпВройро┐ро▒ро╛ро▓рпН, роорпАройрпН, роЙрогро╡рпБ
ЁЯжС => ЁЯжС, роХрогро╡ро╛ропрпН, роЙрогро╡рпБ
ЁЯША => ЁЯША, рокрпБройрпНройроХрпИ, роорпБроХроорпН, роЪро┐ро░ро┐рокрпНрокрпБ
ЁЯШБ => ЁЯШБ, роорпБроХроорпН, роХрогрпН, роЪро┐ро░ро┐рокрпНрокрпБ, рокрпБройрпНройроХрпИ, ро╡рпЗроЯро┐роХрпНроХрпИ
ЁЯШВ => ЁЯШВ, роорпБроХроорпН, роЖройроирпНродроорпН, роЪро┐ро░ро┐рокрпНрокрпБ, роХрогрпНрогрпАро░рпН, роЖройроирпНродроХрпН роХрогрпНрогрпАро░рпН
ЁЯШГ => ЁЯШГ, роорпБроХроорпН, ро╡ро╛ропрпН, роЪро┐ро░ро┐рокрпНрокрпБ, рокрпБройрпНройроХрпИ
ЁЯШД => ЁЯШД, роорпБроХроорпН, роХрогрпН, ро╡ро╛ропрпН, роЪро┐ро░ро┐рокрпНрокрпБ, рокрпБройрпНройроХрпИ
ЁЯШЕ => ЁЯШЕ, ро╡ро┐ропро░рпНро╡рпИ, роорпБроХроорпН, роЪро┐ро░ро┐рокрпНрокрпБ, рокрпБройрпНройроХрпИ, родро┐ро▒роирпНрод ро╡ро╛ропрпНрокрпН рокрпБройрпНройроХрпИ, роХро│рпИрокрпНрокрпБроЪрпН роЪро┐ро░ро┐рокрпНрокрпБ
ЁЯШЖ => ЁЯШЖ, роорпБроХроорпН, ро╡ро╛ропрпН, роЪро┐ро░ро┐рокрпНрокрпБ, рокрпБройрпНройроХрпИ, родро┐ро░рпБрокрпНродро┐, роХрогрпНроорпВроЯро┐родрпНродройрооро╛рой роЪро┐ро░ро┐рокрпНрокрпБ, роХро┐рогрпНроЯро▓рпН
ЁЯШЙ => ЁЯШЙ, роорпБроХроорпН, роЪро┐ро░ро┐рокрпНрокрпБ, рокрпБройрпНройроХрпИ, роХрогрпНрогроЯро┐родрпНродро▓рпН, роХро┐рогрпНроЯро▓рпН
ЁЯШК => ЁЯШК, роорпБроХроорпН, ро╡ро╛ропрпН, роЪро┐ро░ро┐рокрпНрокрпБ, рокрпБройрпНройроХрпИ, роХрогрпН, ро╡рпЖроЯрпНроХроорпН
ЁЯШЛ => ЁЯШЛ, роЯрпЗро╕рпНроЯрпНроЯро┐, роЕро▒рпБроЪрпБро╡рпИ, роЪрпВрокрпНрокро░рпН, роЕро░рпБроорпИ, ро░рпБроЪро┐ропро╛рой роЙрогро╡рпБ, роЪрокрпНрокрпБроХрпНроХрпКроЯрпНроЯрпБродро▓рпН, роорпБроХроорпН
ЁЯШО => ЁЯШО, ро╕рпНроЯрпИро▓рпН, роЪройрпНроХро┐ро│ро╛ро╕рпН, роХрпВро▓рпН, роиро╡рпАройроорпН, ро╡ро╛ройро┐ро▓рпИ, роХрогрпН, роорпБроХроорпН, роЪро┐ро░ро┐рокрпНрокрпБ, рокрпБройрпНройроХрпИ, роЪрпВро░ро┐ропроХрпНроХрогрпНрогро╛роЯро┐роХро│рпН, роЪрпВро░ро┐ропройрпН
ЁЯШН => ЁЯШН, роЗродропроорпН, роХрогрпНроХро│рпН, роЪро┐ро░ро┐рокрпНрокрпБ, роорпБроХроорпН
ЁЯШШ => ЁЯШШ, рокро▒роХрпНроХрпБроорпН роорпБродрпНродроорпН, рокро┐ро│рпИропро┐роЩрпН роХро┐ро╕рпН, роорпБродрпНродрооро┐роЯрпБроорпН роорпБроХроорпН
ЁЯШЧ => ЁЯШЧ, роорпБродрпНродроорпН, роорпБродрпНродрооро│ро┐родрпНродро▓рпН, роорпБродрпНродрооро┐роЯрпБродро▓рпН, роХро┐ро╕рпН
ЁЯШЩ => ЁЯШЩ, роЪро┐ро░ро┐родрпНрод роХрогрпНроХро│рпН, роЪро┐ро░ро┐рокрпНрокрпБроЯройрпН роорпБродрпНродроорпН
ЁЯШЪ => ЁЯШЪ, роХрогрпНроорпВроЯро┐роп роорпБродрпНродроорпН, роорпБродрпНродрооро┐роЯрпБроорпН роорпБроХроорпН
тШ║ => тШ║, роЪро┐ро░ро┐рокрпНрокрпБ, роЪро┐ро░ро┐рокрпНрокрпБ роорпБроХроорпН, роЪроирпНродрпЛро╖роорпН, роороХро┐ро┤рпНроЪрпНроЪро┐, роЙрогро░рпНроЪрпНроЪро┐
ЁЯЩВ => ЁЯЩВ, ро▓рпЗроЪро╛рой роЪро┐ро░ро┐рокрпНрокрпБ, роЪро┐ро░ро┐рокрпНрокрпБ, роорпБроХроорпН
ЁЯдЧ => ЁЯдЧ, роХроЯрпНроЯро┐роХрпНроХрпКро│рпНро│рпБродро▓рпН, роЕрогрпИрокрпНрокрпБ, роорпБроХроорпН
ЁЯШЗ => ЁЯШЗ, роТро│ро┐ро╡роЯрпНроЯроорпН, роТро│ро┐ро╡роЯрпНроЯ роЪро┐ро░ро┐рокрпНрокрпБ, рокро┐ро░роХро╛роЪ роЪро┐ро░ро┐рокрпНрокрпБ
ЁЯдФ => ЁЯдФ, роЪро┐роирпНродро┐родрпНродро▓рпН, роорпНроорпНроорпН, ропрпЛроЪройрпИ
ЁЯШР => ЁЯШР, рокродро┐ро▓рпН роЗро▓рпНро▓рпИ, роЕроорпИродро┐, роироЯрпБроиро┐ро▓рпИ
ЁЯШС => ЁЯШС, роЙрогро░рпНроЪрпНроЪро┐ роЗро▓рпНро▓рпИ, роЙро▒роХрпНроХроорпН, рокродро┐ро▓рпН роЗро▓рпНро▓рпИ
ЁЯШ╢ => ЁЯШ╢, ро╡ро╛ропрпН роЗро▓рпНро▓ро╛родродрпБ, роорпБроХроорпН
ЁЯЩД => ЁЯЩД, роХрогрпНроХро│рпИ роЙро░рпБроЯрпНроЯрпБродро▓рпН, роХрогрпНроХро│рпИроЪрпН роЪрпБро┤ро▒рпНро▒рпБродро▓рпН, роХрогрпНроХро│рпИроЪрпН роЪрпБро┤ро▒рпНро▒рпБроорпН роорпБроХроорпН
ЁЯШП => ЁЯШП, роЗро│ро┐рокрпНрокрпБ, рокроХроЯрпНроЯрпБ, рокроХроЯрпНроЯрпБроЪрпН роЪро┐ро░ро┐рокрпНрокрпБ
ЁЯШг => ЁЯШг, ро╡ро┐роЯро╛ роорпБропро▒рпНроЪро┐, роЙро▒рпБродро┐, роЪро╛родро┐роХрпНроХрпБроорпН роЖро▒рпНро▒ро▓рпН
ЁЯШе => ЁЯШе, роЕрокрпНрокро╛роЯро╛!, роиро┐роорпНроородро┐ рокрпЖро░рпБроорпВроЪрпНроЪрпБ, роорпБроЯро┐роирпНродродрпБ, роиро┐роорпНроородро┐ропро╛роХ роЗро░рпБроХрпНроХро┐ро▒рпЗройрпН
ЁЯШо => ЁЯШо, роЕродро┐ро░рпНроЪрпНроЪро┐, роЕропрпНропрпЛ
ЁЯдР => ЁЯдР, роорпВроЯро┐роп ро╡ро╛ропрпН, ро╡ро╛ропрпН роорпВроЯро┐роп роорпБроХроорпН, ро╡ро╛ропрпИ роорпВроЯрпБ
ЁЯШп => ЁЯШп, роЖроЪрпНроЪро░ро┐ропроорпН, ро╡ро┐ропрокрпНрокрпБ, роЕрокрпНрокроЯро┐ропро╛!
ЁЯШк => ЁЯШк, родрпВроХрпНроХроорпН, родрпВроХрпНроХ роХро▓роХрпНроХроорпН
ЁЯШл => ЁЯШл, роЪро▓ро┐рокрпНрокрпБ, роЕро▓рпБродрпНродрпБро╡ро┐роЯрпНроЯродрпБ, роЪро▓ро┐рокрпНрокро╛рой роорпБроХроорпН, роЪрпЛро░рпНро╡рпБ, роЪрпЛро░рпНро╡ро╛рой роорпБроХроорпН
ЁЯШ┤ => ЁЯШ┤, родрпВроХрпНроХроорпН, родрпВроХрпНроХ роХро▓роХрпНроХроорпН, родрпВроХрпНроХ роХро▓роХрпНроХрооро╛рой роорпБроХроорпН
ЁЯШМ => ЁЯШМ, роиро┐роорпНроородро┐, роЕроорпИродро┐, роорой роЕроорпИродро┐, роЕроорпИродро┐ роорпБроХроорпН
ЁЯдУ => ЁЯдУ, роХрпЛрооро╛ро│ро┐, ро╡рпЗроЯро┐роХрпНроХрпИропро╛рой роорпБроХроорпН, роХрогрпНрогро╛роЯро┐
ЁЯШЫ => ЁЯШЫ, роиро╛роХрпНроХрпИроХрпН роХро╛роЯрпНроЯрпБроорпН роорпБроХроорпН, рокро┤ро┐рокрпНрокрпБ, роирпИропро╛рогрпНроЯро┐
ЁЯШЬ => ЁЯШЬ, рокро┤ро┐рокрпНрокрпБ, роирпИропро╛рогрпНроЯро┐, роЪрпАрогрпНроЯро▓рпН
ЁЯШЭ => ЁЯШЭ, роиро╛роХрпНроХрпИроХрпН роХро╛роЯрпНроЯро┐ роХрогрпН роЪро┐рооро┐роЯрпНроЯрпБроорпН роорпБроХроорпН, роирпИропро╛рогрпНроЯро┐, роЪрпАрогрпНроЯро▓рпН
тШ╣ => тШ╣, ро╡ро░рпБродрпНродроорпН, ро╡ро░рпБродрпНродрооро╛рой роорпБроХроорпН, роЕропрпНропрпЛ, роРропрпЛ, рокрпЛроЪрпНроЪрпБ
ЁЯЩБ => ЁЯЩБ, ро▓рпЗроЪро╛рой ро╡ро░рпБродрпНродроорпН, ро╡ро░рпБродрпНродрооро╛рой роорпБроХроорпН
ЁЯШТ => ЁЯШТ, ро╡ро░рпБродрпНродроорпН, роЖроЪрпНроЪро░ро┐ропрооро┐ро▓рпНро▓рпИ, роТройрпНро▒рпБрооро┐ро▓рпНро▓рпИ
ЁЯШУ => ЁЯШУ, роХро│рпИрокрпНрокрпБ, роЕро╡роЪро░роорпН, рокроЯрокроЯрокрпНрокрпБ роорпБроХроорпН
ЁЯШФ => ЁЯШФ, роЪрпЛро░рпНро╡рпБ, роХро╡ро▓рпИ, роХро│рпИрокрпНрокрпБ, роорпБроХроорпН, роЖро┤рпНроирпНрод роХро╡ро▓рпИ
ЁЯШХ => ЁЯШХ, роХрпБро┤рокрпНрокроорпН, роХрпБро┤рокрпНрокрооро╛рой роорпБроХроорпН
ЁЯШЦ => ЁЯШЦ, роХро▓роХрпНроХроорпН, роХро▓роЩрпНроХро┐роп роорпБроХроорпН, роХрпБро┤рокрпНрокроорпН
ЁЯЩГ => ЁЯЩГ, родро▓рпИроХрпАро┤рпН, роорпБроХроорпН
ЁЯШ╖ => ЁЯШ╖, рооро╛ро╕рпНроХрпН роЕрогро┐роирпНрод роорпБроХроорпН, рооро╛ро╕рпНроХрпН, роХрпБро│ро┐ро░рпН, роХрпБро│ро┐ро░рпНроЪрпНроЪро┐, роорпБроХроорпН
ЁЯдТ => ЁЯдТ, ро╡рпЖрокрпНрокроиро┐ро▓рпИрооро╛ройро┐ роЙро│рпНро│ роорпБроХроорпН, роХро╛ропрпНроЪрпНроЪро▓рпН
ЁЯдХ => ЁЯдХ, родро▓рпИроХрпНроХроЯрпНроЯрпБ роЙро│рпНро│ роорпБроХроорпН, родро▓рпИроХрпНроХроЯрпНроЯрпБ, роорпБроХроорпН
ЁЯдС => ЁЯдС, рокрогроорпН роорпБроХроорпН, роЕродро┐роХ рокрогроорпН, рокрогроорпН роЙро│рпНро│ роорпБроХроорпН
ЁЯШ▓ => ЁЯШ▓, роЕродро┐ро░рпНроЪрпНроЪро┐, роЕродро┐ро░рпНроЪрпНроЪро┐ропро╛рой роорпБроХроорпН, роироЯрпБроХрпНроХроорпН роПро▒рпНрокроЯрпНроЯродрпБ, ро╖ро╛роХрпНроХро╛ропро┐роЯрпНроЯрпЗройрпН
ЁЯШЮ => ЁЯШЮ, роПрооро╛ро▒рпНро▒роорпН, роПрооро╛ро▒рпНро▒роороЯрпИроирпНродрпЗройрпН, роПрооро╛ро▒рпНро▒роорпН роПро▒рпНрокроЯрпНроЯродрпБ
ЁЯШЯ => ЁЯШЯ, роХро╡ро▓рпИ, роХро╡ро▓рпИрокрпНрокроЯрпБроХро┐ро▒рпЗройрпН, роХро╡ро▓рпИропро╛роХ роЙро│рпНро│родрпБ
ЁЯШд => ЁЯШд, ро╡рпЖро▒рпНро▒ро┐, ро╡рпЖро▒рпНро▒ро┐ропро┐ройрпН роороХро┐ро┤рпНроЪрпНроЪро┐, ро╡рпЖройрпНро▒рпБро╡ро┐роЯрпНроЯрпЗройрпН
ЁЯШв => ЁЯШв, роЕро┤рпБроХрпИ, роЕро┤рпБроХро┐ро▒рпЗройрпН, роХрогрпНрогрпАро░рпН ро╡ро░рпБроХро┐ро▒родрпБ
ЁЯШн => ЁЯШн, роЪродрпНродрооро╛роХ роЕро┤рпБроХрпИ, роЕро┤рпБродрпБро╡ро┐роЯрпБро╡рпЗройрпН, роорпБроЯро┐ропро╡ро┐ро▓рпНро▓рпИропрпЗ
ЁЯШж => ЁЯШж, роХрогрпНроХро│рпБроорпН ро╡ро╛ропрпБроорпН родро┐ро▒роирпНродрпБро│рпНро│ роорпБроХроорпН, роЪро┐роЯрпБроЪро┐роЯрпБрокрпНрокрпБ, роЗро▓рпНро▓рпИ, ро╡рпЗрогрпНроЯро╛роорпН
ЁЯШз => ЁЯШз, роЕродро┐ро░рпНроЪрпНроЪро┐, роЕродро┐ро░рпНроЪрпНроЪро┐ропро╛рой роорпБроХроорпН, роорой роЙро│рпИроЪрпНроЪро▓рпН, ро╡рпЗродройрпИ, ро╡рпЗродройрпИрокрпНрокроЯрпБроХро┐ро▒рпЗройрпН
ЁЯШи => ЁЯШи, роЕроЪрпНроЪроорпН, рокропроорпН, рокропрооро╛роХ роЙро│рпНро│родрпБ, ро░рпКроорпНрок рокропроорпН
ЁЯШй => ЁЯШй, роЕродро┐роХ рокропроорпН, роХро│рпИрокрпНрокрпБ, роЪрпЛро░рпНро╡рпБ, роХро│рпИрокрпНрокро╛роХ роЗро░рпБроХрпНроХро┐ро▒родрпБ, роЪрпЛро░рпНро╡ро╛рой роорпБроХроорпН
ЁЯШм => ЁЯШм, рокро▒рпНроХро│рпИроХрпН роХроЯро┐родрпНродро▓рпН, роироХрпНроХро▓рпН, роИроИроИроИроИроИ!
ЁЯШ░ => ЁЯШ░, родро┐ро▒роирпНрод ро╡ро╛ропрпН, ро╡ро┐ропро░рпНро╡рпИроЪрпН роЪрпКроЯрпНроЯрпБроорпН, роорпБроХроорпН, рокродроЯрпНроЯроорпН, роХро│рпИрокрпНрокрпБ, роХро│рпИрокрпНрокро╛рой роорпБроХроорпН
ЁЯШ▒ => ЁЯШ▒, рокропроорпН, рокропродрпНродро┐ро▓рпН роЕро▓ро▒рпБродро▓рпН, роЕропрпНропропрпНропрпЛ!, рокропрооро╛роХ роЗро░рпБроХрпНроХро┐ро▒родрпБ
ЁЯШ│ => ЁЯШ│, рокро┐ро░рооро┐рокрпНрокрпБ, родро┐роХрпИрокрпНрокрпБ, рокро┐ро░рооро┐рокрпНрокро╛роХ роЙро│рпНро│родрпБ
ЁЯШ╡ => ЁЯШ╡, родро▓рпИроЪрпНроЪрпБро▒рпНро▒ро▓рпН, рооропроХрпНроХроорпН, роХро┐ро▒рпБроХро┐ро▒рпБрокрпНрокрпБ, родро▓рпИроЪрпНроЪрпБро▒рпНро▒рпБро╡родрпБ рокрпЛройрпНро▒ роЙрогро░рпНро╡рпБ
ЁЯШб => ЁЯШб, роЖро╡рпЗроЪроорпН, роОро░ро┐роЪрпНроЪро▓рпН, роЖро╡рпЗроЪ роорпБроХроорпН
ЁЯШа => ЁЯШа, роХрпЛрокроорпН, роХрпЛрокрооро╛роХ роЗро░рпБроХрпНроХро┐ро▒рпЗройрпН, роХрпЛрокрооро╛рой роорпБроХроорпН
ЁЯШИ => ЁЯШИ, роХрпКроорпНрокрпБроХро│рпБроЯройрпН роЪро┐ро░ро┐родрпНрод роорпБроХроорпН, роХрпКроорпНрокрпБ, роорпБроХроорпН, роХрпКроорпНрокрпБ роорпБроХроорпН
ЁЯС┐ => ЁЯС┐, роХрпБроЯрпНроЯро┐ рокрпЗропрпН, рокрпЗропрпН, роХрпБроЯрпНроЯро┐ рокрпЗропрпН роорпБроХроорпН, роорпБроХроорпН, роХрпБроЯрпНроЯро┐роЪрпНроЪро╛родрпНродро╛ройрпН
ЁЯС╣ => ЁЯС╣, роЕро░роХрпНроХройрпН, роЕроЪрпБро░ройрпН, ро░ро╛роЯрпНроЪроЪройрпН, ро╡ро┐роЪро┐родрпНродро┐ро░роХрпН роХродрпИ, роЬрокрпНрокро╛ройрпН роЕро░роХрпНроХройрпН, роорпБроХроорпН, роЕроХрпЛро░ роорпБроХроорпН
ЁЯС║ => ЁЯС║, рокрпВродроорпН, рооро╛ройрпНро╕рпНроЯро░рпН, ро╡ро┐роЪро┐родрпНродро┐ро░роХрпН роХродрпИ, роорпБроХроорпН
ЁЯТА => ЁЯТА, ро╡ро┐роЪро┐родрпНродро┐ро░роХрпН роХродрпИ, роорпБроХроорпН, роЙроЯро▓рпН
тШа => тШа, роорогрпНроЯрпИ роУроЯрпБ, ро╡ро┐роЪро┐родрпНродро┐ро░роХрпН роХродрпИ, роорпБроХроорпН, роороирпНродро┐ро░роорпН, рооро╛роирпНродро┐ро░ро┐роХроорпН
ЁЯС╗ => ЁЯС╗, рокро┐роЪро╛роЪрпБ, роЖро╡ро┐, ро╡ро┐роЪро┐родрпНродро┐ро░роХрпН роХродрпИроХро│рпН, роорпБроХроорпН
ЁЯС╜ => ЁЯС╜, ро╡рпЗро▒рпНро▒рпБроХро┐ро░роХ ро╡ро╛роЪро┐, UFO, ро╡ро┐роЪро┐родрпНродро┐ро░роХрпН роХродрпИроХро│рпН, роорпБроХроорпН
ЁЯС╛ => ЁЯС╛, рооро╛ройрпНро╕рпНроЯро░рпН, рокрпЗропрпН, UFO, ро╡рпЗро▒рпНро▒рпБроХро┐ро░роХ ро╡ро╛роЪро┐, ро╡ро┐роЪро┐родрпНродро┐ро░роХрпН роХродрпИроХро│рпН, роорпБроХроорпН
ЁЯдЦ => ЁЯдЦ, ро░рпЛрокрпЛроЯрпН, ро░рпЛрокрпЛ
ЁЯТй => ЁЯТй, роЪро╛рогроорпН, ро╡ро┐ро▒роХрпБ роЕроЯрпБроХрпНроХрпБ
ЁЯШ║ => ЁЯШ║, роЪро┐ро░ро┐роХрпНроХрпБроорпН рокрпВройрпИ роорпБроХроорпН, ро╡ро╛ропрпН родро┐ро▒роирпНродрпБ роЪро┐ро░ро┐роХрпНроХрпБроорпН рокрпВройрпИ роорпБроХроорпН, ро╡ро╛ропрпН родро┐ро▒роирпНродро┐ро░рпБродрпНродро▓рпН, ро╡ро╛ропрпН, рокрпВройрпИ, роорпБроХроорпН
ЁЯШ╕ => ЁЯШ╕, роЪро┐ро░ро┐роХрпНроХрпБроорпН рокрпВройрпИ, роЪро┐ро░ро┐родрпНродро▓рпН, рокрпВройрпИ роорпБроХроорпН, рокрпВройрпИ, роЪро┐ро░ро┐роХрпНроХрпБроорпН роХрогрпНроХро│рпН, роорпБроХроорпН
ЁЯШ╣ => ЁЯШ╣, роЖройроирпНродроХрпН роХрогрпНрогрпАро░рпН, рокрпВройрпИ роорпБроХроорпН, рокрпВройрпИ, роорпБроХроорпН
ЁЯШ╗ => ЁЯШ╗, роЪро┐ро░ро┐роХрпНроХрпБроорпН рокрпВройрпИ роорпБроХроорпН, роХро╛родро▓ро┐ро▓рпН ро╡ро┐ро┤рпБроирпНродрпБро╡ро┐роЯрпНроЯрпЗройрпН роОройрпНрокродрпИроХрпН роХрпБро▒ро┐роХрпНроХрпБроорпН роЪро┐ройрпНройроорпН, роХро╛родро▓рпН, роЗродропроорпН, роХрогрпНроХро│рпН, рокрпВройрпИ, роорпБроХроорпН
ЁЯШ╝ => ЁЯШ╝, ро╡ро░рпБродрпНродрооро╛рой рокрпБройрпНройроХрпИ роХрпКрогрпНроЯ рокрпВройрпИ роорпБроХроорпН, ро╡ро░рпБродрпНродроорпН, рокрпВройрпИ роорпБроХроорпН, ро╡ро░рпБродрпНродрооро╛рой рокрпБройрпНройроХрпИ, рокрпВройрпИ, роорпБроХроорпН
ЁЯШ╜ => ЁЯШ╜, роорпБродрпНродрооро┐роЯрпБроорпН рокрпВройрпИ, роХрогрпНроХро│рпИ роорпВроЯро┐роп рокрпВройрпИ, рокрпВройрпИ, роорпБроХроорпН, рокрпВройрпИ роорпБроХроорпН, роорпБродрпНродроорпН
ЁЯЩА => ЁЯЩА, роЖроЪрпНроЪро░ро┐ропроорпН, роЖроЪрпНроЪро░ро┐ропроХрпНроХро╛роЯрпНроЯрпБроорпН рокрпВройрпИ роорпБроХроорпН, роЖроЪрпНроЪро░ро┐ропродрпНродрпБроЯройрпН рокро╛ро░рпНроХрпНроХрпБроорпН рокрпВройрпИ роорпБроХроорпН, роУ роорпИ роХро╛роЯрпН, рокрпВройрпИ роорпБроХроорпН, рокрпВройрпИ, роорпБроХроорпН
ЁЯШ┐ => ЁЯШ┐, роЕро┤рпБроорпН рокрпВройрпИ, рокрпВройрпИ роорпБроХроорпН, роорпБроХроорпН, рокрпВройрпИ
ЁЯШ╛ => ЁЯШ╛, роЙродроЯрпНроЯрпИрокрпН рокро┐родрпБроХрпНроХрпБродро▓рпН, рокрпВройрпИ роорпБроХроорпН, роорпБроХроорпН, рокрпВройрпИ
ЁЯЩИ => ЁЯЩИ, родрпАропро╡ро▒рпНро▒рпИрокрпН рокро╛ро░рпНроХрпНроХроХрпНроХрпВроЯро╛родрпБ, роХрпБро░роЩрпНроХрпБ, роХрогрпНроХро│рпИ роорпВроЯро┐роХрпНроХрпКрогрпНроЯ роХрпБро░роЩрпНроХрпБ
ЁЯЩЙ => ЁЯЩЙ, родрпАропро╡ро▒рпНро▒рпИроХрпН роХрпЗроЯрпНроХроХрпНроХрпВроЯро╛родрпБ, роХрпБро░роЩрпНроХрпБ, роХро╛родрпБроХро│рпИ роорпВроЯро┐роХрпНроХрпКрогрпНроЯ роХрпБро░роЩрпНроХрпБ
ЁЯЩК => ЁЯЩК, родрпАропро╡ро▒рпНро▒рпИрокрпН рокрпЗроЪроХрпНроХрпВроЯро╛родрпБ, роХрпБро░роЩрпНроХрпБ, ро╡ро╛ропрпИ роорпВроЯро┐роХрпНроХрпКрогрпНроЯ роХрпБро░роЩрпНроХрпБ
ЁЯСж => ЁЯСж, роЖрогрпН, рокрпИропройрпН, роЖроЯро╡ро░рпН, роороХрпНроХро│рпН
ЁЯСз => ЁЯСз, рокрпЖрогрпН, рокрпКрогрпНрогрпБ, роороХрпНроХро│рпН, роЗро│роорпН рокрпЖрогрпН
ЁЯСи => ЁЯСи, роЖрогрпНроороХройрпН, роороХрпНроХро│рпН
ЁЯСитАНтЪХ => ЁЯСитАНтЪХ, роЯро╛роХрпНроЯро░рпН, роЖрогрпН, рооро░рпБродрпНродрпБро╡ро░рпН
ЁЯСитАНЁЯОУ => ЁЯСитАНЁЯОУ, рооро╛рогро╡ройрпН, рокроЯрпНроЯроорпН
ЁЯСитАНЁЯМ╛ => ЁЯСитАНЁЯМ╛, ро╡ро┐ро╡роЪро╛ропроорпН, ро╡ро┐ро╡роЪро╛ропро┐, роЖрогрпН
ЁЯСитАНЁЯН│ => ЁЯСитАНЁЯН│, роЪроорпИропро▓рпН, роЖрогрпН
ЁЯСитАНЁЯПл => ЁЯСитАНЁЯПл, роЖроЪро┐ро░ро┐ропро░рпН, роЖрогрпН, рокро│рпНро│ро┐
ЁЯСитАНЁЯПн => ЁЯСитАНЁЯПн, родрпКро┤ро┐ро▓ро╛ро│ро┐, роЖрогрпН, родрпКро┤ро┐ро▒рпНроЪро╛ро▓рпИ
ЁЯСитАНЁЯОи => ЁЯСитАНЁЯОи, роУро╡ро┐ропро░рпН, роХро▓рпИ, роЖрогрпН, рокрпЖропро┐ройрпНроЯрпН
ЁЯСитАНЁЯЪТ => ЁЯСитАНЁЯЪТ, родрпАропрогрпИрокрпНрокрпБ, роЖрогрпН
ЁЯСитАНтЬИ => ЁЯСитАНтЬИ, ро╡ро┐рооро╛ройро┐, рокрпИро▓роЯрпН, роЖрогрпН
ЁЯСитАНЁЯЪА => ЁЯСитАНЁЯЪА, ро╡ро┐рогрпНро╡рпЖро│ро┐, ро░ро╛роХрпНроХрпЖроЯрпН, роЖрогрпН
ЁЯСитАНЁЯОд => ЁЯСитАНЁЯОд, рокро╛роЯроХро░рпН, роироЯро┐роХро░рпН, роЖрогрпН, рокрпКро┤рпБродрпБрокрпЛроХрпНроХрпБ
ЁЯСитАНЁЯТ╗ => ЁЯСитАНЁЯТ╗, роорпЖройрпНрокрпКро░рпБро│рпН, ро╡ро▓рпНро▓рпБроиро░рпН, роЖрогрпН
ЁЯСитАНЁЯФм => ЁЯСитАНЁЯФм, ро╡ро┐роЮрпНроЮро╛ройро┐, роЖрогрпН, роЕро▒ро┐ро╡ро┐ропро▓рпН
ЁЯСитАНЁЯТ╝ => ЁЯСитАНЁЯТ╝, рокрогро┐ропро╛ро│ро░рпН, роЕродро┐роХро╛ро░ро┐, роЕро▓рпБро╡ро▓роХроорпН, роЖрогрпН
ЁЯСитАНЁЯФз => ЁЯСитАНЁЯФз, роорпЖроХрпНроХро╛ройро┐роХрпН, роЖрогрпН
ЁЯСитАНтЪЦ => ЁЯСитАНтЪЦ, роирпАродро┐рокродро┐, роЪроЯрпНроЯроорпН, роЖрогрпН
ЁЯСй => ЁЯСй, роороХро│ро┐ро░рпН, роороХрпНроХро│рпН
ЁЯСйтАНтЪХ => ЁЯСйтАНтЪХ, роЯро╛роХрпНроЯро░рпН, рокрпЖрогрпН, рооро░рпБродрпНродрпБро╡ро░рпН
ЁЯСйтАНЁЯОУ => ЁЯСйтАНЁЯОУ, рооро╛рогро╡ро┐, рокроЯрпНроЯроорпН
ЁЯСйтАНЁЯМ╛ => ЁЯСйтАНЁЯМ╛, ро╡ро┐ро╡роЪро╛ропроорпН, ро╡ро┐ро╡роЪро╛ропро┐, рокрпЖрогрпН
ЁЯСйтАНЁЯН│ => ЁЯСйтАНЁЯН│, роЪроорпИропро▓рпН, рокрпЖрогрпН
ЁЯСйтАНЁЯПл => ЁЯСйтАНЁЯПл, роЖроЪро┐ро░ро┐ропро░рпН, рокрпЖрогрпН, рокро│рпНро│ро┐
ЁЯСйтАНЁЯПн => ЁЯСйтАНЁЯПн, родрпКро┤ро┐ро▓ро╛ро│ро┐, рокрпЖрогрпН, родрпКро┤ро┐ро▒рпНроЪро╛ро▓рпИ
ЁЯСйтАНЁЯОи => ЁЯСйтАНЁЯОи, роУро╡ро┐ропро░рпН, роХро▓рпИ, рокрпЖрогрпН, рокрпЖропро┐ройрпНроЯрпН
ЁЯСйтАНЁЯЪТ => ЁЯСйтАНЁЯЪТ, родрпАропрогрпИрокрпНрокрпБ, рокрпЖрогрпН
ЁЯСйтАНтЬИ => ЁЯСйтАНтЬИ, ро╡ро┐рооро╛ройро┐, рокрпИро▓роЯрпН, рокрпЖрогрпН
ЁЯСйтАНЁЯЪА => ЁЯСйтАНЁЯЪА, ро╡ро┐рогрпНро╡рпЖро│ро┐, ро░ро╛роХрпНроХрпЖроЯрпН, рокрпЖрогрпН
ЁЯСйтАНЁЯОд => ЁЯСйтАНЁЯОд, рокро╛роЯроХро░рпН, роироЯро┐роХро░рпН, рокрпЖрогрпН, рокрпКро┤рпБродрпБрокрпЛроХрпНроХрпБ
ЁЯСйтАНЁЯТ╗ => ЁЯСйтАНЁЯТ╗, роорпЖройрпНрокрпКро░рпБро│рпН, ро╡ро▓рпНро▓рпБроиро░рпН, рокрпЖрогрпН
ЁЯСйтАНЁЯФм => ЁЯСйтАНЁЯФм, ро╡ро┐роЮрпНроЮро╛ройро┐, рокрпЖрогрпН, роЕро▒ро┐ро╡ро┐ропро▓рпН
ЁЯСйтАНЁЯТ╝ => ЁЯСйтАНЁЯТ╝, рокрогро┐ропро╛ро│ро░рпН, роЕродро┐роХро╛ро░ро┐, роЕро▓рпБро╡ро▓роХроорпН, рокрпЖрогрпН
ЁЯСйтАНЁЯФз => ЁЯСйтАНЁЯФз, роорпЖроХрпНроХро╛ройро┐роХрпН, рокрпЖрогрпН
ЁЯСйтАНтЪЦ => ЁЯСйтАНтЪЦ, роирпАродро┐рокродро┐, роЪроЯрпНроЯроорпН, рокрпЖрогрпН
ЁЯС┤ => ЁЯС┤, ро╡ропродро╛ройро╡ро░рпН, рокрпЖро░ро┐ропро╡ро░рпН, родро╛родрпНродро╛, роороХрпНроХро│рпН
ЁЯС╡ => ЁЯС╡, ро╡ропродро╛ройро╡ро░рпН, рокрпЖро░ро┐ропро╡ро░рпН, рокро╛роЯрпНроЯро┐, роороХрпНроХро│рпН
ЁЯС╢ => ЁЯС╢, рокро╛рокрпНрокро╛, роХрпБроЯрпНроЯро┐рокрпНрокро╛рокрпНрокро╛, роХрпБроЯрпНроЯро┐рокрпНрокрпИропройрпН, роороХрпНроХро│рпН
ЁЯС▒ => ЁЯС▒, роороЮрпНроЪро│рпН роиро┐ро▒роорпН, рокрпКройрпН роиро┐ро▒роорпН, роороХрпНроХро│рпН, роорпБроЯро┐
ЁЯС▒тАНтЩА => ЁЯС▒тАНтЩА, рокрпКройрпНройро┐ройро┐ро▒роорпН, рокрпЖрогрпН, роорпБроЯро┐, роороЮрпНроЪро│рпН
ЁЯС▒тАНтЩВ => ЁЯС▒тАНтЩВ, рокрпКройрпНройро┐ройро┐ро▒роорпН, роЖрогрпН, роорпБроЯро┐, роороЮрпНроЪро│рпН
ЁЯСо => ЁЯСо, рокрпЛро▓рпАро╕рпН роЕродро┐роХро╛ро░ро┐, рокрпЛро▓рпАро╕рпН роЖрокро┐ро╕ро░рпН, роЕродро┐роХро╛ро░ро┐, роороХрпНроХро│рпН
ЁЯСотАНтЩА => ЁЯСотАНтЩА, роХро╛ро╡ро▓ро░рпН, рокрпЖрогрпН, роЕродро┐роХро╛ро░ро┐, роХро╛ро╡ро▓рпНродрпБро▒рпИ, рокрпЛро▓рпАро╕рпН
ЁЯСотАНтЩВ => ЁЯСотАНтЩВ, роХро╛ро╡ро▓ро░рпН, роЖрогрпН, роЕродро┐роХро╛ро░ро┐, роХро╛ро╡ро▓рпНродрпБро▒рпИ, рокрпЛро▓рпАро╕рпН
ЁЯС▓ => ЁЯС▓, роТроЯрпНроЯрпБродрпНродрпКрокрпНрокро┐ропрпБроЯройрпН роХрпВроЯро┐роп роЖрогрпН, роЖрогрпН, роороХрпНроХро│рпН, родрпКрокрпНрокро┐
ЁЯС│ => ЁЯС│, роЖрогрпН, роороХрпНроХро│рпН, родро▓рпИрокрпНрокро╛роХрпИ, роЯро░рпНрокройрпН
ЁЯС│тАНтЩА => ЁЯС│тАНтЩА, родро▓рпИрокрпНрокро╛роХрпИ, рокрпЖрогрпН
ЁЯС│тАНтЩВ => ЁЯС│тАНтЩВ, родро▓рпИрокрпНрокро╛роХрпИ, роЖрогрпН, роЪро┐роЩрпН
ЁЯС╖ => ЁЯС╖, роХроЯрпНроЯрпБрооро╛ройроорпН, родрпКро┤ро┐ро▓ро╛ро│ро┐, рокрогро┐ропро╛ро│ро░рпН, роороХрпНроХро│рпН
ЁЯС╖тАНтЩА => ЁЯС╖тАНтЩА, роХроЯрпНроЯрпБрооро╛ройроорпН, родрпКро┤ро┐ро▓ро╛ро│ро░рпН, родрпКро┤ро┐ро▓ро╛ро│ро┐, рокрпЖрогрпН
ЁЯС╖тАНтЩВ => ЁЯС╖тАНтЩВ, роХроЯрпНроЯрпБрооро╛ройроорпН, родрпКро┤ро┐ро▓ро╛ро│ро░рпН, родрпКро┤ро┐ро▓ро╛ро│ро┐, роЖрогрпН
тЫС => тЫС, ро╡рпЖро│рпНро│рпИ роиро┐ро▒ роХро┐ро░ро╛ро╕рпН роЙро│рпНро│ ро╣рпЖро▓рпНроорпЖроЯрпН
ЁЯС╕ => ЁЯС╕, родрпЗро╡родрпИроХрпН роХродрпИроХро│рпН, родрпЗро╡родрпИ, роороХрпНроХро│рпН, рокрпЖрогрпН
ЁЯТВ => ЁЯТВ, роХро╛ро╡ро▓ро░рпНроХро│рпН, роХро╛ро╡ро▓ро╛ро│ро┐, роороХрпНроХро│рпН
ЁЯТВтАНтЩА => ЁЯТВтАНтЩА, рокро╛родрпБроХро╛ро╡ро▓ро░рпН, рокрпЖрогрпН
ЁЯТВтАНтЩВ => ЁЯТВтАНтЩВ, рокро╛родрпБроХро╛ро╡ро▓ро░рпН, роЖрогрпН
ЁЯХ╡ => ЁЯХ╡, родрпБрокрпНрокро▒ро┐ро╡ро╛ро│ро░рпН, родрпБрокрпНрокро▒ро┐ропрпБроорпН роЪро╛роорпНрокрпБ
ЁЯХ╡тАНтЩА => ЁЯХ╡тАНтЩА, родрпБрокрпНрокро▒ро┐ро╡ро╛ро│ро░рпН, роиро┐рокрпБрогро░рпН, рокрпЖрогрпН
ЁЯХ╡тАНтЩВ => ЁЯХ╡тАНтЩВ, родрпБрокрпНрокро▒ро┐ро╡ро╛ро│ро░рпН, роиро┐рокрпБрогро░рпН, роЖрогрпН
ЁЯОЕ => ЁЯОЕ, родро╛родрпНродро╛, роХро┐ро▒ро┐ро╕рпНродрпБрооро╕рпН, рокро░ро┐роЪрпБ, роХрпКрогрпНроЯро╛роЯрпНроЯроорпН
ЁЯС╝ => ЁЯС╝, роПроЮрпНроЪро▓рпН, родрпЗро╡родрпИ, родрпЗро╡родрпИроХрпН роХродрпИ, роорпБроХроорпН
ЁЯСп => ЁЯСп, роорпБропро▓рпН роХро╛родрпБроХро│рпБроЯройрпН рокрпЖрогрпНроХро│рпН, роорпБропро▓рпН роХро╛родрпБроХро│рпН, рокрпЖрогрпН, роЗро│роорпНрокрпЖрогрпН, роороХрпНроХро│рпН, роХро╛родрпБроХро│рпН, роорпБропро▓рпН роХро╛родрпБроХро│рпН роЙро│рпНро│ рокрпЖрогрпНроХро│рпН
ЁЯСптАНтЩА => ЁЯСптАНтЩА, роироЯройроорпН, роЖроЯрпНроЯроорпН, рокрпЖрогрпНроХро│рпН, рокро╛ро░рпНроЯрпНроЯро┐, роХрпКрогрпНроЯро╛роЯрпНроЯроорпН
ЁЯСптАНтЩВ => ЁЯСптАНтЩВ, роироЯройроорпН, роЖроЯрпНроЯроорпН, роЖрогрпНроХро│рпН, рокро╛ро░рпНроЯрпНроЯро┐, роХрпКрогрпНроЯро╛роЯрпНроЯроорпН
ЁЯТЖ => ЁЯТЖ, роороЪро╛роЬрпН, роЪро▓рпВройрпН, роорпБроХроорпН, роЕро┤роХрпБ
ЁЯТЖтАНтЩА => ЁЯТЖтАНтЩА, родро▓рпИ, роороЪро╛роЬрпН, рокрпЖрогрпН, роЪро▓рпВройрпН
ЁЯТЖтАНтЩВ => ЁЯТЖтАНтЩВ, родро▓рпИ, роороЪро╛роЬрпН, роЖрогрпН, роЪро▓рпВройрпН
ЁЯТЗ => ЁЯТЗ, роЕро┤роХрпБроиро┐ро▓рпИропроорпН, роЕро┤роХрпБ, роорпБроЯро┐, ро╣рпЗро░рпН роХроЯрпН, рокро┐ропрпВроЯрпНроЯро┐ рокро╛ро░рпНро▓ро░рпН, рокро╛ро░рпНро▓ро░рпН
ЁЯТЗтАНтЩА => ЁЯТЗтАНтЩА, родро▓рпИроорпБроЯро┐, рокро╛ро░рпНро▓ро░рпН, рокрпЖрогрпН, ро╣рпЗро░рпН роХроЯрпН
ЁЯТЗтАНтЩВ => ЁЯТЗтАНтЩВ, родро▓рпИроорпБроЯро┐, рокро╛ро░рпНро▓ро░рпН, роЖрогрпН, ро╣рпЗро░рпН роХроЯрпН
ЁЯС░ => ЁЯС░, роорпБроХрпНроХро╛роЯрпБ роЕрогро┐роирпНрод родро┐ро░рпБроорог рокрпЖрогрпН, родро┐ро░рпБроорогроорпН, роороХрпНроХро│рпН
ЁЯЩН => ЁЯЩН, ро╡ро░рпБродрпНродроорпН, ро╡ро░рпБродрпНродродрпНродрпИродрпН родрпЖро░ро┐ро╡ро┐родрпНродро▓рпН
ЁЯЩНтАНтЩА => ЁЯЩНтАНтЩА, ро╡ро░рпБродрпНродроорпН, рокрпЖрогрпН, роЕро┤рпБроХрпИ, роХро╡ро▓рпИ
ЁЯЩНтАНтЩВ => ЁЯЩНтАНтЩВ, ро╡ро░рпБродрпНродроорпН, роЖрогрпН, роЕро┤рпБроХрпИ, роХро╡ро▓рпИ
ЁЯЩО => ЁЯЩО, роХрпЛрокроорпН, роХрпЛрокродрпНродрпИроХрпН роХро╛роЯрпНроЯрпБродро▓рпН
ЁЯЩОтАНтЩА => ЁЯЩОтАНтЩА, роХрпЛрокроорпН, рокрпЖрогрпН, роЪро┐ройроорпН, роЖродрпНродро┐ро░роорпН
ЁЯЩОтАНтЩВ => ЁЯЩОтАНтЩВ, роХрпЛрокроорпН, роЖрогрпН, роЪро┐ройроорпН, роЖродрпНродро┐ро░роорпН
ЁЯЩЕ => ЁЯЩЕ, ро╡рпЗрогрпНроЯро╛роорпН, роЗро▓рпНро▓рпИ, роорпБроЯро┐роирпНродродрпБ, роЪрпИроХрпИ
ЁЯЩЕтАНтЩА => ЁЯЩЕтАНтЩА, рооро▒рпБ, роЪрпЖропрпНропро╛родрпЗ, рокрпЖрогрпН, ро╡рпЗрогрпНроЯро╛роорпН
ЁЯЩЕтАНтЩВ => ЁЯЩЕтАНтЩВ, рооро▒рпБ, роЪрпЖропрпНропро╛родрпЗ, роЖрогрпН, ро╡рпЗрогрпНроЯро╛роорпН
ЁЯЩЖ => ЁЯЩЖ, роЪро░ро┐, роУроХрпЗ, роЪро░ро┐ роЪрпИроХрпИ
ЁЯЩЖтАНтЩА => ЁЯЩЖтАНтЩА, родро▓рпИ, роХрпИ, рокрпЖрогрпН
ЁЯЩЖтАНтЩВ => ЁЯЩЖтАНтЩВ, родро▓рпИ, роХрпИ, роЖрогрпН
ЁЯТБ => ЁЯТБ, ро╡ро┤ро┐роХро╛роЯрпНроЯрпБрокро╡ро░рпН, роЙродро╡ро┐, ро╡ро┤ро┐роХро╛роЯрпНроЯро▓рпН, родроХро╡ро▓рпН, роороХрпНроХро│рпН
ЁЯТБтАНтЩА => ЁЯТБтАНтЩА, ро╡ро░ро╡рпЗро▒рпНрокро╛ро│ро░рпН, рокрпЖрогрпН, роЙродро╡ро┐
ЁЯТБтАНтЩВ => ЁЯТБтАНтЩВ, ро╡ро░ро╡рпЗро▒рпНрокро╛ро│ро░рпН, роЖрогрпН, роЙродро╡ро┐
ЁЯЩЛ => ЁЯЩЛ, роороХро┐ро┤рпНроЪрпНроЪро┐ роЪро┐ройрпНройроорпН
ЁЯЩЛтАНтЩА => ЁЯЩЛтАНтЩА, роХрпИ, роЙропро░рпНродрпНродрпБродро▓рпН, рокрпЖрогрпН
ЁЯЩЛтАНтЩВ => ЁЯЩЛтАНтЩВ, роХрпИ, роЙропро░рпНродрпНродрпБродро▓рпН, роЖрогрпН
ЁЯЩЗ => ЁЯЩЗ, рооройрпНройро┐родрпНродрпБро╡ро┐роЯрпБроЩрпНроХро│рпН, рооройрпНройро┐роХрпНроХро╡рпБроорпН, рооройрпНройро┐родрпНродрпБро╡ро┐роЯрпБ, рооройрпНройро┐рокрпНрокрпБ, роЪро╛ро░ро┐, роЪрпИроХрпИ, рооройро┐родройрпН
ЁЯЩЗтАНтЩА => ЁЯЩЗтАНтЩА, рооройрпНройро┐рокрпНрокрпБ, рооройрпНройро┐родрпНродрпБро╡ро┐роЯрпБ, роЪро╛ро░ро┐, рокрпЖрогрпН
ЁЯЩЗтАНтЩВ => ЁЯЩЗтАНтЩВ, рооройрпНройро┐рокрпНрокрпБ, рооройрпНройро┐родрпНродрпБро╡ро┐роЯрпБ, роЪро╛ро░ро┐, роЖрогрпН
ЁЯЩМ => ЁЯЩМ, роороХро┐ро┤рпНроЪрпНроЪро┐ роЪро┐ройрпНройроорпН
ЁЯЩП => ЁЯЩП, рокрпЛродрпБроороЯро╛ роЪро╛рооро┐ роОройрпНрокродрпИроХрпН роХрпБро▒ро┐роХрпНроХрпБроорпН роЪро┐ройрпНройроорпН, ро╡ро┐роЯрпНроЯрпБро╡ро┐роЯрпБ роОройрпНрокродрпИроХрпН роХрпБро▒ро┐роХрпНроХрпБроорпН роЪро┐ройрпНройроорпН, ро╡ро┤ро┐рокроЯрпБродро▓рпН, ро╡ро┤ро┐рокро╛роЯрпБ, роХрпИ, роЪрпИроХрпИ
ЁЯЧг => ЁЯЧг, рокрпЗроЪрпБродро▓рпН, рокрпЗроЪрпБ, родро▓рпИ, роорпБроХроорпН, роиро┐ро┤ро▓рпН рокроЯроорпН
ЁЯСд => ЁЯСд, рооро╛ро░рпНрокро│ро╡рпБ ро╡ро░рпИ роиро┐ро┤ро▓рпН рокроЯроорпН, рооро╛ро░рпНрокрпБ, роиро┐ро┤ро▓рпН рокроЯроорпН, роороХрпНроХро│рпН
ЁЯСе => ЁЯСе, рооро╛ро░рпНрокрпБ, роиро┐ро┤ро▓рпНрокроЯроорпН, роороХрпНроХро│рпН
ЁЯЪ╢ => ЁЯЪ╢, роироЯроирпНродрпБ роЪрпЖро▓рпНрокро╡ро░рпНроХро│рпН, роироЯроирпНродрпБ роЪрпЖро▓рпНро▓рпБродро▓рпН, рокро╛родроЪро╛ро░ро┐роХро│рпН, роироЯро░ро╛роЬро╛, рокрпЛроХро┐ро▒рпЗройрпН
ЁЯЪ╢тАНтЩА => ЁЯЪ╢тАНтЩА, роироЯрпИ, рокрпЖрогрпН, рокрпЛроХро┐ро▒рпЗройрпН, рокро╛родроЪро╛ро░ро┐роХро│рпН, ро╡ро╛роХрпНроХро┐роЩрпН
ЁЯЪ╢тАНтЩВ => ЁЯЪ╢тАНтЩВ, роироЯрпИ, роЖрогрпН, рокрпЛроХро┐ро▒рпЗройрпН, рокро╛родроЪро╛ро░ро┐роХро│рпН, ро╡ро╛роХрпНроХро┐роЩрпН
ЁЯПГ => ЁЯПГ, роУроЯрпНроЯрокрпНрокроирпНродропроорпН, рооро╛ро░родрпНродро╛ройрпН, ро╡ро┐ро│рпИропро╛роЯрпНроЯрпБ
ЁЯПГтАНтЩА => ЁЯПГтАНтЩА, роУроЯрпНроЯроорпН, рокрпЖрогрпН
ЁЯПГтАНтЩВ => ЁЯПГтАНтЩВ, роУроЯрпНроЯроорпН, роЖрогрпН
ЁЯТГ => ЁЯТГ, роЯро╛ройрпНроЪро░рпН, роороХро┐ро┤рпНроЪрпНроЪро┐, роироЯройроХрпНроХро▓рпИроЮро░рпН, роЖроЯрпНроЯроХрпНроХро╛ро░ро░рпН, роороХрпНроХро│рпН
ЁЯХ┤ => ЁЯХ┤, рооройро┐родройрпН, роЪрпВроЯрпН роЕрогро┐роирпНродро╡ро░рпН
ЁЯТП => ЁЯТП, роорпБродрпНродроорпН, роороХрпНроХро│рпН, роХрпЖрооро┐ро╕рпНроЯрпНро░ро┐, ро░рпКрооро╛ройрпНро╕рпН, роХро╛родро▓рпН
ЁЯТС => ЁЯТС, роороХро┐ро┤рпНроЪрпНроЪро┐ропро╛рой роЗро▓рпНро▓ро▒ роЬрпЛроЯро┐роХро│рпН, роХро╛родро▓ро┐ро▓рпН родро┐ро│рпИроХрпНроХрпБроорпН роЗро░рпБро╡ро░рпН, роЗродропроорпН, роХро╛родро▓рпН, роороХрпНроХро│рпН, ро░рпКрооро╛ройрпНро╕рпН
ЁЯСк => ЁЯСк, роЕрокрпНрокро╛, роЕроорпНрооро╛, роХрпБро┤роирпНродрпИ, роороХрпНроХро│рпН, родроирпНродрпИ, родро╛ропрпН
ЁЯСл => ЁЯСл, роЖрогрпБроорпН рокрпЖрогрпНрогрпБроорпН, роЗро░рпБро╡ро░рпН, роЖрогрпН, рокрпЖрогрпН, роЖрогрпБроорпН рокрпЖрогрпНрогрпБроорпН роХрпИроХрпЛро░рпНродрпНродро▓рпН, роХро╛родро▓ро░рпНроХро│рпН
ЁЯСм => ЁЯСм, роЗро░рпБ роЖрогрпНроХро│рпН, роЗро░рпБро╡ро░рпН, роЗро░рпБ роЖрогрпНроХро│рпН роХрпИроХрпЛро░рпНродрпНродро▓рпН, роЖрогрпН, роороХрпНроХро│рпН, родрпЛро┤ро░рпНроХро│рпН, роирогрпНрокро░рпНроХро│рпН
ЁЯСн => ЁЯСн, роЗро░рпБ роЖрогрпНроХро│рпН, роЗро░рпБро╡ро░рпН, роХрпИроХрпЛро░рпНродрпНрод роЗро░рпБ роЖрогрпНроХро│рпН, роЗро░рпБ роЖрогрпНроХро│рпН роХрпИроХрпЛро░рпНродрпНродро▓рпН, роЖрогрпН, роороХрпНроХро│рпН, родрпЛро┤ро┐роХро│рпН
ЁЯП╗ => ЁЯП╗, родрпЛро▓ро┐ройрпН роиро┐ро▒роорпН
ЁЯП╝ => ЁЯП╝, родрпЛро▓ро┐ройрпН роиро┐ро▒роорпН
ЁЯП╜ => ЁЯП╜, родрпЛро▓ро┐ройрпН роиро┐ро▒роорпН
ЁЯП╛ => ЁЯП╛, родрпЛро▓ро┐ройрпН роиро┐ро▒роорпН
ЁЯП┐ => ЁЯП┐, родрпЛро▓ро┐ройрпН роиро┐ро▒роорпН
ЁЯТк => ЁЯТк, роЗро░рпБродро▓рпИ родроЪрпИ, ро╡ро▓рпБро╡ро╛рой роХрпИроХро│рпН, ро╡ро▓ро┐роорпИ, роироХрпИроЪрпНроЪрпБро╡рпИ
ЁЯСИ => ЁЯСИ, роЗроЯродрпБроирпЛроХрпНроХро┐роп ро╡ро┐ро░ро▓рпН, роЖро│рпНроХро╛роЯрпНроЯро┐ ро╡ро┐ро░ро▓рпН, ро╡ро┐ро░ро▓рпН
ЁЯСЙ => ЁЯСЙ, ро╡ро▓родрпБроирпЛроХрпНроХро┐роп ро╡ро┐ро░ро▓рпН, роЖро│рпНроХро╛роЯрпНроЯро┐ ро╡ро┐ро░ро▓рпН, ро╡ро┐ро░ро▓рпН
тШЭ => тШЭ, роорпЗро▓рпНроирпЛроХрпНроХро┐роп ро╡ро┐ро░ро▓рпН, ро╡ро┐ро░ро▓рпН, роорпЗро▓рпЗ
ЁЯСЖ => ЁЯСЖ, роорпЗро▓рпНроирпЛроХрпНроХро┐роп ро╡ро┐ро░ро▓рпН, роорпЗро▓рпН роирпЛроХрпНроХро┐ роХро╛роЯрпНроЯрпБроорпН ро╡ро┐ро░ро▓рпН, роЖро│рпНроХро╛роЯрпНроЯро┐ ро╡ро┐ро░ро▓рпН, ро╡ро┐ро░ро▓рпН
ЁЯЦХ => ЁЯЦХ, роироЯрпБро╡ро┐ро▓рпН
ЁЯСЗ => ЁЯСЗ, роХрпАро┤рпНроирпЛроХрпНроХро┐роп ро╡ро┐ро░ро▓рпН, роХрпАро┤рпН роирпЛроХрпНроХро┐ роХро╛роЯрпНроЯрпБроорпН ро╡ро┐ро░ро▓рпН, роЖро│рпНроХро╛роЯрпНроЯро┐ ро╡ро┐ро░ро▓рпН, ро╡ро┐ро░ро▓рпН, роХрпАро┤рпЗ
тЬМ => тЬМ, ро╡рпЖро▒рпНро▒ро┐, ро╡рпЖро▒рпНро▒ро┐ роЪро┐ройрпНройроорпН, роЪрпИроХрпИ, роЕроЯрпИропро╛ро│роорпН
ЁЯЦЦ => ЁЯЦЦ, роЪро▓рпНропрпВроЯрпН
ЁЯдШ => ЁЯдШ, роЕроЪродрпНродро┐роЯрпАроЩрпНроХ, роХрпКроорпНрокрпБ рокрпЛройрпНро▒ роЪрпИроХрпИ
ЁЯЦР => ЁЯЦР, роРроирпНродрпБ ро╡ро┐ро░ро▓рпНроХро│рпН, роЪрпИроХрпИ
тЬК => тЬК, роЪрпИроХрпИ, роЕроЯрпИропро╛ро│роорпН
тЬЛ => тЬЛ, роХрпИроХро│рпИроХрпН роХро╛роЯрпНроЯрпБродро▓рпН, роЪрпИроХрпИ, роЕроЯрпИропро╛ро│роорпН
ЁЯСК => ЁЯСК, роХрпБродрпНродрпБ, роХрпБродрпНродрпБ роЪро┐ройрпНройроорпН, роХрпИ
ЁЯСМ => ЁЯСМ, роТроХрпЗ, роЪро░ро┐ роОройрпНрокродрпИроХрпН роХрпБро▒ро┐роХрпНроХрпБроорпН роЪро┐ройрпНройроорпН, роЪро░ро┐, роХрпИ, роЪро┐ройрпНройроорпН, роЪрпВрокрпНрокро░рпН роЪро┐ройрпНройроорпН
ЁЯСН => ЁЯСН, роорпБроЯро┐роирпНродродрпБ, рокрпЖро░рпБро╡ро┐ро░ро▓рпН, роЪро┐ройрпНройроорпН, ро╡рпЖро▒рпНро▒ро┐, ро╡рпЖро▒рпНро▒ро┐ роЪро┐ройрпНройроорпН
ЁЯСО => ЁЯСО, рокрпЖро░рпБро╡ро┐ро░ро▓рпН, роЪро┐ройрпНройроорпН, роиройрпНро▒ро╛роХ роЗро▓рпНро▓рпИ, родрпЛро▓рпНро╡ро┐, родрпЛро▓рпНро╡ро┐ роЪро┐ройрпНройроорпН
ЁЯСЛ => ЁЯСЛ, роХрпИропроЪрпИроХрпНроХрпБроорпН роЪро┐ройрпНройроорпН, роХрпИ, роЪро┐ройрпНройроорпН, роЯро╛роЯрпНроЯро╛
ЁЯСП => ЁЯСП, роХрпИ родроЯрпНроЯрпБродро▓рпН, роХрпИроХро│рпН, родроЯрпНроЯрпБродро▓рпН, роЪро┐ройрпНройроорпН
ЁЯСР => ЁЯСР, ро╡ро┐ро░ро┐родрпНрод роХрпИроХро│рпН, роЕрогрпИрокрпНрокрпБ, роХрпИроХро│рпН, родро┐ро▒роирпНрод роХрпИроХро│рпН, роЪро┐ройрпНройроорпН
тЬН => тЬН, роОро┤рпБродрпБ
ЁЯТЕ => ЁЯТЕ, роироХроорпН, роирпЖропро┐ро▓рпН рокро╛ро▓ро┐ро╕рпН, роЕро┤роХрпБроЪрпНроЪро╛родройроорпН, роЕро▓роЩрпНроХро╛ро░роорпН, роироХрокрпН рокро░ро╛рооро░ро┐рокрпНрокрпБ, роХрпИро╡ро┐ро░ро▓рпН роТрокрпНрокройрпИроХрпН роХро▓рпИ, роорпЗройро┐ роХрпБропрпВро░рпН
ЁЯСВ => ЁЯСВ, роЙроЯро▓рпН, роЙроЯро▓рпН роЙро▒рпБрокрпНрокрпБ
ЁЯСГ => ЁЯСГ, роорпБроХроорпН, роЙроЯро▓рпН, роЙроЯро▓рпН роЙро▒рпБрокрпНрокрпБ
ЁЯСг => ЁЯСг, роХро╛ро▓роЯро┐ родроЯроорпН, роХро╛ро▓роЯро┐ роЕроЪрпНроЪрпБ, рокро╛родроорпН, роЕроЪрпНроЪрпБ, роЙроЯро▓рпН, рокро╛родрпИ, ро╡ро┤ро┐
ЁЯСА => ЁЯСА, роХрогрпН, роорпБроХроорпН, роЙроЯро▓рпН роЙро▒рпБрокрпНрокрпБ
ЁЯСБ => ЁЯСБ, роорпБроХроорпН, роЙроЯро▓рпН роЙро▒рпБрокрпНрокрпБ, рокро╛ро░рпНро╡рпИ
ЁЯСБтАНЁЯЧи => ЁЯСБтАНЁЯЧи, рокрпЗроЪрпНроЪрпБроХрпН роХрпБрооро┐ро┤ро┐, роХрогрпН
ЁЯСЕ => ЁЯСЕ, роорпБроХроорпН, роЙроЯро▓рпН, роЙроЯро▓рпН роЙро▒рпБрокрпНрокрпБ
ЁЯСД => ЁЯСД, роЙродроЯрпБроХро│рпН, роЪро┐ро╡рокрпНрокрпБ роЙродроЯрпБроХро│рпН, роЙроЯро▓рпН, роЙроЯро▓рпН роЙро▒рпБрокрпНрокрпБ, роорпБроХроорпН
ЁЯТЛ => ЁЯТЛ, роЙродроЯрпБроХро│рпН, роорпБродрпНродроЪрпН роЪро┐ройрпНройроорпН, ро░рпКрооро╛ройрпНро╕рпН, роХро┐ро╕рпН, роХро╛родро▓рпН
ЁЯТШ => ЁЯТШ, роЕроорпНрокрпБроХрпНроХрпБро▒ро┐ роОропрпНрод роЗродропроорпН, роЕроорпНрокрпБ, роХро╛родро▓рпН, роЙрогро░рпНро╡рпБ, роЙрогро░рпНроЪрпНроЪро┐, роЗродропроорпН
тЭд => тЭд, роЪро┐ро╡рокрпНрокрпБ, роЗродропроорпН, роЪро┐ро╡рокрпНрокрпБ роЗродропроорпН
ЁЯТУ => ЁЯТУ, родрпБроЯро┐родрпНродро▓рпН, роЗродропроорпН, роХро╛родро▓рпН, ро░рпКрооро╛ройрпНро╕рпН, роЙрогро░рпНро╡рпБ, роЙрогро░рпНроЪрпНроЪро┐
ЁЯТФ => ЁЯТФ, роЙроЯрпИроирпНрод роЗродропроорпН, родрпБрогрпНроЯро╛рой роЗродропроорпН, рокро┐ро░рпЗроХрпН роЕрокрпН, роХро╛родро▓рпН роорпБро▒ро┐роирпНродрпБро╡ро┐роЯрпНроЯродрпБ, роЗродропроорпН, роХро╛родро▓рпН, ро░рпКрооро╛ройрпНро╕рпН, роЙрогро░рпНро╡рпБ, роЙрогро░рпНроЪрпНроЪро┐
ЁЯТХ => ЁЯТХ, роХро╛родро▓ро░рпНроХро│рпН, роХро╛родро▓рпН, роЙрогро░рпНро╡рпБ, роЙрогро░рпНроЪрпНроЪро┐, роЗродропроорпН
ЁЯТЦ => ЁЯТЦ, рооро┐ройрпНройрпБроорпН роЗродропроорпН, рокроЯрокроЯродрпНродро▓рпН, роЙрогро░рпНро╡рпБ, роЙрогро░рпНроЪрпНроЪро┐, роХро╛родро▓рпН, роЗродропроорпН
ЁЯТЧ => ЁЯТЧ, ро╡ро┐ро░ро┐ро╡роЯрпИропрпБроорпН роЗродропроорпН, родропроХрпНроХроорпН, рокроЯрокроЯродрпНродро▓рпН, роЙрогро░рпНро╡рпБ, роЙрогро░рпНроЪрпНроЪро┐, роЗродропроорпН
ЁЯТЩ => ЁЯТЩ, роирпАро▓роорпН, роЗродропроорпН, роХро╛родро▓рпН, роЙрогро░рпНро╡рпБ, роЙрогро░рпНроЪрпНроЪро┐
ЁЯТЪ => ЁЯТЪ, рокроЪрпНроЪрпИ, роЗродропроорпН, роХро╛родро▓рпН, роЙрогро░рпНро╡рпБ, роЙрогро░рпНроЪрпНроЪро┐
ЁЯТЫ => ЁЯТЫ, роороЮрпНроЪро│рпН, роЗродропроорпН, роХро╛родро▓рпН, роЙрогро░рпНро╡рпБ, роЙрогро░рпНроЪрпНроЪро┐
ЁЯТЬ => ЁЯТЬ, рокро░рпНрокро┐ро│рпН, роЗродропроорпН, роХро╛родро▓рпН, роЙрогро░рпНро╡рпБ, роЙрогро░рпНроЪрпНроЪро┐
ЁЯТЭ => ЁЯТЭ, роЗродропроорпН, ро░ро┐рокрпНрокройрпН, роХро╛родро▓ро░рпНроХро│рпН, роХро╛родро▓рпН, роЙрогро░рпНро╡рпБ, роЙрогро░рпНроЪрпНроЪро┐
ЁЯТЮ => ЁЯТЮ, роЗродропроорпН, роЪрпБро▒рпНро▒рпБродро▓рпН, роХро╛родро▓рпН, роЕро▒рпНрокрпБродроорпН, роЙрогро░рпНро╡рпБ, роЙрогро░рпНроЪрпНроЪро┐
ЁЯТЯ => ЁЯТЯ, роЗродропроорпН, роЕро▓роЩрпНроХро╛ро░роорпН
тЭг => тЭг, роЕродро┐роХ роХро╛родро▓рпН, роХро╛родро▓рпН, роЙрогро░рпНроЪрпНроЪро┐, роЙрогро░рпНро╡рпБ
ЁЯТМ => ЁЯТМ, роЗродропродрпНродрпБроЯройрпН роЕройрпБрокрпНрокрокрпНрокроЯрпБроорпН роХроЯро┐родроорпН, роЗродропроорпН, роХро╛родроорпН, ро░рпКрооро╛ройрпНро╕рпН, роХрпЖрооро┐ро╕рпНроЯрпНро░ро┐, ро▓ро╡рпН ро▓рпЖроЯрпНроЯро░рпН
ЁЯТд => ЁЯТд, родрпВроЩрпНроХрпБродро▓рпН, роХрпБро▒роЯрпНроЯрпИ, роХрпБро▒роЯрпНроЯрпИ ро╡ро┐роЯрпБродро▓рпН, роироХрпИроЪрпНроЪрпБро╡рпИ, роЙрогро░рпНроЪрпНроЪро┐, роЙрогро░рпНро╡рпБ
ЁЯТв => ЁЯТв, роЪро┐ройроорпН, роЪрпАро▒рпНро▒роорпН, роироХрпИроЪрпНроЪрпБро╡рпИ, роЙрогро░рпНроЪрпНроЪро┐, роЙрогро░рпНро╡рпБ
ЁЯТг => ЁЯТг, рокро╛роорпНрокрпН, роХрпБрогрпНроЯрпБ, рокроЯрпНроЯро╛роЪрпБ, роироХрпИроЪрпНроЪрпБро╡рпИ, роЙрогро░рпНроЪрпНроЪро┐, роЙрогро░рпНро╡рпБ
ЁЯТе => ЁЯТе, ро╡рпЖроЯро┐родрпНродро▓рпН роЪро┐ройрпНройроорпН, роироХрпИроЪрпНроЪрпБро╡рпИ, роЙрогро░рпНроЪрпНроЪро┐, роЙрогро░рпНро╡рпБ
ЁЯТж => ЁЯТж, ро╡ро┐ропро░рпНро╡рпИроХрпН роХрпКроЯрпНроЯрпБродро▓рпН, ро╡ро┐ропро░рпНро╡рпИ, ро╡ро┐ропро░рпНродрпНродрпБроХрпНроХрпКроЯрпНроЯрпБродро▓рпН, роироХрпИроЪрпНроЪрпБро╡рпИ, роЙрогро░рпНроЪрпНроЪро┐, роЙрогро░рпНро╡рпБ
ЁЯТи => ЁЯТи, ро╡ро┐ро┤рпБроирпНродроЯро┐родрпНродрпБ роУроЯрпБродро▓рпН, роУроЯрпБродро▓рпН, роироХрпИроЪрпНроЪрпБро╡рпИ, роЙрогро░рпНроЪрпНроЪро┐, роЙрогро░рпНро╡рпБ
ЁЯТл => ЁЯТл, родро▓рпИроЪрпНроЪрпБро▒рпНро▒ро▓рпН, роироЯрпНроЪродрпНродро┐ро░роЩрпНроХро│рпН, роироЯрпНроЪродрпНродро┐ро░роорпН, роироХрпИроЪрпНроЪрпБро╡рпИ, роЙрогро░рпНроЪрпНроЪро┐, роЙрогро░рпНро╡рпБ
ЁЯТм => ЁЯТм, рокрпЗроЪрпНроЪрпБ роХрпБрооро┐ро┤рпН, роЙро░рпИропро╛роЯро▓рпН роХрпБрооро┐ро┤рпН, рокро▓рпВройрпН, роХрпБрооро┐ро┤рпН, роЙро░рпИропро╛роЯро▓рпН, роироХрпИроЪрпНроЪрпБро╡рпИ
ЁЯЧи => ЁЯЧи, рокрпЗроЪрпНроЪрпБро╡роЯро┐ро╡роХрпН роХрпБрооро┐ро┤рпН
ЁЯЧп => ЁЯЧп, роХрпЛрокроХрпН роХрпБрооро┐ро┤рпН
ЁЯТн => ЁЯТн, роЪро┐роирпНродройрпИ роХрпБрооро┐ро┤рпН, роЪро┐роирпНродройрпИ, роХрпБрооро┐ро┤рпН, роироХрпИроЪрпНроЪрпБро╡рпИ
ЁЯХ│ => ЁЯХ│, роХрпБро┤ро┐, рокро│рпНро│роорпН
ЁЯСУ => ЁЯСУ, роХрогрпНрогро╛роЯро┐роХро│рпН, роорпВроХрпНроХрпБроХрпН роХрогрпНрогро╛роЯро┐, роХрогрпНрогро╛роЯро┐, роЖроЯрпИ роЕрогро┐роХро▓ройрпН
ЁЯХ╢ => ЁЯХ╢, роЪройрпНроХро┐ро│ро╛ро╕рпНроХро│рпН, роХро░рпБрокрпНрокрпБроХрпН роХрогрпНрогро╛роЯро┐
ЁЯСФ => ЁЯСФ, роЯрпИ, родрпБрогро┐, роЖроЯрпИ роЕрогро┐роХро▓ройрпН
ЁЯСХ => ЁЯСХ, роЪро░рпНроЯрпН, роЖроЯрпИ роЕрогро┐роХро▓ройрпН
ЁЯСЦ => ЁЯСЦ, роЯро┐ро░ро╡рпБроЪро░рпНро╕рпН, рокрпЗройрпНроЯрпН, роХро╛ро▒рпНроЪроЯрпНроЯрпИ, роЖроЯрпИроХро│рпН
ЁЯСЧ => ЁЯСЧ, роЙроЯрпИ, роЖроЯрпИроХро│рпН, роЖроЯрпИ роЕрогро┐роХро▓ройрпН, рокрпЖрогрпНроХро│рпН роЙроЯрпИ, роЯро┐ро░ро╕рпН
ЁЯСШ => ЁЯСШ, роЖроЯрпИ, роЙроЯрпИроХро│рпН, роЖроЯрпИ роЕрогро┐роХро▓ройрпН
ЁЯСЩ => ЁЯСЩ, рокро┐роХро┐ройро┐ роЙроЯрпИ, роХрпБро│ро┐рокрпНрокродро▒рпНроХро╛рой роЖроЯрпИ, роирпАроЪрпНроЪро▓рпБроЯрпИ, роЖроЯрпИ роЕрогро┐роХро▓ройрпН
ЁЯСЪ => ЁЯСЪ, рокрпЖрогрпНроХро│рпН роЖроЯрпИроХро│рпН, роЖроЯрпИроХро│рпН, рокрпЖрогрпНроХро│рпН, роЙроЯрпИроХро│рпН, роЖроЯрпИ роЕрогро┐роХро▓ройрпН
ЁЯСЫ => ЁЯСЫ, рокрогрокрпНрокрпИ, рокрпИ, рокрогроорпН, роорогро┐ рокро░рпНро╕рпН, роЖроЯрпИ роЕрогро┐роХро▓ройрпН
ЁЯСЬ => ЁЯСЬ, роХрпИрокрпНрокрпИ, рокрпИ, рокрпЗроХрпН, роЖроЯрпИ роЕрогро┐роХро▓ройрпН
ЁЯСЭ => ЁЯСЭ, рокрпИ, роЖроЯрпИ роЕрогро┐роХро▓ройрпН
ЁЯЫН => ЁЯЫН, ро╖ро╛рокрпНрокро┐роЩрпН рокрпЗроХрпНроХрпБроХро│рпН, ро╖ро╛рокрпНрокро┐роЩрпН, рокро┐роХрпН ро╖ро╛рокрпНрокро░рпН рокрпЗроХрпН
ЁЯОТ => ЁЯОТ, рокрпИ, рокро│рпНро│ро┐роХрпНроХрпВроЯроорпН, рооро╛рогро╡ро░рпНроХро│рпН
ЁЯСЮ => ЁЯСЮ, ро╖рпВ, роЖроЯрпИ роЕрогро┐роХро▓ройрпН, роЖрогрпНроХро│рпН
ЁЯСЯ => ЁЯСЯ, ро╖рпВ, рооро┐ро░рпБродрпБро╡ро╛рой ро╖рпВ, роЖроЯрпИ роЕрогро┐роХро▓ройрпН
ЁЯСа => ЁЯСа, роХрпБродрпНродрпБроХрпНроХро╛ро▓рпН, ро╣рпИ ро╣рпАро▓рпН, ро╣рпАро▓рпН, рокрпЖрогрпНроХро│рпН, роЖроЯрпИ роЕрогро┐роХро▓ройрпН
ЁЯСб => ЁЯСб, роЪрпЖро░рпБрокрпНрокрпБ, роЪро╛рогрпНроЯро▓рпН, рокрпЖрогрпНроХро│рпН, роЖроЯрпИ роЕрогро┐роХро▓ройрпН
ЁЯСв => ЁЯСв, рокрпВроЯрпН, рокрпЖрогрпНроХро│рпН, роЖроЯрпИ роЕрогро┐роХро▓ройрпН
ЁЯСС => ЁЯСС, роороХрпБроЯроорпН, роЖроЯрпИ роЕрогро┐роХро▓ройрпН
ЁЯСТ => ЁЯСТ, родрпКрокрпНрокро┐, роЖроЯрпИ роЕрогро┐роХро▓ройрпН
ЁЯОй => ЁЯОй, родрпКрокрпНрокро┐, рокрпКро┤рпБродрпБрокрпЛроХрпНроХрпБ, роорпЗроЬро┐роХрпН, роЖрогрпН
ЁЯОУ => ЁЯОУ, родрпКрокрпНрокро┐, рокроЯрпНроЯрооро│ро┐рокрпНрокрпБ, роХро▓рпНро▓рпВро░ро┐, роХрпКрогрпНроЯро╛роЯрпНроЯроорпН, ро╡ро┐ро┤ро╛
ЁЯУ┐ => ЁЯУ┐, рокро┐ро░ро╛ро░рпНродрпНродройрпИроХрпНроХро╛рой роорогро┐роХро│рпН, роЕрогро┐роХро▓ройрпН
ЁЯТД => ЁЯТД, ро▓ро┐рокрпНро╕рпН ро╕рпНроЯро┐роХрпН, роЙродроЯрпНроЯрпБроЪрпНроЪро╛ропроорпН, роЕро┤роХрпБроЪрпНроЪро╛родройроорпН, роЕро▓роЩрпНроХро╛ро░роорпН, роЙродроЯрпБ
ЁЯТН => ЁЯТН, роиро┐роЪрпНроЪропродрпНродро╛ро░рпНродрпНродроорпН, родро┐ро░рпБроорогроорпН, роХро╛родро▓рпН, ро░рпКрооро╛ройрпНро╕рпН
ЁЯТО => ЁЯТО, ро░родрпНродро┐ройроХрпН роХро▓рпН, роЕродро┐ро░рпНро╖рпНроЯроХрпН роХро▓рпН, ро╡рпИро░роорпН, роХро╛родро▓рпН, ро░рпКрооро╛ройрпНро╕рпН, роХро╛родро▓рпН роЪро┐ройрпНройроорпН
ЁЯР╡ => ЁЯР╡, роХрпБро░роЩрпНроХрпБ, роХрпЛродро┐, рокрпЖро░ро┐роп роХрпБро░роЩрпНроХрпБ, ро╡ро┐ро▓роЩрпНроХро┐ройроорпН, ро╡ро┐ро▓роЩрпНроХрпБ роорпБроХроорпН
ЁЯРТ => ЁЯРТ, роХрпЛродро┐, ро╡ро┐ро▓роЩрпНроХрпБ
ЁЯР╢ => ЁЯР╢, роиро╛ропрпН, роЪрпЖро▓рпНро▓рокрпНрокро┐ро░ро╛рогро┐, ро╡рпАроЯрпНроЯрпБроХрпН роХро╛ро╡ро▓рпН, ро╡ро┐ро▓роЩрпНроХрпБ роорпБроХроорпН, ро╡ро┐ро▓роЩрпНроХро┐ройроорпН, роорпБроХроорпН
ЁЯРХ => ЁЯРХ, роиро╛ропрпНроХрпНроХрпБроЯрпНроЯро┐, ро╡ро┐ро▓роЩрпНроХрпБ, роЪрпЖро▓рпНро▓рокрпНрокро┐ро░ро╛рогро┐
ЁЯРй => ЁЯРй, роиро╛ропрпН, роЪрпЖро▓рпНро▓рокрпНрокро┐ро░ро╛рогро┐, ро╡ро┐ро▓роЩрпНроХро┐ройроорпН, роЕроЯро░рпНродрпНродро┐ропро╛рой роорпБроЯро┐ роХрпКрогрпНроЯ роиро╛ропрпН ро╡роХрпИ
ЁЯР║ => ЁЯР║, роУроиро╛ропрпН, роорпБроХроорпН, ро╡ро┐ро▓роЩрпНроХрпБ, ро╡ро┐ро▓роЩрпНроХрпБ роорпБроХроорпН
ЁЯР▒ => ЁЯР▒, ро╡ро┐ро▓роЩрпНроХрпБ роорпБроХроорпН, рокрпВройрпИроХрпНроХрпБроЯрпНроЯро┐ роорпБроХроорпН, роЪрпЖро▓рпНро▓рокрпНрокро┐ро░ро╛рогро┐, ро╡ро┐ро▓роЩрпНроХрпБ, роорпБроХроорпН, рокрпВройрпИ, рокрпВройрпИроХрпНроХрпБроЯрпНроЯро┐
ЁЯРИ => ЁЯРИ, ро╡ро┐ро▓роЩрпНроХрпБ, рокрпВройрпИроХрпНроХрпБроЯрпНроЯро┐
ЁЯжБ => ЁЯжБ, рокрпКроорпНроорпИ роЪро┐роЩрпНроХроорпН, роЪро┐роЩрпНроХроорпН
ЁЯРп => ЁЯРп, рокрпБро▓ро┐, ро╡ро┐ро▓роЩрпНроХро┐ройроорпН, родрпЗроЪро┐роп ро╡ро┐ро▓роЩрпНроХрпБ, роЯрпИроХро░рпН
ЁЯРЕ => ЁЯРЕ, ро╡ро┐ро▓роЩрпНроХрпБ, рооро┐ро░рпБроХроорпН, родрпЗроЪро┐роп ро╡ро┐ро▓роЩрпНроХрпБ
ЁЯРЖ => ЁЯРЖ, роЪро┐ро▒рпБродрпНродрпИрокрпНрокрпБро▓ро┐, ро╡ро┐ро▓роЩрпНроХрпБ, рооро┐ро░рпБроХроорпН
ЁЯР┤ => ЁЯР┤, роХрпБродро┐ро░рпИ, ро╡ро┐ро▓роЩрпНроХрпБ, ро╡ро┐ро▓роЩрпНроХрпБ роорпБроХроорпН
ЁЯРО => ЁЯРО, ро╡ро┐ро▓роЩрпНроХрпБ
ЁЯжД => ЁЯжД, роТро▒рпНро▒рпИроХрпН роХрпКроорпНрокрпБ роХрпБродро┐ро░рпИ, роХрпБродро┐ро░рпИ роорпБроХроорпН
ЁЯРо => ЁЯРо, рокроЪрпБ рооро╛роЯрпБ роорпБроХроорпН, рокроЪрпБ, ро╡ро┐ро▓роЩрпНроХрпБ, роорпБроХроорпН
ЁЯРВ => ЁЯРВ, ро╡ро┐ро▓роЩрпНроХрпБ
ЁЯРГ => ЁЯРГ, роирпАро░рпН, роОро░рпБроорпИ, ро╡ро┐ро▓роЩрпНроХрпБ, рооро┐ро░рпБроХроорпН
ЁЯРД => ЁЯРД, ро╡ро┐ро▓роЩрпНроХрпБ, рокроЪрпБрооро╛роЯрпБ
ЁЯР╖ => ЁЯР╖, рокройрпНро▒ро┐, роорпБроХроорпН, ро╡ро┐ро▓роЩрпНроХрпБ, ро╡ро┐ро▓роЩрпНроХрпБ роорпБроХроорпН
ЁЯРЦ => ЁЯРЦ, рокройрпНро▒ро┐роХрпНроХрпБроЯрпНроЯро┐, ро╡ро┐ро▓роЩрпНроХрпБ
ЁЯРЧ => ЁЯРЧ, ро╡ро┐ро▓роЩрпНроХрпБ
ЁЯР╜ => ЁЯР╜, рокройрпНро▒ро┐ропро┐ройрпН роорпВроХрпНроХрпБ, роорпВроХрпНроХрпБ, рокройрпНро▒ро┐, роорпБроХроорпН, ро╡ро┐ро▓роЩрпНроХрпБ, ро╡ро┐ро▓роЩрпНроХрпБ роорпБроХроорпН
ЁЯРП => ЁЯРП, роЖроЯрпНроЯрпБроХрпНроХроЯро╛, ро╡ро┐ро▓роЩрпНроХрпБ
ЁЯРС => ЁЯРС, ро╡ро┐ро▓роЩрпНроХрпБ
ЁЯРР => ЁЯРР, ро╡ро┐ро▓роЩрпНроХрпБ, ро╡рпЖро│рпНро│ро╛роЯрпБ
ЁЯРк => ЁЯРк, роТро▒рпНро▒рпИродрпН родро┐рооро┐ро▓рпН роХрпКрогрпНроЯ роТроЯрпНроЯроХроорпН, родро┐рооро┐ро▓рпН, роТро░рпБ родро┐рооро┐ро▓рпН, ро╡ро┐ро▓роЩрпНроХро┐ройроорпН, рокро╛ро▓рпВроЯрпНроЯро┐, рокро╛ро▓рпИро╡рой роЙропро┐ро░ро┐, роХрпЗрооро▓рпН
ЁЯРл => ЁЯРл, родро┐рооро┐ро▓рпН, роЗро░рпБ родро┐рооро┐ро▓рпНроХро│рпН, ро╡ро┐ро▓роЩрпНроХро┐ройроорпН, рокро╛ро▓рпВроЯрпНроЯро┐, рокро╛ро▓рпИро╡рой роЙропро┐ро░ро┐, рокро╛роХрпНроЯро┐ро░рпАропройрпН роХрпЗрооро▓рпН
ЁЯРШ => ЁЯРШ, ропро╛ройрпИроХрпБроЯрпНроЯро┐, ро╡ро┐ро▓роЩрпНроХрпБ
ЁЯРн => ЁЯРн, роХрпБроЯрпНроЯро┐ роОро▓ро┐ роорпБроХроорпН, роЪрпБрогрпНроЯрпЖро▓ро┐, ро╡ро┐ро▓роЩрпНроХрпБ роорпБроХроорпН, роХрпБроЯрпНроЯро┐ роОро▓ро┐
ЁЯРБ => ЁЯРБ, ро╡ро┐ро▓роЩрпНроХрпБ
ЁЯРА => ЁЯРА, ро╡ро┐ро▓роЩрпНроХрпБ, роЬрпЖро░рпНро░ро┐
ЁЯР╣ => ЁЯР╣, ро╡рпЖро│рпНро│рпЖро▓ро┐, роорпБроХроорпН, ро╡ро┐ро▓роЩрпНроХрпБ, ро╡ро┐ро▓роЩрпНроХрпБ роорпБроХроорпН
ЁЯР░ => ЁЯР░, роорпБропро▓рпН роХрпБроЯрпНроЯро┐ роорпБроХроорпН, роорпБроХроорпН, ро╡ро┐ро▓роЩрпНроХрпБ роорпБроХроорпН, роорпКроЪроХрпН роХрпБроЯрпНроЯро┐ роорпБроХроорпН
ЁЯРЗ => ЁЯРЗ, ро╡ро┐ро▓роЩрпНроХрпБ, роорпБропро▓рпН роХрпБроЯрпНроЯро┐, роорпКроЪроХрпН роХрпБроЯрпНроЯро┐
ЁЯР┐ => ЁЯР┐, роЪро┐рокрпНроороЩрпНроХрпНро╕рпН, роЕрогро┐ро▓рпН
ЁЯР╗ => ЁЯР╗, роорпБроХроорпН, ро╡ро┐ро▓роЩрпНроХрпБ, роХро░роЯро┐роХрпНроХрпБроЯрпНроЯро┐, ро╡ро┐ро▓роЩрпНроХрпБ роорпБроХроорпН
ЁЯРи => ЁЯРи, роХрпЛро╡ро╛ро▓ро╛ рокро┐ропро░рпН, ро╡ро┐ро▓роЩрпНроХро┐ройроорпН, рокро╛ро▓рпВроЯрпНроЯро┐
ЁЯР╝ => ЁЯР╝, рокро╛ройрпНроЯро╛, роорпБроХроорпН, ро╡ро┐ро▓роЩрпНроХрпБ, рокро╛ройрпНроЯро╛ роХро░роЯро┐ роорпБроХроорпН
ЁЯР╛ => ЁЯР╛, рокро╛родродрпН родроЯроорпН, рокро╛родроорпН, родроЯроорпН, ро╡ро┐ро▓роЩрпНроХрпБ
ЁЯжГ => ЁЯжГ, рокро▒ро╡рпИ
ЁЯРФ => ЁЯРФ, рокро▒ро╡рпИ
ЁЯРУ => ЁЯРУ, ро╡рпАроЯрпНроЯрпБроЪрпН роЪрпЗро╡ро▓рпН, рокро▒ро╡рпИ
ЁЯРг => ЁЯРг, роХрпЛро┤ро┐роХрпНроХрпБроЮрпНроЪрпБ, ро╡ро┐ро▓роЩрпНроХро┐ройроорпН, роХрпБроЮрпНроЪрпБ, ро╡рпЖро│ро┐ро╡ро░рпБроорпН роХрпБроЮрпНроЪрпБ, роорпБроЯрпНроЯрпИ
ЁЯРд => ЁЯРд, роХрпЛро┤ро┐роХрпНроХрпБроЮрпНроЪрпБ, ро╡ро┐ро▓роЩрпНроХро┐ройроорпН, роЪро┐роХрпНроХройрпН
ЁЯРе => ЁЯРе, роХрпЛро┤ро┐роХрпНроХрпБроЮрпНроЪрпБ, роорпБройрпНроиро┐ройрпНро▒рпБ рокро╛ро░рпНроХрпНроХрпБроорпН роХрпЛро┤ро┐роХрпНроХрпБроЮрпНроЪрпБ, ро╡ро┐ро▓роЩрпНроХро┐ройроорпН
ЁЯРж => ЁЯРж, ро╡ро┐ро▓роЩрпНроХро┐ройроорпН
ЁЯРз => ЁЯРз, рокро▒ро╡рпИ
ЁЯХК => ЁЯХК, рокрпБро▒ро╛, родрпВродрпБ, роЪрооро╛родро╛ройроорпН, рокро▒ро╡рпИ
ЁЯР╕ => ЁЯР╕, родро╡ро│рпИ, роорпБроХроорпН, ро╡ро┐ро▓роЩрпНроХрпБ, ро╡ро┐ро▓роЩрпНроХрпБ роорпБроХроорпН
ЁЯРК => ЁЯРК, ро╡ро┐ро▓роЩрпНроХрпБ, роКро░рпНро╡родрпБ
ЁЯРв => ЁЯРв, роКро░рпНро╡рой, ро╡ро┐ро▓роЩрпНроХро┐ройроорпН, роХроЯро▓ро╛роорпИ
ЁЯРН => ЁЯРН, роиро╛роХроорпН, ро╡ро┐ро▓роЩрпНроХрпБ
ЁЯР▓ => ЁЯР▓, ро╡ро┐ро▓роЩрпНроХрпБ роорпБроХроорпН, рооро┐ро░рпБроХроорпН, рокро▒роХрпНроХрпБроорпН роиро╛роХроорпН, роорпБроХроорпН
ЁЯРЙ => ЁЯРЙ, ро╡ро┐ро▓роЩрпНроХрпБ, рооро┐ро░рпБроХроорпН, рокро▒роХрпНроХрпБроорпН роиро╛роХроорпН
ЁЯР│ => ЁЯР│, родро┐рооро┐роЩрпНроХро▓роорпН, ро╡ро┐ро▓роЩрпНроХро┐ройроорпН
ЁЯРЛ => ЁЯРЛ, рокро╛ро▓рпВроЯрпНроЯро┐, роирпАро░рпНро╡ро╛ро┤рпН роЙропро┐ро░ро┐, ро╡ро┐ро▓роЩрпНроХрпБ
ЁЯРм => ЁЯРм, ро╡ро┐ро▓роЩрпНроХро┐ройроорпН, рокро╛ро▓рпВроЯрпНроЯро┐
ЁЯРЯ => ЁЯРЯ, ро╡ро┐ро▓роЩрпНроХро┐ройроорпН, роирпАро░рпНро╡ро╛ро┤рпН роЙропро┐ро░ро┐ройроорпН
ЁЯРа => ЁЯРа, роорпАройрпН, ро╡ро┐ро▓роЩрпНроХро┐ройроорпН, роирпАро░рпНро╡ро╛ро┤рпН роЙропро┐ро░ро┐ройроорпН, ро╡рпЖрокрпНрокроорогрпНроЯро▓ роорпАройрпН
ЁЯРб => ЁЯРб, роорпАройрпН, ро╡ро┐ро▓роЩрпНроХро┐ройроорпН, роирпАро░рпНро╡ро╛ро┤рпН роЙропро┐ро░ро┐ройроорпН, роХрпБро│рпЛрокрпН роорпАройрпН
ЁЯРЩ => ЁЯРЩ, ро╡ро┐ро▓роЩрпНроХрпБ, рокрпЗропрпНроХрпНроХрогро╡ро╛ропрпН
ЁЯРЪ => ЁЯРЪ, роЪро┐рокрпНрокро┐, ро╡ро┐ро▓роЩрпНроХрпБ
ЁЯжА => ЁЯжА, роХроЯроХроорпН, роХроЯроХ ро░ро╛роЪро┐
ЁЯРМ => ЁЯРМ, ро╡ро┐ро▓роЩрпНроХрпБ
ЁЯРЫ => ЁЯРЫ, роХроорпНрокро│ро┐рокрпНрокрпБро┤рпБ, рокрпВро░ро╛ройрпН, ро╡ро┐ро▓роЩрпНроХрпБ
ЁЯРЬ => ЁЯРЬ, рокрпВроЪрпНроЪро┐, ро╡ро┐ро▓роЩрпНроХро┐ройроорпН
ЁЯРЭ => ЁЯРЭ, рокрпВроЪрпНроЪро┐, ро╡ро┐ро▓роЩрпНроХро┐ройроорпН
ЁЯРЮ => ЁЯРЮ, ро╡рогрпНроЯрпБ, ро╡ро┐ро▓роЩрпНроХро┐ройроорпН, рокрпВроЪрпНроЪро┐, роХрпБро│ро╡ро┐
ЁЯХ╖ => ЁЯХ╖, рокрпВроЪрпНроЪро┐
ЁЯХ╕ => ЁЯХ╕, роЪро┐ро▓роирпНродро┐ ро╡рпАроЯрпБ, роЪро┐ро▓роирпНродро┐
ЁЯжВ => ЁЯжВ, ро╡ро┐ро░рпБроЪрпНроЪро┐роХроорпН, ро╡ро┐ро░рпБроЪрпНроЪро┐роХ ро░ро╛роЪро┐
ЁЯТР => ЁЯТР, рокрпВроЩрпНроХрпКродрпНродрпБ, рооро▓ро░рпНроХро│рпН, роХро╛родро▓рпН, ро░рпКрооро╛ройрпНро╕рпН
ЁЯМ╕ => ЁЯМ╕, роЪрпЖро░рпНро░ро┐рокро┐ро▓ро╛ро╕роорпН, рооро▓ро░рпН, ро╡роЪроирпНродроорпН
ЁЯТо => ЁЯТо, ро╡рпЖро│рпНро│рпИ, роЕро░рпБроорпИ роОройрпНрокродрпИроХрпН роХрпБро▒ро┐роХрпНроХрпБроорпН роорпБродрпНродро┐ро░рпИ, рооро▓ро░рпН, роорпБродрпНродро┐ро░рпИ
ЁЯП╡ => ЁЯП╡, ро╡роЯрпНроЯрокрпН рокрпВ, рокрпВ, рооро▓ро░рпН, ро╡роЯрпНроЯ рооро▓ро░рпН
ЁЯМ╣ => ЁЯМ╣, рооро▓ро░рпН, роХро╛родро▓рпН, роЪро┐ро╡рокрпНрокрпБ ро░рпЛроЬро╛
ЁЯМ║ => ЁЯМ║, рооро▓ро░рпН, рокрпВ
ЁЯМ╗ => ЁЯМ╗, роЪрпВро░ро┐ропройрпН, рооро▓ро░рпН
ЁЯМ╝ => ЁЯМ╝, рокро┐ро▓ро╛ро╕роорпН, рооро▓ро░рпН
ЁЯМ╖ => ЁЯМ╖, роЯрпНропрпБро▓ро┐рокрпН, рооро▓ро░рпН, роЪрпЖроЯро┐, роЗро▓рпИроХро│рпН
тШШ => тШШ, рокроЪрпНроЪрпИ роЗро▓рпИ, роЗро▓рпИ
ЁЯМ▒ => ЁЯМ▒, рокрпБродро┐роп родрпКроЯроХрпНроХроорпН, ро╡ро│ро░рпНроЪрпНроЪро┐
ЁЯМ▓ => ЁЯМ▓, роХро┐ро▒ро┐ро╕рпНродрпБрооро╕рпН рооро░роорпН, рооро░роорпН, рокроЪрпБроорпИ, роХро┐ро▒ро┐ро╕рпНродрпБрооро╕рпН роХро╛ро▓роорпН
ЁЯМ│ => ЁЯМ│, рооро░роорпН, рокроЪрпБроорпИ
ЁЯМ┤ => ЁЯМ┤, рооро░роорпН, роХроЯро▒рпНроХро░рпИ, роХрпЗро│ро┐роХрпНроХрпИ, ро╡ро┐роЯрпБроорпБро▒рпИ
ЁЯМ╡ => ЁЯМ╡, роХро│рпНро│ро┐, рокро╛ро▓рпИро╡ройроорпН
ЁЯМ╛ => ЁЯМ╛, ро╡ропро▓рпН, роЕро░ро┐роЪро┐, роЕро▒рпБро╡роЯрпИ
ЁЯМ┐ => ЁЯМ┐, роЪрпЖроЯро┐, роЗро▓рпИроХро│рпН, рооро░рпБроирпНродрпБ
ЁЯНА => ЁЯНА, роЗро▓рпИроХро│рпН, роиро╛ройрпНроХрпБ, роЕродро┐ро░рпНро╖рпНроЯроорпН
ЁЯНБ => ЁЯНБ, роЗро▓рпИ, роЗро▓рпИропрпБродро┐ро░рпНроХро╛ро▓роорпН
ЁЯНВ => ЁЯНВ, роЗро▓рпИропрпБродро┐ро░рпНроХро╛ро▓роорпН, роЗро▓рпИроХро│рпН, ро╡ро▒роЯрпНроЪро┐
ЁЯНГ => ЁЯНГ, роЙродро┐ро░рпБроорпН роЗро▓рпИроХро│рпН, роЗро▓рпИропрпБродро┐ро░рпНроХро╛ро▓роорпН, роЗро▓рпИроХро│рпН, рокроЪрпБроорпИ
ЁЯНЗ => ЁЯНЗ, рокро┤роорпН, роТропро┐ройрпН
ЁЯНИ => ЁЯНИ, рокро┤роорпН, родро╛роХроорпН
ЁЯНЙ => ЁЯНЙ, роХрпЛроЯрпИроХро╛ро▓роорпН, рокро┤роорпН, родро╛роХроорпН
ЁЯНК => ЁЯНК, рокро┤роорпН, роЙроЯро▓рпНроиро▓роорпН
ЁЯНЛ => ЁЯНЛ, рокрпБро│ро┐рокрпНрокрпБ, рокро┤роорпН, роороЮрпНроЪро│рпН ро╡рогрпНрогроорпН
ЁЯНМ => ЁЯНМ, роЙрогро╡рпБ, роЙроЯро▓рпНроиро▓роорпН, рокро┤роорпН
ЁЯНН => ЁЯНН, роЙрогро╡рпБ, роЙроЯро▓рпНроиро▓роорпН, рокро┤роорпН
ЁЯНО => ЁЯНО, роЙрогро╡рпБ, роЪро┐ро╡рокрпНрокрпБ, роЙроЯро▓рпНроиро▓роорпН
ЁЯНП => ЁЯНП, роЖрокрпНрокро┐ро│рпН, рокро┤роорпН
ЁЯНР => ЁЯНР, роЙрогро╡рпБ
ЁЯНС => ЁЯНС, рокро┤роорпН, роЙрогро╡рпБ
ЁЯНТ => ЁЯНТ, рокро┤роорпН, роЪро┐ро╡рокрпНрокрпБ
ЁЯНУ => ЁЯНУ, рокро┤роорпН, роЙрогро╡рпБ
ЁЯНЕ => ЁЯНЕ, роХро╛ропрпНроХро▒ро┐, роЙрогро╡рпБ
ЁЯНЖ => ЁЯНЖ, роХро╛ропрпНроХро▒ро┐, роЙрогро╡рпБ
ЁЯМ╜ => ЁЯМ╜, роороХрпНроХро╛роЪрпНроЪрпЛро│роорпН, рокро╛рокрпНроХро╛ро░рпНройрпН
ЁЯМ╢ => ЁЯМ╢, рооро┐ро│роХро╛ропрпН, рокрпЖрокрпНрокро░рпН, роХро╛ро░роорпН, роЪро┐ро╡рокрпНрокрпБ рооро┐ро│роХро╛ропрпН
ЁЯНД => ЁЯНД, рооро╖рпНро░рпВроорпН, роЙрогро╡рпБ, роЪрпВрокрпНрокро░рпН рооро╛ро░ро┐ропрпЛ
ЁЯМ░ => ЁЯМ░, ро╡ро▒рпБродрпНрод роЪрпЖро╕рпНроЯрпНроироЯрпН
ЁЯНЮ => ЁЯНЮ, ро░рпКроЯрпНроЯро┐, роЙрогро╡рпБ, роЙрогро╡роХроорпН
ЁЯзА => ЁЯзА, рокро╛ро▓ро╛роЯрпИ, рокро╛ро▓рпЗроЯрпБ, роЪрпАро╕рпН
ЁЯНЦ => ЁЯНЦ, рооро╛рооро┐роЪроорпН, роЙрогро╡роХроорпН, ро╡ро┐ро░рпБроирпНродрпБ
ЁЯНЧ => ЁЯНЧ, роЙрогро╡роХроорпН, ро╡ро┐ро░рпБроирпНродрпБ, роЕроЪрпИро╡роорпН, роЙрогро╡рпБ, ро▓рпЖроХрпН рокрпАро╕рпН
ЁЯНФ => ЁЯНФ, ро╣роорпНрокро░рпНроХро░рпН, роЙрогро╡рпБ, роЙрогро╡роХроорпН
ЁЯНЯ => ЁЯНЯ, роЙрогро╡роХроорпН, роЙрогро╡рпБ
ЁЯНХ => ЁЯНХ, роЙрогро╡рпБ, роЙрогро╡роХроорпН, рокрпАроЯрпНроЪро╛ родрпБрогрпНроЯрпБ, родрпБро░ро┐род роЙрогро╡рпБ, рокрпАро╕рпНро╕ро╛
ЁЯМн => ЁЯМн, роХрпКродрпНродрпБроХрпНроХро▒ро┐ роЙрогро╡рпБ, роЗро▒рпИроЪрпНроЪро┐ роЙрогро╡рпБ
ЁЯМо => ЁЯМо, роорпЖроХрпНроЪро┐роХройрпН роЙрогро╡рпБ, роЙрогро╡рпБ
ЁЯМп => ЁЯМп, роорпЖроХрпНроЪро┐роХройрпН роЙрогро╡рпБ, роЙрогро╡рпБ
ЁЯН┐ => ЁЯН┐, рокрпКро░рпБроЯрпНроХро╛роЯрпНроЪро┐
ЁЯН▓ => ЁЯН▓, рокро╛родрпНродро┐ро░родрпНродро┐ро▓рпН роЙрогро╡рпБ, роЙрогро╡рпБ, роЙрогро╡роХроорпН, роЪрпВроЯро╛рой роЙрогро╡рпБ
ЁЯН▒ => ЁЯН▒, рокрпЖроЯрпНроЯро┐, роЙрогро╡роХроорпН
ЁЯНШ => ЁЯНШ, роЕро░ро┐роЪро┐
ЁЯНЩ => ЁЯНЩ, роЕро░ро┐роЪро┐, роЙрогро╡роХроорпН, роЙрогро╡рпБ
ЁЯНЪ => ЁЯНЪ, роЙрогро╡рпБ, роЙрогро╡роХроорпН
ЁЯНЫ => ЁЯНЫ, роЪро╛рокрпНрокро╛роЯрпБ, роЪрпЛро▒рпБ, роХрпБро┤роорпНрокрпБ, роЙрогро╡роХроорпН
ЁЯНЬ => ЁЯНЬ, роЪрпВрокрпН, роирпВроЯрпВро▓рпНро╕рпН, роЙрогро╡рпБ, роЙрогро╡роХроорпН
ЁЯНЭ => ЁЯНЭ, родроХрпНроХро╛ро│ро┐ роирпВроЯрпВро▓рпНро╕рпН, роЙрогро╡роХроорпН, роЙрогро╡рпБ
ЁЯНа => ЁЯНа, ро╡ро▒рпБродрпНрод роХро┐ро┤роЩрпНроХрпБ, роЪро░рпНроХрпНроХро░рпИро╡ро│рпНро│ро┐роХрпН роХро┐ро┤роЩрпНроХрпБ, роЙро░рпБро│рпИроХрпНроХро┐ро┤роЩрпНроХрпБ, роЙрогро╡роХроорпН, роЙрогро╡рпБ
ЁЯНв => ЁЯНв, роХрпБроЪрпНроЪро┐ропро┐ро▓рпН роХроЯро▓рпН роЙрогро╡рпБ, роХроЯро▓рпН роЙрогро╡рпБ, роЙрогро╡роХроорпН, роЙрогро╡рпБ, роХрокро╛рокрпН
ЁЯНг => ЁЯНг, роЙрогро╡рпБ, роорпАройрпН, роЙрогро╡роХроорпН
ЁЯНд => ЁЯНд, роХроЯро▓рпН роЙрогро╡рпБ, роЙрогро╡роХроорпН
ЁЯНе => ЁЯНе, роГрокро┐ро╖рпН роХрпЗроХрпН, роХроЯро▓рпН роЙрогро╡рпБ, роЙрогро╡роХроорпН
ЁЯНб => ЁЯНб, роХрпБроЪрпНроЪро┐ропро┐ро▓рпН роЙро░рпБрогрпНроЯрпИроХро│рпН, роЙрогро╡рпБ, роЬрокрпНрокро╛ройро┐роп роЙрогро╡рпБ, роЙрогро╡роХроорпН
ЁЯНж => ЁЯНж, роРро╕рпНроХрпНро░рпАроорпН, роЙрогро╡рпБ, роЙрогро╡роХроорпН
ЁЯНз => ЁЯНз, ро╖рпЗро╡рпНроЯрпН роРро╕рпНроХрпНро░рпАроорпН, роРро╕рпНроХрпНро░рпАроорпН, роЙрогро╡рпБ, роЙрогро╡роХроорпН
ЁЯНи => ЁЯНи, роРро╕рпНроХрпНро░рпАроорпН, роЙрогро╡рпБ, роЙрогро╡роХроорпН
ЁЯНй => ЁЯНй, роЗройро┐рокрпНрокрпБ, роЙрогро╡рпБ, роЙрогро╡роХроорпН
ЁЯНк => ЁЯНк, ро░рпКроЯрпНроЯро┐, роЙрогро╡рпБ, роЙрогро╡роХроорпН
ЁЯОВ => ЁЯОВ, роХрпЗроХрпН, рокро┐ро▒роирпНродроиро╛ро│рпН, роХрпКрогрпНроЯро╛роЯрпНроЯроорпН, ро╡ро┐ро░рпБроирпНродрпБ
ЁЯН░ => ЁЯН░, роХрпЗроХрпН рокрпАро╕рпН, роХрпЗроХрпН, роЙрогро╡роХроорпН
ЁЯНл => ЁЯНл, роЪро╛роХрпНро▓рпЗроЯрпН рокро╛ро░рпН, роЗройро┐рокрпНрокрпБ, роЙрогро╡роХроорпН
ЁЯНм => ЁЯНм, роХрпЗройрпНроЯро┐, роЗройро┐рокрпНрокрпБ
ЁЯНн => ЁЯНн, ро▓ро╛ро▓ро┐рокро╛рокрпН, рооро┐роЯрпНроЯро╛ропрпН, роЗройро┐рокрпНрокрпБ
ЁЯНо => ЁЯНо, роЗройро┐рокрпНрокрпБ, роЙрогро╡роХроорпН
ЁЯНп => ЁЯНп, ро╣ройро┐рокро╛роЯрпН, роЗройро┐рокрпНрокрпБ, роЙрогро╡роХроорпН
ЁЯН╝ => ЁЯН╝, роЪро┐ро▒рпБрокро┐ро│рпНро│рпИродрпНродройроорпН, рокро╛роЯрпНроЯро┐ро▓рпН, рокро╛ройроорпН
тШХ => тШХ, роЪрпВроЯро╛рой роХро╛рокро┐, роЯрпА, рокро╛ройроорпН
ЁЯН╡ => ЁЯН╡, родрпЗройрпАро░рпНроХрпНроХрпЛрокрпНрокрпИ, родрпЗройрпАро░рпН, роЯрпА, рокро╛ройроорпН
ЁЯН╢ => ЁЯН╢, роЪрпЗроХрпН рокро╛роЯрпНроЯро┐ро▓рпБроорпН роХрпЛрокрпНрокрпИропрпБроорпН, роЪрпЗроХрпН, роородрпБрокро╛ройроорпН, роЙрогро╡роХроорпН
ЁЯН╛ => ЁЯН╛, роХро╛ро░рпНроХрпН, рокрпАроЪрпНроЪро┐ропроЯро┐
ЁЯН╖ => ЁЯН╖, роородрпБ, роХрпЛрокрпНрокрпИ, рокро╛ройроорпН, роЙрогро╡роХроорпН
ЁЯН╕ => ЁЯН╕, роХро╛роХрпНроЯрпЖропро┐ро▓рпН, роородрпБроХрпНроХро▓ро╡рпИ, роЙрогро╡роХроорпН, рокро╛ройроорпН
ЁЯН╣ => ЁЯН╣, рокро╛ройроорпН, роЙрогро╡роХроорпН, ро╡ро┐ро░рпБроирпНродрпБ
ЁЯН║ => ЁЯН║, рокрпАро░рпН, роХрпБро╡ро│рпИ, роЙрогро╡роХроорпН, ро╡ро┐ро░рпБроирпНродрпБ
ЁЯН╗ => ЁЯН╗, рокрпАро░рпН, роХрпБро╡ро│рпИроХро│рпН, роЙрогро╡роХроорпН, ро╡ро┐ро░рпБроирпНродрпБ
ЁЯН╜ => ЁЯН╜, роЪроорпИропро▓рпН, родроЯрпНроЯрпБ, роХродрпНродро┐, роорпБро│рпНроХро░рогрпНроЯро┐, роирпИроГрокрпН, роГрокрпЛро░рпНроХрпН
ЁЯН┤ => ЁЯН┤, роЙрогро╡рпБ, роЙрогро╡рпБ роирпЗро░роорпН, роЙрогро╡роХроорпН
ЁЯН│ => ЁЯН│, роорпБроЯрпНроЯрпИ, роЙрогро╡рпБ, роХро╛роГрокрпН рокро╛ропро┐ро▓рпН, роХро╛роГрокрпН рокро╛ропро┐ро▓рпН роорпБроЯрпНроЯрпИ
ЁЯП║ => ЁЯП║, роХрпБроорпНрок ро░ро╛роЪро┐, роЬро╛роЯро┐, рокро╛ройроорпН, ро╡рпАроЯрпНроЯрпБ роЕро▓роЩрпНроХро╛ро░ рокрпКро░рпБро│рпН
ЁЯМН => ЁЯМН, роЖрокрпНрокро┐ро░ро┐роХрпНроХро╛, роРро░рпЛрокрпНрокро╛, роЙро▓роХ роЙро░рпБрогрпНроЯрпИ, рокрпВрооро┐
ЁЯМО => ЁЯМО, роЙро▓роХ роЙро░рпБрогрпНроЯрпИ, рокрпВрооро┐, родрпЖройрпН роЕроорпЖро░ро┐роХрпНроХро╛, ро╡роЯ роЕроорпЖро░ро┐роХрпНроХро╛
ЁЯМП => ЁЯМП, роЖроЪро┐ропро╛, роЖро╕рпНродро┐ро░рпЗро▓ро┐ропро╛, роЙро▓роХ роЙро░рпБрогрпНроЯрпИ, рокрпВрооро┐
ЁЯМР => ЁЯМР, роЕроЯрпНроЪро░рпЗроХрпИ, родрпАро░рпНроХрпНроХро░рпЗроХрпИ, роЙро▓роХ роЙро░рпБрогрпНроЯрпИ, рокрпВрооро┐
ЁЯЧ║ => ЁЯЧ║, роЙро▓роХроорпН, ро╡ро░рпИрокроЯроорпН
ЁЯПФ => ЁЯПФ, рокройро┐, рооро▓рпИ, роХрпБро│ро┐ро░рпН
тЫ░ => тЫ░, рооро▓рпИ
ЁЯМЛ => ЁЯМЛ, ро╡рпЖроЯро┐роХрпНроХрпБроорпН роОро░ро┐рооро▓рпИ, роирпЖро░рпБрокрпНрокрпБ, ро▓ро╛ро╡ро╛
ЁЯЧ╗ => ЁЯЧ╗, роЪро┐роХро░роорпН
ЁЯПХ => ЁЯПХ, роорпБроХро╛роорпН
ЁЯПЦ => ЁЯПЦ, роХроЯро▒рпНроХро░рпИ, роХрпБроЯрпИ
ЁЯПЬ => ЁЯПЬ, рокро╛ро▓рпИро╡ройроорпН, ро╡ро▒роЯрпНроЪро┐
ЁЯПЭ => ЁЯПЭ, рокро╛ро▓рпИро╡ройроорпН
ЁЯПЮ => ЁЯПЮ, рокрпВроЩрпНроХро╛
ЁЯПЯ => ЁЯПЯ, ро╕рпНроЯрпЗроЯро┐ропроорпН
ЁЯПЫ => ЁЯПЫ, рокро┤рпИроорпИ ро╡ро╛ропрпНроирпНродродрпБ, рокро╛ро░роорпНрокро░ро┐роп роХроЯрпНроЯро┐роЯроорпН, роХроЯрпНроЯро┐роЯроорпН
ЁЯПЧ => ЁЯПЧ, роХроЯрпНроЯрпБрооро╛ройроорпН, роХроЯрпНроЯро┐роЯроорпН
ЁЯПШ => ЁЯПШ, роХроЯрпНроЯро┐роЯроЩрпНроХро│рпН, ро╡рпАроЯрпБ
ЁЯПЩ => ЁЯПЩ, роироХро░роорпН
ЁЯПЪ => ЁЯПЪ, рокро╛ро┤роЯрпИроирпНрод ро╡рпАроЯрпБ, роорпЛроЪрооро╛рой роиро┐ро▓рпИропро┐ро▓рпН роЙро│рпНро│ ро╡рпАроЯрпБ, ро╡рпАроЯрпБ
ЁЯПа => ЁЯПа, роЗро▓рпНро▓роорпН, роХроЯрпНроЯро┐роЯроорпН
ЁЯПб => ЁЯПб, ро╡рпАроЯрпБ, ро╡рпАроЯрпНроЯрпБродрпН родрпЛроЯрпНроЯроорпН, роХроЯрпНроЯро┐роЯроорпН, родрпЛроЯрпНроЯроорпН роЗро░рпБроХрпНроХрпБроорпН ро╡рпАроЯрпБ
тЫк => тЫк, роХрпЛропро┐ро▓рпН, роЖро▓ропроорпН, роХроЯро╡рпБро│рпН, рокро┐ро░ро╛ро░рпНродрпНродройрпИ
ЁЯХЛ => ЁЯХЛ, роЗро╕рпНро▓ро╛роорпН, роородроорпН, роЗро╕рпНро▓ро╛рооро┐ропроорпН
ЁЯХМ => ЁЯХМ, роЗро╕рпНро▓ро╛роорпН, роородроорпН, роЗро╕рпНро▓ро╛рооро┐ропроорпН
ЁЯХН => ЁЯХН, ропрпВродро░рпНроХро│рпН, ропрпВрод роородроорпН, роородроорпН
тЫй => тЫй, ро╖ро┐рогрпНроЯрпЛ, ро╕рпНро░рпИройрпН, роородроорпН
ЁЯПв => ЁЯПв, роЕро▓рпБро╡ро▓роХроорпН, роЖрокро┐ро╕рпН, роХроЯрпНроЯро┐роЯроорпН
ЁЯПг => ЁЯПг, рокрпЛро╕рпНроЯрпН роЖрокро┐ро╕рпН, роЕроЮрпНроЪро▓рпН роЕро▓рпБро╡ро▓роХроорпН, роХроЯрпНроЯро┐роЯроорпН
ЁЯПд => ЁЯПд, рокрпЛро╕рпНроЯрпН роЖрокро┐ро╕рпН, родрокро╛ро▓рпН роЕро▓рпБро╡ро▓роХроорпН, роХроЯрпНроЯро┐роЯроорпН
ЁЯПе => ЁЯПе, роХро┐ро│ро┐ройро┐роХрпН, роХроЯрпНроЯро┐роЯроорпН
ЁЯПж => ЁЯПж, рокрпЗроЩрпНроХрпН, роХроЯрпНроЯро┐роЯроорпН
ЁЯПи => ЁЯПи, ро╡ро┐роЯрпБродро┐, роХроЯрпНроЯро┐роЯроорпН
ЁЯПй => ЁЯПй, ро╣рпЛроЯрпНроЯро▓рпН, роХроЯрпНроЯро┐роЯроорпН
ЁЯПк => ЁЯПк, ро╕рпНроЯрпЛро░рпН, роЪрпВрокрпНрокро░рпН рооро╛ро░рпНроХрпНроХрпЖроЯрпН, роХроЯрпНроЯро┐роЯроорпН
ЁЯПл => ЁЯПл, рокро│рпНро│ро┐, роХро▓рпНро╡ро┐роХрпНроХрпВроЯроорпН, рокро╛роЯ роЪро╛ро▓рпИ, рокро│рпНро│ро┐роХрпН роХроЯрпНроЯро┐роЯроорпН
ЁЯПм => ЁЯПм, ро╕рпНроЯрпЛро░рпН, роХроЯрпНроЯро┐роЯроорпН, рокрпКро░рпБроЯрпНроХро│рпН
ЁЯПн => ЁЯПн, родрпКро┤ро┐ро▓роХроорпН, родрпКро┤ро┐ро▒рпНроЪро╛ро▓рпИ роХроЯрпНроЯро┐роЯроорпН, роХроЯрпНроЯро┐роЯроорпН
ЁЯПп => ЁЯПп, роЕро░рогрпНрооройрпИ, роХрпЛроЯрпНроЯрпИ, роХроЯрпНроЯро┐роЯроорпН
ЁЯП░ => ЁЯП░, роЕро░рогрпНрооройрпИ, роХроЯрпНроЯро┐роЯроорпН, роРро░рпЛрокрпНрокро┐роп рокро╛рогро┐ роЕро░рогрпНрооройрпИ
ЁЯТТ => ЁЯТТ, родро┐ро░рпБроорог роЕро░роЩрпНроХрпБ, родро┐ро░рпБроорогроорпН, ро░рпКрооро╛ройрпНро╕рпН, роХро╛родро▓рпН
ЁЯЧ╝ => ЁЯЧ╝, роЯро╡ро░рпН
ЁЯЧ╜ => ЁЯЧ╜, роЪрпБродроирпНродро┐ро░ родрпЗро╡ро┐, роЪро┐ро▓рпИ, ро▓ро┐рокро░рпНроЯрпНроЯро┐
ЁЯЧ╛ => ЁЯЧ╛, роорпЗрокрпН, ро╡ро░рпИрокроЯроорпН, роЬрокрпНрокро╛ройрпН
тЫ▓ => тЫ▓, родрпЛроЯрпНроЯроорпН, рокрпВроЩрпНроХро╛
тЫ║ => тЫ║, роорпБроХро╛роорпН, рокропро┐ро▒рпНроЪро┐
ЁЯМБ => ЁЯМБ, рокройро┐рокрпНрокрпБроХрпИ, ро╡рпЖрогрпНрокрпБроХрпИ
ЁЯМГ => ЁЯМГ, роЗро░ро╡ро┐ро▓рпН роироЯрпНроЪродрпНродро┐ро░роЩрпНроХро│рпН, роироЯрпНроЪродрпНродро┐ро░роорпН, роЗро░ро╡рпБ, роироХро░роорпН
ЁЯМД => ЁЯМД, роЪрпВро░ро┐ропрпЛродропроорпН, роХро╛ро▓рпИроЪрпНроЪрпВро░ро┐ропройрпН, рооро▓рпИ, роХро╛ро▓рпИ ро╡рпЖропро┐ро▓рпН
ЁЯМЕ => ЁЯМЕ, роХро╛ро▓рпИроЪрпНроЪрпВро░ро┐ропройрпН, роХроЯро▓рпБроорпН роЪрпВро░ро┐ропройрпБроорпН, роХро╛ро▓рпИ
ЁЯМЖ => ЁЯМЖ, роЪрпВро░ро┐роп роЕро╕рпНродрооройроорпН, роЕро╕рпНродрооройроорпН, рооро╛ро▓рпИ, роироХро░роорпН
ЁЯМЗ => ЁЯМЗ, роироХро░родрпНродро┐ро▓рпН роЪрпВро░ро┐роп роЕро╕рпНродрооройроорпН, ро╡рпЗро▓рпИ роирпЗро░ роорпБроЯро┐ро╡рпБ, рооро╛ро▓рпИ
ЁЯМЙ => ЁЯМЙ, роЗро░ро╡ро┐ро▓рпН роироХро░родрпН родрпЛро▒рпНро▒роорпН, рокро╛ро▓роорпН, роЗро░ро╡рпБ, роироЯрпНроЪродрпНродро┐ро░роЩрпНроХро│рпН, роиро┐ро▓ро╛
тЩи => тЩи, родрпА, роЪрпВроЯрпБ
ЁЯММ => ЁЯММ, роЗро░ро╡рпБ
ЁЯОа => ЁЯОа, роХрпЗро░ро╛роЪрпВро▓рпН, роХрпБродро┐ро░рпИ, рокрпКро┤рпБродрпБрокрпЛроХрпНроХрпБ, роЗро░ро╛роЯрпНроЯро┐ройроорпН
ЁЯОб => ЁЯОб, роГрокрпЖро░рпНро░ро┐ро╕рпН, роЪроХрпНроХро░роорпН, рокрпКро┤рпБродрпБрокрпЛроХрпНроХрпБ рокрпВроЩрпНроХро╛, рокрпКро┤рпБродрпБрокрпЛроХрпНроХрпБ, рокрпВроЩрпНроХро╛
ЁЯОв => ЁЯОв, ро░рпЛро▓ро░рпН, роХрпЛро╕рпНроЯро░рпН, рокрпКро┤рпБродрпБрокрпЛроХрпНроХрпБрокрпН рокрпВроЩрпНроХро╛, рокрпВроЩрпНроХро╛, рокрпКро┤рпБродрпБрокрпЛроХрпНроХрпБ
ЁЯТИ => ЁЯТИ, рокро╛ро░рпНрокро░рпН роХроЯрпИ, роорпБроЯро┐родро┐ро░рпБродрпНродрпБрокро╡ро░рпН, роорпБроЯро┐родро┐ро░рпБродрпНродрпБродро▓рпН, роорпБроЯро┐родро┐ро░рпБродрпНродрпБроорпН роХроЯрпИ
ЁЯОк => ЁЯОк, роЪро░рпНроХрпНроХро╕рпН, роХрпВроЯро╛ро░роорпН, рокрпКро┤рпБродрпБрокрпЛроХрпНроХрпБ, роороХро┐ро┤рпНроЪрпНроЪро┐
ЁЯОн => ЁЯОн, роиро┐роХро┤рпНроЪрпНроЪро┐, роироЯройроорпН, роиро╛роЯроХроорпН, роХро▓рпИ, рокрпКро┤рпБродрпБрокрпЛроХрпНроХрпБ
ЁЯЦ╝ => ЁЯЦ╝, рокроЯ роГрокро┐ро░рпЗроорпН, рокроЯроорпН
ЁЯОи => ЁЯОи, рокрпЖропро┐рогрпНроЯрпН родроЯрпНроЯрпБ, родроЯрпНроЯрпБ, роХро▓рпИроЮро░рпН, рокрпЖропро┐рогрпНроЯрпН, роХро▓рпИ, роЖро░рпНроЯрпН, роУро╡ро┐ропроорпН
ЁЯО░ => ЁЯО░, ро╕рпНро▓ро╛роЯрпН роЗропроирпНродро┐ро░роорпН, ро╕рпНро▓ро╛роЯрпН, ро╡ро┐ро│рпИропро╛роЯрпНроЯрпБ
ЁЯЪВ => ЁЯЪВ, родрпКроЯро░рпН ро╡рогрпНроЯро┐
ЁЯЪГ => ЁЯЪГ, рооро┐ройрпНроЪро╛ро░ роЗро░ропро┐ро▓рпН ро╡рогрпНроЯро┐, ро░ропро┐ро▓рпН, рооро┐ройрпНроЪро╛ро░ ро░ропро┐ро▓рпН
ЁЯЪД => ЁЯЪД, ро╡ро┐ро░рпИро╡рпБ роЗро░ропро┐ро▓рпН, ро╡ро┐ро░рпИро╡рпБ ро░ропро┐ро▓рпН, ро╡ро┐ро░рпИро╡рпБ ро░ропро┐ро▓рпН ро╡рогрпНроЯро┐
ЁЯЪЕ => ЁЯЪЕ, рокрпБро▓рпНро▓рпЖроЯрпН роЗро░ропро┐ро▓рпН, рокрпБро▓рпНро▓рпЖроЯрпН роЗро░ропро┐ро▓рпН ро╡рогрпНроЯро┐, рокрпБро▓рпНро▓рпЖроЯрпН ро░ропро┐ро▓рпН, рокрпБро▓рпНро▓рпЖроЯрпН ро░ропро┐ро▓рпН ро╡рогрпНроЯро┐
ЁЯЪЖ => ЁЯЪЖ, роЗро░ропро┐ро▓рпН ро╡рогрпНроЯро┐, ро░ропро┐ро▓рпН, ро░ропро┐ро▓рпН ро╡рогрпНроЯро┐
ЁЯЪЗ => ЁЯЪЗ, роорпЖроЯрпНро░рпЛ ро░ропро┐ро▓рпН ро╡рогрпНроЯро┐, роорпЖроЯрпНро░рпЛ роЗро░ропро┐ро▓рпН, роорпЖроЯрпНро░рпЛ роЗро░ропро┐ро▓рпН ро╡рогрпНроЯро┐
ЁЯЪИ => ЁЯЪИ, роЗро░ропро┐ро▓рпН, ро░ропро┐ро▓рпН
ЁЯЪЙ => ЁЯЪЙ, роЗро░ропро┐ро▓рпН роиро┐ро▓рпИропроорпН
ЁЯЪК => ЁЯЪК, роЯро┐ро░ро╛роорпН ро╡рогрпНроЯро┐
ЁЯЪЭ => ЁЯЪЭ, роорпЛройрпЛро░ропро┐ро▓рпН ро╡рогрпНроЯро┐
ЁЯЪЮ => ЁЯЪЮ, рооро▓рпИ ро░ропро┐ро▓рпН
ЁЯЪЛ => ЁЯЪЛ, роЯро┐ро░ро╛роорпН, роЯро┐ро░ро╛роорпН ро╡ро╛роХройроорпН
ЁЯЪМ => ЁЯЪМ, рокро╕рпН
ЁЯЪН => ЁЯЪН, рокрпЗро░рпБроирпНродрпБ ро╡роирпНродрпБроХрпКрогрпНроЯро┐ро░рпБроХрпНроХро┐ро▒родрпБ
ЁЯЪО => ЁЯЪО, роЯрпНро░ро╛ро▓ро┐рокро╕рпН, рооро┐ройрпНроЪро╛ро░ рокро╕рпН
ЁЯЪП => ЁЯЪП, рокро╕рпН ро╕рпНроЯро╛рокрпН
ЁЯЪР => ЁЯЪР, рооро┐ройро┐ рокро╕рпН
ЁЯЪС => ЁЯЪС, роЖроорпНрокрпБро▓ройрпНро╕рпН, ро╡ро╛роХройроорпН, роЕро╡роЪро░роорпН, ро╡ро┐рокродрпНродрпБ
ЁЯЪТ => ЁЯЪТ, родрпАропрогрпИрокрпНрокрпБ ро╡рогрпНроЯро┐
ЁЯЪУ => ЁЯЪУ, ро░рпЛроирпНродрпБ ро╡рогрпНроЯро┐, рокрпЛро▓рпАро╕рпН роХро╛ро░рпН
ЁЯЪФ => ЁЯЪФ, ро╡роирпНродрпБроХрпКрогрпНроЯро┐ро░рпБроХрпНроХрпБроорпН рокрпЛро▓рпАро╕рпН ро╡рогрпНроЯро┐, рокрпЛро▓рпАро╕рпН ро╡рогрпНроЯро┐ ро╡роирпНродрпБроХрпКрогрпНроЯро┐ро░рпБроХрпНроХро┐ро▒родрпБ
ЁЯЪХ => ЁЯЪХ, роЯро╛роХрпНро╕ро┐
ЁЯЪЦ => ЁЯЪЦ, ро╡ро╛роЯроХрпИ роЯро╛роХрпНроЪро┐
ЁЯЪЧ => ЁЯЪЧ, роорпЛроЯрпНроЯро╛ро░рпН ро╡ро╛роХройроорпН, роорпЛроЯрпНроЯро╛ро░рпН ро╡рогрпНроЯро┐
ЁЯЪШ => ЁЯЪШ, ро╡роирпНродрпБроХрпКрогрпНроЯро┐ро░рпБроХрпНроХрпБроорпН роорпЛроЯрпНроЯро╛ро░рпН ро╡рогрпНроЯро┐, роХро╛ро░рпН ро╡роирпНродрпБроХрпКрогрпНроЯро┐ро░рпБроХрпНроХро┐ро▒родрпБ, роорпЛроЯрпНроЯро╛ро░рпН ро╡рогрпНроЯро┐ ро╡роирпНродрпБроХрпКрогрпНроЯро┐ро░рпБроХрпНроХро┐ро▒родрпБ
ЁЯЪЩ => ЁЯЪЩ, роиро╡рпАрой ро╡роЪродро┐роХро│рпН роХрпКрогрпНроЯ рокрпЗро░рпБроирпНродрпБ
ЁЯЪЪ => ЁЯЪЪ, роЯро┐ро░роХрпН, роЪро░роХрпНроХрпБ ро▓ро╛ро░ро┐
ЁЯЪЫ => ЁЯЪЫ, ро▓ро╛ро░ро┐, роХройро░роХ ро╡ро╛роХройроорпН
ЁЯЪЬ => ЁЯЪЬ, роЯро┐ро░ро╛роХрпНроЯро░рпН ро╡рогрпНроЯро┐
ЁЯЪ▓ => ЁЯЪ▓, роЪрпИроХрпНроХро┐ро│рпН ро╡рогрпНроЯро┐
тЫ╜ => тЫ╜, роОро░ро┐ро╡ро╛ропрпБ, роОро░ро┐рокрпКро░рпБро│рпН
ЁЯЫг => ЁЯЫг, роЪро╛ро▓рпИ
ЁЯЫд => ЁЯЫд, родрогрпНроЯро╡ро╛ро│роорпН, роЗро░ропро┐ро▓рпН
ЁЯЪи => ЁЯЪи, рокрпЛро▓рпАро╕рпН роХро╛ро░рпНроХро│ро┐ро▓рпН роЪрпБро┤ро▓рпБроорпН ро╡ро┐ро│роХрпНроХрпБ, рокрпЛро▓рпАро╕рпН ро╡рогрпНроЯро┐ ро╡ро┐ро│роХрпНроХрпБ
ЁЯЪе => ЁЯЪе, роЯрпНро░ро╛роГрокро┐роХрпН ро▓рпИроЯрпНроЯрпБроХро│рпН, роЯрпНро░ро╛роГрокро┐роХрпН роЪро┐роХрпНройро▓рпНроХро│рпН, роЯрпНро░ро╛роГрокро┐роХрпН ро╡ро┐ро│роХрпНроХрпБроХро│рпН
ЁЯЪж => ЁЯЪж, роЯрпНро░ро╛роГрокро┐роХрпН ро▓рпИроЯрпНроЯрпБроХро│рпН, роЯрпНро░ро╛роГрокро┐роХрпН роЪро┐роХрпНройро▓рпНроХро│рпН, роЯрпНро░ро╛роГрокро┐роХрпН ро╡ро┐ро│роХрпНроХрпБроХро│рпН
ЁЯЪз => ЁЯЪз, роХроЯрпНроЯрпБрооро╛рой роЪро┐ройрпНройроорпН, роХроЯрпНроЯрпБрооро╛рой рокрогро┐ роироЯрпИрокрпЖро▒рпБроХро┐ро▒родрпБ
тЪУ => тЪУ, роЖроЩрпНроХро░рпН, роХро░рпБро╡ро┐
тЫ╡ => тЫ╡, роЪрпБро▒рпНро▒рпБро▓ро╛, ро░ро┐роЪро╛ро░рпНроЯрпН, роХроЯро▓рпН рокропрогроорпН
ЁЯЪг => ЁЯЪг, рокроЯроХрпБ
ЁЯЪгтАНтЩА => ЁЯЪгтАНтЩА, рокроЯроХрпБ, рокрпЖрогрпН
ЁЯЪгтАНтЩВ => ЁЯЪгтАНтЩВ, рокроЯроХрпБ, роЖрогрпН
ЁЯЪд => ЁЯЪд, роХроЯро▓рпН рокропрогроорпН
ЁЯЫ│ => ЁЯЫ│, роХрокрпНрокро▓рпН, роХроЯро▓рпН рокропрогроорпН
тЫ┤ => тЫ┤, роХрокрпНрокро▓рпН, рокроЯроХрпБ, роХроЯро▓рпН рокропрогроорпН
ЁЯЫе => ЁЯЫе, рокроЯроХрпБ, роХроЯро▓рпН рокропрогроорпН
ЁЯЪв => ЁЯЪв, роХроЯро▓рпН рокропрогроорпН
тЬИ => тЬИ, ро╡ро╛ройрпНро╡ро┤ро┐рокрпН рокропрогроорпН
ЁЯЫй => ЁЯЫй, ро╡ро┐рооро╛ройроорпН, ро╡ро╛ройрпНро╡ро┤ро┐рокрпН рокропрогроорпН
ЁЯЫл => ЁЯЫл, рокро┐ро│рпИроЯрпН роЯрпЗроХрпН роЖроГрокрпН, роЪрпЖроХрпН-роЗройрпН, ро╡ро┐рооро╛ройроорпН рокрпБро▒рокрпНрокроЯрпБродро▓рпН, ро╡ро┐рооро╛ройроорпН
ЁЯЫм => ЁЯЫм, рокро┐ро│рпИроЯрпН ро▓рпЗрогрпНроЯро┐роЩрпН, ро╡ро┐рооро╛рой ро╡ро░рпБроХрпИ, ро╡ро┐рооро╛ройроорпН
ЁЯТ║ => ЁЯТ║, роЪрпАроЯрпН
ЁЯЪБ => ЁЯЪБ, ро╡ро╛ройрпНро╡ро┤ро┐рокрпН рокропрогроорпН
ЁЯЪЯ => ЁЯЪЯ, родрпКроЩрпНроХрпБ ро░ропро┐ро▓рпН
ЁЯЪа => ЁЯЪа, рооро▓рпИ роХрпЗрокро┐ро│рпНро╡ро┤ро┐ рокропрогроорпН
ЁЯЪб => ЁЯЪб, ро░рпЛрокрпН роХро╛ро░рпН
ЁЯЪА => ЁЯЪА, ро░ро╛роХрпНроХрпЖроЯрпН, ро╡ро┐рогрпНро╡рпЖро│ро┐ ро░ро╛роХрпНроХрпЖроЯрпН
ЁЯЫ░ => ЁЯЫ░, ро╡ро┐рогрпНро╡рпЖро│ро┐, ро╡ро┐рогрпНро╡рпЖро│ро┐ роЗропроирпНродро┐ро░роорпН
ЁЯЫО => ЁЯЫО, роЕро┤рпИрокрпНрокрпБ роорогро┐
ЁЯЪк => ЁЯЪк, рооро░рокрпНрокрпКро░рпБро│рпН, роорпБроЯро┐роирпНродродрпБ
ЁЯЫМ => ЁЯЫМ, рокроЯрпБродрпНродро┐ро░рпБрокрпНрокро╡ро░рпН, родрпВроХрпНроХроорпН, ро╡ро┐роЯрпБродро┐
ЁЯЫП => ЁЯЫП, родрпВроХрпНроХроорпН, ро╡ро┐роЯрпБродро┐
ЁЯЫЛ => ЁЯЫЛ, рооро┐ройрпНро╡ро┐ро│роХрпНроХрпБроЯройрпН рокроЯрпБроХрпНроХрпИ, рокроЯрпБроХрпНроХрпИ, рооро┐ройрпНро╡ро┐ро│роХрпНроХрпБ
ЁЯЪ╜ => ЁЯЪ╜, роХро┤ро┐рокрпНрокро▒рпИ, роЯро╛ропрпНро▓роЯрпН
ЁЯЪ┐ => ЁЯЪ┐, ро╖ро╡ро░рпН роХрпБро│ро┐ропро▓рпН
ЁЯЫА => ЁЯЫА, роХрпБро│ро┐ропро▓рпН родрпКроЯрпНроЯро┐
ЁЯЫБ => ЁЯЫБ, роХрпБро│ро┐ропро▓ро▒рпИ, родрпКроЯрпНроЯро┐
тМЫ => тМЫ, роирпЗро░роорпН, роХроЯро┐роХро╛ро░роорпН
тП│ => тП│, роорогро▒рпНроХроЯро┐роХро╛ро░роорпН, роХроЯро┐роХро╛ро░роорпН, роирпЗро░роорпН
тМЪ => тМЪ, роирпЗро░роорпН, роХроЯро┐роХро╛ро░роорпН
тП░ => тП░, роХроЯро┐роХро╛ро░роорпН, роЕро▓ро╛ро░ роХроЯро┐роХро╛ро░роорпН
тП▒ => тП▒, роХроЯро┐роХро╛ро░роорпН
тП▓ => тП▓, роЯрпИрооро░рпН, роХроЯро┐роХро╛ро░роорпН
ЁЯХ░ => ЁЯХ░, роХроЯро┐роХро╛ро░роорпН
ЁЯХЫ => ЁЯХЫ, 12:00
ЁЯХз => ЁЯХз, 12:30
ЁЯХР => ЁЯХР, роЙроЪрпНроЪро┐ роирпЗро░роорпН, 1:00
ЁЯХЬ => ЁЯХЬ, 1:30
ЁЯХС => ЁЯХС, 2:00
ЁЯХЭ => ЁЯХЭ, 2:30
ЁЯХТ => ЁЯХТ, 3:00
ЁЯХЮ => ЁЯХЮ, 3:30
ЁЯХУ => ЁЯХУ, 4:00
ЁЯХЯ => ЁЯХЯ, 4:30
ЁЯХФ => ЁЯХФ, 5:00
ЁЯХа => ЁЯХа, 5:30
ЁЯХХ => ЁЯХХ, 6:00
ЁЯХб => ЁЯХб, 6:30
ЁЯХЦ => ЁЯХЦ, 7:00
ЁЯХв => ЁЯХв, 7:30
ЁЯХЧ => ЁЯХЧ, 8:00
ЁЯХг => ЁЯХг, 8:30
ЁЯХШ => ЁЯХШ, 9:00
ЁЯХд => ЁЯХд, 9:30
ЁЯХЩ => ЁЯХЩ, 10:00
ЁЯХе => ЁЯХе, 10:30
ЁЯХЪ => ЁЯХЪ, 11:00
ЁЯХж => ЁЯХж, 11:30
ЁЯМС => ЁЯМС, роЗро░ро╡рпБ, роиро┐ро▓ро╛, роЗро░рпБро│рпН
ЁЯМТ => ЁЯМТ, рокро┐ро▒рпИроиро┐ро▓ро╡рпБ, роиро┐ро▓ро╛, роЗро░ро╡рпБ
ЁЯМУ => ЁЯМУ, роиро┐ро▓ро╛, роЕро░рпИроиро┐ро▓ро╡рпБ, роЗро░ро╡рпБ, ро╡ро│ро░рпНрокро┐ро▒рпИ
ЁЯМФ => ЁЯМФ, ро╡ро│ро░рпНрокро┐ро▒рпИ, рокро┐ро▒рпИроиро┐ро▓ро╡рпБ, роиро┐ро▓ро╛, роЗро░ро╡рпБ, роиро┐ро▓ро╡рпКро│ро┐
ЁЯМХ => ЁЯМХ, роорпБро┤рпБроиро┐ро▓ро╡рпБ, роЗро░ро╡рпБ, роиро┐ро▓ро╡рпКро│ро┐
ЁЯМЦ => ЁЯМЦ, родрпЗропрпНрокро┐ро▒рпИ, роЗро░ро╡рпБ, роиро┐ро▓ро╡рпКро│ро┐, роиро┐ро▓ро╛
ЁЯМЧ => ЁЯМЧ, родрпЗропрпНрокро┐ро▒рпИ, роЕро░рпИроиро┐ро▓ро╡рпБ, роиро┐ро▓ро╛, роЗро░ро╡рпБ
ЁЯМШ => ЁЯМШ, родрпЗропрпНрокро┐ро▒рпИ, рокро┐ро▒рпИроиро┐ро▓ро╡рпБ, роиро┐ро▓ро╛, роЗро░ро╡рпБ
ЁЯМЩ => ЁЯМЩ, роиро┐ро▓ро╛, роиро┐ро▓ро╡рпКро│ро┐, родрпЗропрпНрокро┐ро▒рпИ, ро╡ро│ро░рпНрокро┐ро▒рпИ
ЁЯМЪ => ЁЯМЪ, роЕрооро╛ро╡ро╛роЪрпИ, роорпБроХроорпН, роХро░рпБрокрпНрокрпБ роорпБроХроорпН
ЁЯМЫ => ЁЯМЫ, роиро┐ро▓ро╛ роорпБроХроорпН, ро╡ро│ро░рпНрокро┐ро▒рпИ роорпБроХроорпН, роорпБроХроорпН, роиро┐ро▓ро╛
ЁЯМЬ => ЁЯМЬ, роиро┐ро▓ро╛ роорпБроХроорпН, родрпЗропрпНрокро┐ро▒рпИ роорпБроХроорпН, роорпБроХроорпН, роиро┐ро▓ро╛
ЁЯМб => ЁЯМб, роЙроЯро▓рпНроиро┐ро▓рпИ
тША => тША, ро╡рпЖрокрпНрокроиро┐ро▓рпИ, роЪрпВро░ро┐роп роХродро┐ро░рпН, рокро┐ро░роХро╛роЪроорпН
ЁЯМЭ => ЁЯМЭ, рокрпМро░рпНрогрооро┐, роорпБроХроорпН, роиро┐ро▓ро╛
ЁЯМЮ => ЁЯМЮ, роЪрпВро░ро┐ропройрпН, роорпБроХроорпН
тнР => тнР, ро╡рпЖро│ро┐ро░рпНроиро┐ро▒ роироЯрпНроЪродрпНродро┐ро░роорпН, роироЯрпНроЪродрпНродро┐ро░роорпН
ЁЯМЯ => ЁЯМЯ, роироЯрпНроЪродрпНродро┐ро░роорпН, родро┐ро▒роорпИ
ЁЯМа => ЁЯМа, роироЯрпНроЪродрпНродро┐ро░роорпН, роЗро░ро╡рпБ
тШБ => тШБ, роорпЗроХроорпВроЯрпНроЯроорпН, ро╡ро╛ройро┐ро▓рпИ, ро╡рпЖрокрпНрокроиро┐ро▓рпИ
тЫЕ => тЫЕ, роорпЗроХродрпНродро┐ройрпН рокро┐ройрпНройро╛ро▓рпН рооро▒рпИроирпНродро┐ро░рпБроХрпНроХрпБроорпН роЪрпВро░ро┐ропройрпН, роЗропро▒рпНроХрпИ роХро╛роЯрпНроЪро┐, роЪрпВро░ро┐ропройрпИ роорпЗроХроорпН роорпВроЯро┐ропро┐ро░рпБрокрпНрокродрпБ рокрпЛройрпНро▒ роХро╛роЯрпНроЪро┐
тЫИ => тЫИ, ро╡ро╛ройро┐ро▓рпИ, ро╡рпЖрокрпНрокроиро┐ро▓рпИ
ЁЯМд => ЁЯМд, ро╡рпЖрокрпНрокроиро┐ро▓рпИ, роорпЗроХроорпН, роЪрпВро░ро┐ропройрпН
ЁЯМе => ЁЯМе, ро╡рпЖрокрпНрокроиро┐ро▓рпИ, роорпЗроХроорпН, роЪрпВро░ро┐ропройрпН
ЁЯМж => ЁЯМж, ро╡рпЖрокрпНрокроиро┐ро▓рпИ, роорпЗроХроорпН, роЪрпВро░ро┐ропройрпН, рооро┤рпИ
ЁЯМз => ЁЯМз, ро╡рпЖрокрпНрокроиро┐ро▓рпИ, роорпЗроХроорпН, рооро┤рпИ
ЁЯМи => ЁЯМи, рокройро┐рокрпКро┤ро┐ро╡рпБ, роорпЗроХроорпН, ро╡рпЖрокрпНрокроиро┐ро▓рпИ
ЁЯМй => ЁЯМй, рооро┐ройрпНройро▓рпН, роорпЗроХроорпН, ро╡рпЖрокрпНрокроиро┐ро▓рпИ
ЁЯМк => ЁЯМк, ро╡рпЖрокрпНрокроиро┐ро▓рпИ
ЁЯМл => ЁЯМл, ро╡рпЖрокрпНрокроиро┐ро▓рпИ
ЁЯМм => ЁЯМм, роХро╛ро▒рпНро▒рпБ ро╡рпАроЪрпБродро▓рпН, роХро╛ро▒рпНро▒рпБ, ро╡рпЖрокрпНрокроиро┐ро▓рпИ
ЁЯМА => ЁЯМА, роЪрпБро┤ро▒рпНроХро╛ро▒рпНро▒рпБ, рокро┤рпИроп роиро┐ройрпИро╡рпБ
ЁЯМИ => ЁЯМИ, ро╡рогрпНрогроорпН
ЁЯМВ => ЁЯМВ, роХрпБроЯрпИ, рооро┤рпИ, ро╡рпЖропро┐ро▓рпН
тШВ => тШВ, рооро┤рпИ, ро╡рпЖропро┐ро▓рпН
тШФ => тШФ, рооро┤рпИродрпН родрпБро│ро┐, роХрпБроЯрпИ, рооро┤рпИ
тЫ▒ => тЫ▒, роХрпБроЯрпИ, рооро┤рпИ, ро╡рпЖропро┐ро▓рпН, ро╡рпЖрокрпНрокроиро┐ро▓рпИ, роиро┐ро┤ро▓рпН
тЪб => тЪб, роЙропро░рпН рооро┐ройрпНройро┤рпБродрпНрод роЕрокро╛ропроорпН, роЙропро░рпН рооро┐ройрпНройро┤рпБродрпНрод роЪро┐ройрпНройроорпН, рооро┐ройрпНройро┤рпБродрпНродроорпН
тЭД => тЭД, ро╕рпНройрпЛрокро┐ро│ро╛роХрпН, рокройро┐, роХрпБро│ро┐ро░рпНроХро╛ро▓роорпН, ро╡рпЖрокрпНрокроиро┐ро▓рпИ
тШГ => тШГ, рокройро┐, рокройро┐рокрпКро┤ро┐ро╡рпБ, роХрпБро│ро┐ро░рпНроХро╛ро▓роорпН, ро╡рпЖрокрпНрокроиро┐ро▓рпИ
тЫД => тЫД, роХро╛ро░рпНроЯрпНроЯрпВройрпН, ро╕рпНройрпЛроорпЗройрпН, роХрпБро│ро┐ро░рпНроХро╛ро▓роорпН, ро╡рпЖрокрпНрокроиро┐ро▓рпИ
тШД => тШД, ро╡ро╛ройроорпН, ро╡ро┐рогрпНро╡рпЖро│ро┐
ЁЯФе => ЁЯФе, роирпЖро░рпБрокрпНрокрпБ
ЁЯТз => ЁЯТз, ро╡ро┐ропро░рпНро╡рпИроЪрпН роЪрпКроЯрпНроЯрпБродро▓рпН, ро╡ро┐ропро░рпНродрпНродрпБроХрпНроХрпКроЯрпНроЯрпБродро▓рпН, роироХрпИроЪрпНроЪрпБро╡рпИ, роЙрогро░рпНроЪрпНроЪро┐, роЙрогро░рпНро╡рпБ
ЁЯМК => ЁЯМК, роЕро▓рпИ роУроЪрпИ, роЕро▓рпИ, роирпАро░ро▓рпИ
ЁЯОГ => ЁЯОГ, ро╣рпЗро▓рпЛро╡ро┐ройрпН, роХрпКрогрпНроЯро╛роЯрпНроЯроорпН, рокрпВроЪрогро┐роХрпНроХро╛ропрпН
ЁЯОД => ЁЯОД, рооро░роорпН, рокроЪрпБроорпИ, роХро┐ро▒ро┐ро╕рпНродрпБрооро╕рпН роХро╛ро▓роорпН
ЁЯОЖ => ЁЯОЖ, роХрпКрогрпНроЯро╛роЯрпНроЯроорпН, роТро│ро┐, роЪродрпНродроорпН, рокрогрпНроЯро┐роХрпИ
ЁЯОЗ => ЁЯОЗ, роХрпКрогрпНроЯро╛роЯрпНроЯроорпН, роТро│ро┐, рокрогрпНроЯро┐роХрпИ
тЬи => тЬи, роироЯрпНроЪродрпНродро┐ро░роорпН, роХрпКрогрпНроЯро╛роЯрпНроЯроорпН
ЁЯОИ => ЁЯОИ, ро╣рпАро▓ро┐ропроорпН, роХрпКрогрпНроЯро╛роЯрпНроЯроорпН, родро┐ро░рпБро╡ро┐ро┤ро╛, роХрпБро┤роирпНродрпИроХро│рпН
ЁЯОЙ => ЁЯОЙ, ро╡ро┐ро░рпБроирпНродрпБ, ро╡рпЖро▒рпНро▒ро┐ роЕро▒ро┐ро╡ро┐рокрпНрокрпБ, роХрпКрогрпНроЯро╛роЯрпНроЯроорпН
ЁЯОК => ЁЯОК, ро╡ро╛ро┤рпНродрпНродрпБроХро│рпН, рокро┐ро▒роирпНродроиро╛ро│рпН, родро┐ро░рпБроорогроорпН, роХрпКрогрпНроЯро╛роЯрпНроЯроорпН
ЁЯОЛ => ЁЯОЛ, роорпВроЩрпНроХро┐ро▓рпН рооро░роорпН, роорпВроЩрпНроХро┐ро▓рпН рооро░родрпНродро┐ро▓рпН роХро╛роХро┐родродрпНродрпИроХрпН роХроЯрпНроЯрпБродро▓рпН, роХро╛родро┐роХродрпН родрпБрогрпНроЯрпБроХро│рпН, роХрпКрогрпНроЯро╛роЯрпНроЯроорпН, родро┐ро░рпБро╡ро┐ро┤ро╛
ЁЯОМ => ЁЯОМ, роХрпБро▒рпБроХрпНроХрпЗ роХроЯрпНроЯрокрпНрокроЯрпНроЯ роЬрокрпНрокро╛ройрпН роХрпКроЯро┐роХро│рпН, роХрпКроЯро┐роХро│рпН, роХрпКроЯро┐, роЬрокрпНрокро╛ройрпН, роХрпКрогрпНроЯро╛роЯрпНроЯроорпН, родро┐ро░рпБро╡ро┐ро┤ро╛
ЁЯОН => ЁЯОН, рокрпБродрпНродро╛рогрпНроЯрпБ, рокрпБродрпБ ро╡ро░рпБроЯрокрпН рокро┐ро▒рокрпНрокрпБ, роЬрокрпНрокро╛ройрпН, рокрпИройрпН, роХрпКрогрпНроЯро╛роЯрпНроЯроорпН, родро┐ро░рпБро╡ро┐ро┤ро╛
ЁЯОО => ЁЯОО, рокрпКроорпНроорпИроХро│рпН, рокрпКроорпНроорпИ родро┐ро░рпБро╡ро┐ро┤ро╛, родро┐ро░рпБро╡ро┐ро┤ро╛, роЬрокрпНрокро╛ройрпН родро┐ро░рпБро╡ро┐ро┤ро╛, роХрпКрогрпНроЯро╛роЯрпНроЯроорпН
ЁЯОП => ЁЯОП, роХрпЖрогрпНроЯрпИ роорпАройрпН, роЬрокрпНрокро╛ройрпН роиро╛роЯрпНроЯро┐ройрпН роХрпБро┤роирпНродрпИроХро│рпН родро┐ройроорпН, роХрпКрогрпНроЯро╛роЯрпНроЯроорпН, ро╡ро┐роЯрпБроорпБро▒рпИ
ЁЯОР => ЁЯОР, роорогро┐ропрпЛроЪрпИ, роУроЪрпИ
ЁЯОС => ЁЯОС, роиро┐ро▓ро╡ро┐ро▒рпНроХрпБрокрпН рокроЯрпИродрпНродро▓рпН, роиро┐ро▓ро╡рпБ, рокроЯрпИродрпНродро▓рпН, роХрпКрогрпНроЯро╛роЯрпНроЯроорпН
ЁЯОА => ЁЯОА, роХрпКрогрпНроЯро╛роЯрпНроЯроорпН, ро╡ро┐ро░рпБроирпНродрпБ, родро┐ро▒рокрпНрокрпБ ро╡ро┐ро┤ро╛
ЁЯОБ => ЁЯОБ, рокро░ро┐роЪрпБ, роХрпКрогрпНроЯро╛роЯрпНроЯроорпН
ЁЯОЦ => ЁЯОЦ, ро╡ро┐ро░рпБродрпБ, роЪро┐ро▒рокрпНрокро┐родрпНродро▓рпН
ЁЯОЧ => ЁЯОЧ, ро░ро┐роорпИройрпНроЯро░рпН, ро░ро┐рокрпНрокройрпН, роЪро┐ро▒рокрпНрокро┐родрпНродро▓рпН
ЁЯОЮ => ЁЯОЮ, роорпВро╡ро┐, роГрокро┐ро░рпЗроорпНроХро│рпН, роЪро┐ройро┐рооро╛
ЁЯОЯ => ЁЯОЯ, роирпБро┤рпИро╡рпБ роЯро┐роХрпНроХрпЖроЯрпН
ЁЯОл => ЁЯОл, роирпБро┤рпИро╡рпБроЪрпНроЪрпАроЯрпНроЯрпБ, рокрпКро┤рпБродрпБрокрпЛроХрпНроХрпБ
ЁЯП╖ => ЁЯП╖, ро▓рпЗрокро┐ро│рпН, роороЮрпНроЪро│рпН, роЕроЯрпНроЯрпИ
тЪ╜ => тЪ╜, ро╡ро┐ро│рпИропро╛роЯрпНроЯрпБ
тЪ╛ => тЪ╛, ро╡ро┐ро│рпИропро╛роЯрпНроЯрпБ
ЁЯПА => ЁЯПА, рокрпЗро╕рпНроХроЯрпН рокро╛ро▓рпН, ро╡ро┐ро│рпИропро╛роЯрпНроЯрпБ
ЁЯПИ => ЁЯПИ, рокроирпНродрпБ, ро╡ро┐ро│рпИропро╛роЯрпНроЯрпБ
ЁЯПЙ => ЁЯПЙ, роХро╛ро▓рпНрокроирпНродрпБ, ро░роХрпНрокро┐, ро╡ро┐ро│рпИропро╛роЯрпНроЯрпБ
ЁЯО╛ => ЁЯО╛, роЯрпЖройрпНройро┐ро╕рпН рокроирпНродрпБ, роЯрпЖройрпНройро┐ро╕рпН роороЯрпНроЯрпИ, ро╡ро┐ро│рпИропро╛роЯрпНроЯрпБ
ЁЯО▒ => ЁЯО▒, роОроЯрпНроЯрпБ рокроирпНродрпБ, ро╡ро┐ро│рпИропро╛роЯрпНроЯрпБ, роЙро│рпНро│ро░роЩрпНроХ ро╡ро┐ро│рпИропро╛роЯрпНроЯрпБ
ЁЯО│ => ЁЯО│, рокро╡рпБро▓ро┐роЩрпН, рокро╡рпБро▓ро┐роЩрпН рокро╛ро▓рпН, рокроирпНродрпБ, ро╡ро┐ро│рпИропро╛роЯрпНроЯрпБ
тЫ│ => тЫ│, ро╡ро┐ро│рпИропро╛роЯрпНроЯрпБ, роХрпКроЯро┐
ЁЯПМ => ЁЯПМ, роХрпЛро▓рпНроГрокрпН, ро╡ро┐ро│рпИропро╛роЯрпНроЯрпБ
ЁЯПМтАНтЩА => ЁЯПМтАНтЩА, роХрпЛро▓рпНроГрокрпН, ро╡ро┐ро│рпИропро╛роЯрпНроЯрпБ, рокрпЖрогрпН
ЁЯПМтАНтЩВ => ЁЯПМтАНтЩВ, роХрпЛро▓рпНроГрокрпН, ро╡ро┐ро│рпИропро╛роЯрпНроЯрпБ, роЖрогрпН
тЫ╕ => тЫ╕, роРро╕рпН ро╕рпНроХрпЗроЯрпНроЯро┐роЩрпН
ЁЯОг => ЁЯОг, роорпАройрпНродрпВрогрпНроЯро┐ро▓рпБроорпН роорпАройрпБроорпН, роорпАройрпН, роУропрпНро╡рпБ, роорпАройрпН родрпВрогрпНроЯро┐ро▓рпН, рокрпВроЩрпНроХро╛, рокрпКро┤рпБродрпБрокрпЛроХрпНроХрпБ, роирпАро░рпН
ЁЯО╜ => ЁЯО╜, ро╡ро┐ро│рпИропро╛роЯрпНроЯрпБ, ро╡ро┐ро│рпИропро╛роЯрпНроЯрпБ ро╡рпАро░ро░рпБроХрпНроХро╛рой роЖроЯрпИ
ЁЯО┐ => ЁЯО┐, ро╕рпНроХрпА, рокройро┐роЪрпНроЪро▒рпБроХрпНроХрпБ рокро▓роХрпИ, ро╡ро┐ро│рпИропро╛роЯрпНроЯрпБ
тЫ╖ => тЫ╖, рокройро┐роЪрпНроЪро▒рпБроХрпНроХрпБ, ро╡ро┐ро│рпИропро╛роЯрпНроЯрпБ
ЁЯПВ => ЁЯПВ, рокройро┐роЪрпНроЪро▒рпБроХрпНроХрпБ ро╡рпАро░ро░рпН, рокройро┐роЪрпНроЪро▒рпБроХрпНроХрпБ, ро╕рпНройрпЛрокрпЛро░рпНроЯро┐роЩрпН, ро╡ро┐ро│рпИропро╛роЯрпНроЯрпБ
ЁЯПД => ЁЯПД, роЪро░рпНрокро┐роЩрпН, ро╡ро┐ро│рпИропро╛роЯрпНроЯрпБ
ЁЯПДтАНтЩА => ЁЯПДтАНтЩА, роЕро▓рпИроЪрпНроЪро▒рпБроХрпНроХрпБ, ро╡ро┐ро│рпИропро╛роЯрпНроЯрпБ, роЪро░рпНроГрокро┐роЩрпН, рокрпЖрогрпН
ЁЯПДтАНтЩВ => ЁЯПДтАНтЩВ, роЕро▓рпИроЪрпНроЪро▒рпБроХрпНроХрпБ, ро╡ро┐ро│рпИропро╛роЯрпНроЯрпБ, роЪро░рпНроГрокро┐роЩрпН, роЖрогрпН
ЁЯПЗ => ЁЯПЗ, роХрпБродро┐ро░рпИрокрпН рокроирпНродрпИропроорпН, роЬро╛роХрпНроХро┐, роХрпБродро┐ро░рпИ, ро╡ро┐ро│рпИропро╛роЯрпНроЯрпБ
ЁЯПК => ЁЯПК, роирпАроЪрпНроЪро▓рпН, ро╡ро┐ро│рпИропро╛роЯрпНроЯрпБ
ЁЯПКтАНтЩА => ЁЯПКтАНтЩА, роирпАроЪрпНроЪро▓рпН, рокрпЖрогрпН, ро╡ро┐ро│рпИропро╛роЯрпНроЯрпБ
ЁЯПКтАНтЩВ => ЁЯПКтАНтЩВ, роирпАроЪрпНроЪро▓рпН, роЖрогрпН, ро╡ро┐ро│рпИропро╛роЯрпНроЯрпБ
тЫ╣ => тЫ╣, рокроирпНродрпБ, ро╡ро┐ро│рпИропро╛роЯрпНроЯрпБ, рокроирпНродрпБ ро╡ро┐ро│рпИропро╛роЯрпБрокро╡ро░рпН, рокроирпНродрпИ родроЯрпНроЯрпБродро▓рпН
тЫ╣тАНтЩА => тЫ╣тАНтЩА, рокроирпНродрпБ, рокрпЖрогрпН, ро╡ро┐ро│рпИропро╛роЯрпНроЯрпБ
тЫ╣тАНтЩВ => тЫ╣тАНтЩВ, рокроирпНродрпБ, роЖрогрпН, ро╡ро┐ро│рпИропро╛роЯрпНроЯрпБ
ЁЯПЛ => ЁЯПЛ, роОроЯрпИродрпН родрпВроХрпНроХрпБродро▓рпН
ЁЯПЛтАНтЩА => ЁЯПЛтАНтЩА, рокро│рпБродрпВроХрпНроХрпБродро▓рпН, ро╡ро┐ро│рпИропро╛роЯрпНроЯрпБ, рокрпЖрогрпН
ЁЯПЛтАНтЩВ => ЁЯПЛтАНтЩВ, рокро│рпБродрпВроХрпНроХрпБродро▓рпН, ро╡ро┐ро│рпИропро╛роЯрпНроЯрпБ, роЖрогрпН
ЁЯЪ┤ => ЁЯЪ┤, роЪрпИроХрпНроХро┐ро│рпН роУроЯрпНроЯрпБродро▓рпН, роЪрпИроХрпНроХро┐ро│ро┐роЩрпН
ЁЯЪ┤тАНтЩА => ЁЯЪ┤тАНтЩА, роЪрпИроХрпНроХро┐ро│рпН, роУроЯрпНроЯрпБродро▓рпН, рокрпЖрогрпН
ЁЯЪ┤тАНтЩВ => ЁЯЪ┤тАНтЩВ, роЪрпИроХрпНроХро┐ро│рпН, роУроЯрпНроЯрпБродро▓рпН, роЖрогрпН
ЁЯЪ╡ => ЁЯЪ╡, рооро▓рпИрокрпНрокро╛родрпИропро┐ро▓рпН роЪрпИроХрпНроХро┐ро│рпН роУроЯрпНроЯрпБродро▓рпН
ЁЯЪ╡тАНтЩА => ЁЯЪ╡тАНтЩА, роЪрпИроХрпНроХро┐ро│рпН, рооро▓рпИрокрпНрокро╛родрпИ, рооро▓рпИ, роУроЯрпНроЯрпБродро▓рпН, рокрпЖрогрпН
ЁЯЪ╡тАНтЩВ => ЁЯЪ╡тАНтЩВ, роЪрпИроХрпНроХро┐ро│рпН, рооро▓рпИрокрпНрокро╛родрпИ, рооро▓рпИ, роУроЯрпНроЯрпБродро▓рпН, роЖрогрпН
ЁЯПО => ЁЯПО, роХро╛ро░рпН, рокроирпНродропроорпН
ЁЯПН => ЁЯПН, рокроирпНродропроорпН
ЁЯПЕ => ЁЯПЕ, рокродроХрпНроХроорпН
ЁЯПЖ => ЁЯПЖ, роХрпЛрокрпНрокрпИ, рокро░ро┐роЪрпБ, ро╡рпЖро▒рпНро▒ро┐
ЁЯПП => ЁЯПП, роХро┐ро░ро┐роХрпНроХрпЖроЯрпН роороЯрпНроЯрпИ, роХро┐ро░ро┐роХрпНроХрпЖроЯрпН рокроирпНродрпБ, ро╡ро┐ро│рпИропро╛роЯрпНроЯрпБ
ЁЯПР => ЁЯПР, роХрпИрокрпНрокроирпНродрпБ, ро╡ро┐ро│рпИропро╛роЯрпНроЯрпБ
ЁЯПС => ЁЯПС, роЗроирпНродро┐роп родрпЗроЪро┐роп ро╡ро┐ро│рпИропро╛роЯрпНроЯрпБ, ро╡ро┐ро│рпИропро╛роЯрпНроЯрпБ
ЁЯПТ => ЁЯПТ, ро╣ро╛роХрпНроХро┐, роороЯрпНроЯрпИ, ро╡ро┐ро│рпИропро╛роЯрпНроЯрпБ
ЁЯПУ => ЁЯПУ, роЯрпЗрокро┐ро│рпН роЯрпЖройрпНройро┐ро╕рпН, роорпЗроЪрпИрокрпНрокроирпНродро╛роЯрпНроЯроорпН, ро╡ро┐ро│рпИропро╛роЯрпНроЯрпБ
ЁЯП╕ => ЁЯП╕, роХрпЗроорпН, ро╡ро┐ро│рпИропро╛роЯрпНроЯрпБ, ро╖роЯрпНроЯро┐ро▓рпНроХро╛роХрпН
ЁЯОп => ЁЯОп, родрпБро▓рпНро▓ро┐ропрооро╛рой роХрпБро▒ро┐, роХрпЗроорпН, роХрпБро▒ро┐рокро╛ро░рпНродрпНродро▓рпН
ЁЯОо => ЁЯОо, роХрпЗроорпН роХройрпНроЯрпНро░рпЛро▓ро░рпН, роХройрпНроЯрпНро░рпЛро▓ро░рпН, роХрпЗроорпН, роЪро╛родройроорпН
ЁЯХ╣ => ЁЯХ╣, роХрпЗроорпН, ро╡рпАроЯро┐ропрпЛ роХрпЗроорпН
ЁЯО▓ => ЁЯО▓, рокроХроЯрпИ, родро╛ропроорпН, родро╛ропроорпН роЙро░рпБроЯрпНроЯрпБродро▓рпН, ро╡ро┐ро│рпИропро╛роЯрпНроЯрпБ
тЩа => тЩа, роЪрпАроЯрпНроЯрпБ ро╡ро┐ро│рпИропро╛роЯрпБродро▓рпН
тЩе => тЩе, роЪрпАроЯрпНроЯрпБ ро╡ро┐ро│рпИропро╛роЯрпБродро▓рпН
тЩж => тЩж, роЪрпАроЯрпНроЯрпБ ро╡ро┐ро│рпИропро╛роЯрпБродро▓рпН
тЩг => тЩг, роЪрпАроЯрпНроЯрпБ ро╡ро┐ро│рпИропро╛роЯрпБродро▓рпН
ЁЯГП => ЁЯГП, роЪрпАроЯрпНроЯрпБ роЕроЯрпНроЯрпИропро┐ро▓рпН роХро░рпБрокрпНрокрпБ роЬрпЛроХрпНроХро░рпН, роЪрпАроЯрпНроЯрпБроХрпНроХроЯрпНроЯрпБ, роХро░рпБрокрпНрокрпБ роЬрпЛроХрпНроХро░рпН
ЁЯАД => ЁЯАД, ро░рпЖроЯрпН роЯро┐ро░ро╛роХройрпН, роЯро┐ро░ро╛роХройрпН
ЁЯО┤ => ЁЯО┤, рокрпВ роЪрпАроЯрпНроЯрпБ, рокрпВ, роЪрпАроЯрпНроЯрпБ ро╡ро┐ро│рпИропро╛роЯрпНроЯрпБ, роЪрпАроЯрпНроЯрпБ, ро╡ро┐ро│рпИропро╛роЯрпНроЯрпБ
ЁЯФЗ => ЁЯФЗ, роЕроорпИродро┐, роЪрпИро▓ройрпНро╕рпН, роиро┐роЪрокрпНродроорпН
ЁЯФИ => ЁЯФИ, роЪродрпНродроорпН, рокрпЗроЪрпБ
ЁЯФЙ => ЁЯФЙ, ро╕рпНрокрпАроХрпНроХро░рпН, роорпЖродрпБро╡ро╛роХ рокрпЗроЪрпБ, роХрпБро▒рпИроирпНрод роТро▓ро┐
ЁЯФК => ЁЯФК, ро╕рпНрокрпАроХрпНроХро░рпН, роЪродрпНродрооро╛роХрокрпН рокрпЗроЪрпБ, ро╣рпИрокро┐роЯрпНроЪрпН
ЁЯУв => ЁЯУв, ро╕рпНрокрпАроХрпНроХро░рпН, роЪрпЖропрпНродро┐
ЁЯУг => ЁЯУг, роХрпВро╡рпБродро▓рпН, родрпКроЯро░рпНрокрпБ
ЁЯУп => ЁЯУп, рокрпЛро╕рпНроЯро▓рпН
ЁЯФФ => ЁЯФФ, роТро▓ро┐, роорогро┐ропрпКро▓ро┐
ЁЯФХ => ЁЯФХ, роЕроорпИродро┐, роЪродрпНродрооро┐роЯро╛родрпЗ, роорогро┐
ЁЯО╝ => ЁЯО╝, роЗроЪрпИ, роХрпЛро░рпНрокрпНрокрпБ
ЁЯО╡ => ЁЯО╡, роЗроЪрпИ роорпКро┤ро┐, роЗроЪрпИ, роХрпБро▒ро┐рокрпНрокрпБ
ЁЯО╢ => ЁЯО╢, роХрпБро▒ро┐рокрпНрокрпБ, роХрпБро▒ро┐рокрпНрокрпБроХро│рпН
ЁЯОЩ => ЁЯОЩ, роЗроЪрпИ, рокро╛роЯрпНроЯрпБ, роорпИроХрпН
ЁЯОЪ => ЁЯОЪ, роЗроЪрпИ, ро╕рпНро▓рпИроЯро░рпН
ЁЯОЫ => ЁЯОЫ, роЗроЪрпИ
ЁЯОд => ЁЯОд, роорпИроХрпН, роХро░рпЛроХрпНроХро┐, рокрпКро┤рпБродрпБрокрпЛроХрпНроХрпБ, рокрпЗроЪрпБродро▓рпН, рокро╛роЯрпБродро▓рпН
ЁЯОз => ЁЯОз, рокро╛роЯрпНроЯрпБ роХрпЗроЯрпНроЯро▓рпН, рокро╛роЯро▓рпН, роЪрпЖропрпНродро┐, рокрпКро┤рпБродрпБрокрпЛроХрпНроХрпБ
ЁЯО╖ => ЁЯО╖, роЗроЪрпИ, роЗроЪрпИроХрпНроХро░рпБро╡ро┐
ЁЯО╕ => ЁЯО╕, роЗроЪрпИ, роЗроЪрпИроХрпНроХро░рпБро╡ро┐
ЁЯО╣ => ЁЯО╣, рокро┐ропро╛ройрпЛ, роЗроЪрпИроХрпНроХро░рпБро╡ро┐
ЁЯО║ => ЁЯО║, роКродрпБроХрпКроорпНрокрпБ, роЗроЪрпИроХрпНроХро░рпБро╡ро┐
ЁЯО╗ => ЁЯО╗, роЗроЪрпИроХрпНроХро░рпБро╡ро┐
ЁЯУ╗ => ЁЯУ╗, ро╡ро╛ройрпКро▓ро┐, роОрокрпНроОроорпН
ЁЯУ▒ => ЁЯУ▒, роЪрпЖро▓рпНрокрпЛройрпН, роЪрпЖро▓рпНрокрпЗроЪро┐
ЁЯУ▓ => ЁЯУ▓, роЪрпЖро▓рпНрокрпЛройрпН, роорпКрокрпИро▓рпН, роЕро┤рпИ, роЕро┤рпИрокрпНрокрпИрокрпН рокрпЖро▒рпБродро▓рпН, роЪрпЖропрпНродро┐ропрпИрокрпН рокрпЖро▒рпБродро▓рпН
тШО => тШО, роЯрпЖро▓ро┐рокрпЛройрпН, роГрокрпЛройрпН
ЁЯУЮ => ЁЯУЮ, роЯрпЖро▓ро┐рокрпЛройрпН, ро░ро┐роЪрпАро╡ро░рпН, родрпКро▓рпИрокрпЗроЪро┐, родрпКроЯро░рпНрокрпБроХрпКро│рпН
ЁЯУЯ => ЁЯУЯ, рокрпЗроЬро░рпН
ЁЯУа => ЁЯУа, родрпКро▓рпИроироХро▓рпН, родрпКроЯро░рпНрокрпБроХрпКро│рпН
ЁЯФЛ => ЁЯФЛ, рооро┐ройрпНроХро▓роорпН
ЁЯФМ => ЁЯФМ, рокро┐ро│роХрпН рокро╛ропро┐ройрпНроЯрпН
ЁЯТ╗ => ЁЯТ╗, роХрогро┐ройро┐, родройро┐роирокро░рпН роХрогро┐ройро┐, роХрогро┐рокрпНрокрпКро▒ро┐
ЁЯЦе => ЁЯЦе, роЯрпЖро╕рпНроХрпНроЯро╛рокрпН, роХрогро┐ройро┐
ЁЯЦи => ЁЯЦи, роХрогро┐ройро┐ роЙрокроХро░рогроорпН
тМи => тМи, роХрпАрокрпЛро░рпНроЯрпБ
ЁЯЦ▒ => ЁЯЦ▒, рооро╡рпБро╕рпН, роЪрпБроЯрпНроЯро┐
ЁЯЦ▓ => ЁЯЦ▓, рооро╡рпБро╕рпН рокро╛ро▓рпН
ЁЯТ╜ => ЁЯТ╜, роЯро┐ро╕рпНроХрпН, ро╡роЯрпНроЯрпБ
ЁЯТ╛ => ЁЯТ╛, рокро┐ро│ро╛рокрпНрокро┐, роЯро┐ро╕рпНроХрпН
ЁЯТ┐ => ЁЯТ┐, рокрпНро│рпВ-ро░рпЗ, роЯро┐ро╡ро┐роЯро┐, роЪро┐роЯро┐, роЯро┐ро╕рпНроХрпН
ЁЯУА => ЁЯУА, роЯро┐ро╡ро┐роЯро┐ роЯро┐ро╕рпНроХрпН, роЯро┐ро╕рпНроХрпН
ЁЯОе => ЁЯОе, родро┐ро░рпИрокрпНрокроЯроорпН, роЪро┐ройро┐рооро╛, рокрпКро┤рпБродрпБрокрпЛроХрпНроХрпБ
ЁЯОм => ЁЯОм, роХро┐ро│ро╛рокрпНрокро░рпН рокро▓роХрпИ, роХро┐ро│ро╛рокрпН роЕроЯро┐роХрпНроХрпБроорпН рокро▓роХрпИ, роХро┐ро│ро╛рокрпН роЕроЯро┐рокрпНрокро╡ро░рпН, родро┐ро░рпИрокрпНрокроЯроорпН, рокрпКро┤рпБродрпБрокрпЛроХрпНроХрпБ
ЁЯУ╜ => ЁЯУ╜, рокро┐ро▓ро┐роорпН, рокрпБро░рпЛроЬрпЖроХрпНроЯро░рпН, роорпВро╡ро┐, роЪро┐ройро┐рооро╛
ЁЯУ║ => ЁЯУ║, роЯро┐ро╡ро┐, роЯрпЖро▓ро┐ро╡ро┐ро╖ройрпН
ЁЯУ╖ => ЁЯУ╖, роХрпЗрооро░ро╛, рокроЯроорпН, рокрпБроХрпИрокрпНрокроЯроорпН
ЁЯУ╕ => ЁЯУ╕, рокро┐ро│ро╛ро╖рпН роХрпЗрооро░ро╛
ЁЯУ╣ => ЁЯУ╣, роХрпЗроорпН роХро╛ро░рпНроЯро░рпН, ро╡рпАроЯро┐ропрпЛ
ЁЯУ╝ => ЁЯУ╝, роХрпЗроЪроЯрпН
ЁЯФН => ЁЯФН, родрпЗроЯрпБ, родрпЗроЯро▓рпН, ро▓рпЖройрпНро╕рпН
ЁЯФО => ЁЯФО, родрпЗроЯрпБ, родрпЗроЯро▓рпН, ро▓рпЖройрпНро╕рпН
ЁЯФм => ЁЯФм, роЖро░ро╛ропрпНроЪрпНроЪро┐
ЁЯФн => ЁЯФн, ро╡ро╛ройро┐ропро▓рпН роЖро░ро╛ропрпНроЪрпНроЪро┐
ЁЯУб => ЁЯУб, роЯро┐ро╖рпН, роЖройрпНроЯройро╛, роЯро┐ро╖рпН роЖройрпНроЯройро╛
ЁЯХп => ЁЯХп, роХрпЗрогрпНроЯро┐ро▓рпН рокро╛ро░рпНроЯрпНроЯро┐, роТро│ро┐
ЁЯТб => ЁЯТб, рокро▓рпНрокрпБ, ро▓рпИроЯрпН рокро▓рпНрокрпБ, роРроЯро┐ропро╛ роХро┐роЯрпИродрпНродродрпБ, роОро▓роХрпНроЯрпНро░ро┐роХрпН роЪро╛родройроорпН, ро╡ро┐ро│роХрпНроХрпБ, рооро┐ройрпНроЪро╛ро░роЪрпН роЪро╛родройроорпН, роироХрпИроЪрпНроЪрпБро╡рпИ
ЁЯФж => ЁЯФж, рокро┐ро│ро╛ро╖рпН, ро▓рпИроЯрпН, роЯро╛ро░рпНроЪрпН, ро╡ро┐ро│роХрпНроХрпБ
ЁЯПо => ЁЯПо, роЪро┐ро╡рокрпНрокрпБ, ро╡ро┐ро│роХрпНроХрпБ, роЙрогро╡роХроорпН, рокро╛ро░рпН, роЪро┐ро╡рокрпНрокрпБ роиро┐ро▒ ро╡ро┐ро│роХрпНроХрпБ роорпВро▓роорпН роЕро▓роЩрпНроХро░ро┐роХрпНроХрокрпНрокроЯрпНроЯ рокро╛ро░рпН, роЪро┐ро╡рокрпНрокрпБ роиро┐ро▒ ро╡ро┐ро│роХрпНроХрпБ роорпВро▓роорпН роЕро▓роЩрпНроХро░ро┐роХрпНроХрокрпНрокроЯрпНроЯ роХрпБроЯро┐роХрпНроХрпБрооро┐роЯроорпН, роХрпБроЯро┐роХрпНроХрпБрооро┐роЯроорпН
ЁЯУФ => ЁЯУФ, роЕро┤роХро╛рой роирпЛроЯрпНроЯрпБ, роЕроЯрпНроЯрпИ, ро╡рпЗро▓рпИрокрпНрокро╛роЯро╛рой роЕроЯрпНроЯрпИ
ЁЯУХ => ЁЯУХ, рокрпБродрпНродроХроорпН
ЁЯУЦ => ЁЯУЦ, рокрпБродрпНродроХроорпН
ЁЯУЧ => ЁЯУЧ, рокрпБродрпНродроХроорпН
ЁЯУШ => ЁЯУШ, рокрпБродрпНродроХроорпН
ЁЯУЩ => ЁЯУЩ, рокрпБродрпНродроХроорпН
ЁЯУЪ => ЁЯУЪ, рокрпБродрпНродроХроорпН
ЁЯУУ => ЁЯУУ, роирпЛроЯрпНрокрпБроХрпН
ЁЯУТ => ЁЯУТ, роирпЛроЯрпНроЯрпБ, рокрпБродрпНродроХроорпН
ЁЯУГ => ЁЯУГ, роЪрпБро░рпБрогрпНроЯ роЖро╡рогроорпН, роЪрпБро░рпБро│рпН рокроХрпНроХроорпН, рокроХрпНроХроЪрпН роЪрпБро░рпБро│рпН
ЁЯУЬ => ЁЯУЬ, роЪрпБро░рпБроЯрпНроЯрпБ, рокрпЗрокрпНрокро░рпИ роЪрпБро░рпБроЯрпНроЯрпБ
ЁЯУД => ЁЯУД, родро┐ро▒роирпНрод роЖро╡рогроорпН
ЁЯУ░ => ЁЯУ░, роиро┐ропрпВро╕рпН рокрпЗрокрпНрокро░рпН, роЪрпЖропрпНродро┐роХро│рпН
ЁЯЧЮ => ЁЯЧЮ, роЪрпБро░рпБроЯрпНроЯрокрпНрокроЯрпНроЯ роЪрпЖропрпНродро┐родрпНродро╛ро│рпН, роЪрпЖропрпНродро┐родрпНродро╛ро│рпН, роЪрпБро░рпБроЯрпНроЯрокрпНрокроЯрпНроЯродрпБ, роиро┐ропрпВро╕рпН рокрпЗрокрпНрокро░рпН
ЁЯУС => ЁЯУС, роХрпБро▒ро┐родрпНродро▓рпН, рокрпБродрпНродроХродрпНродро┐ро▓рпН роХрпБро▒ро┐родрпНродро▓рпН, рокрпБроХрпНрооро╛ро░рпНроХрпН, роЯрпЗрокрпНро╕рпН, рооро╛ро░рпНроХрпНроХро░рпН
ЁЯФЦ => ЁЯФЦ, рокрпБродрпНродроХроХрпНроХрпБро▒ро┐, рокроХрпНроХ роЕроЯрпИропро╛ро│роорпН, рокроЯрпНроЯро┐
ЁЯТ░ => ЁЯТ░, роХро╛роЪрпБ роЕроЯроЩрпНроХро┐роп рокрпИ, роЯро╛ро▓ро░рпН рокрпИ, рокрогроорпН, роХро╛роЪрпБ, рокрпИ
ЁЯТ┤ => ЁЯТ┤, ро╡роЩрпНроХро┐рокрпНрокрогроорпН, ропрпЖройрпН, рокрогроорпН, рокро┐ро▓рпН, роирпЛроЯрпНроЯрпБ ро░рпВрокро╛ропрпН, роЬрокрпНрокро╛ройрпН
ЁЯТ╡ => ЁЯТ╡, ро╡роЩрпНроХро┐рокрпНрокрогроорпН, роЯро╛ро▓ро░рпН, рокрогроорпН, рокро┐ро▓рпН, роирпЛроЯрпНроЯрпБ ро░рпВрокро╛ропрпН, ропрпБ.роОро╕рпН.
ЁЯТ╢ => ЁЯТ╢, ро╡роЩрпНроХро┐рокрпНрокрогроорпН, ропрпВро░рпЛ, рокрогроорпН, рокро┐ро▓рпН, роирпЛроЯрпНроЯрпБ ро░рпВрокро╛ропрпН, роРро░рпЛрокрпНрокро╛
ЁЯТ╖ => ЁЯТ╖, ро╡роЩрпНроХро┐рокрпНрокрогроорпН, рокро╡рпБрогрпНроЯрпН, рокрогроорпН, рокро┐ро▓рпН, роирпЛроЯрпНроЯрпБ ро░рпВрокро╛ропрпН
ЁЯТ╕ => ЁЯТ╕, роЗро▒роХрпНроХрпИроХро│рпБроЯройрпН роХрпВроЯро┐роп рокрогроорпН, рокро▒роХрпНроХрпБроорпН ро╡роЩрпНроХро┐рокрпН рокрогроорпН, рокрогроорпН, ро╡роЩрпНроХро┐
ЁЯТ│ => ЁЯТ│, роХро┐ро░рпЖроЯро┐роЯрпН, роХро╛ро░рпНроЯрпБ
ЁЯТ╣ => ЁЯТ╣, ро╡ро│ро░рпБроорпН роЪроирпНродрпИ, роЪроирпНродрпИ ро╡ро│ро░рпНроЪрпНроЪро┐
тЬЙ => тЬЙ, роОройрпНро╡рпЖро▓рокрпН, роОройрпНро╡рпЖро▓рокрпН роХро╡ро░рпН
ЁЯУз => ЁЯУз, рооро┐ройрпНройроЮрпНроЪро▓рпН, рооро┐ройрпН роЕроЮрпНроЪро▓рпН, роЗроорпЖропро┐ро▓рпН роЪро┐ройрпНройроорпН, роИроорпЖропро┐ро▓рпН роЪро┐роорпНрокро▓рпН
ЁЯУи => ЁЯУи, ро╡роирпНрод роорпЖропро┐ро▓рпН, роХроЯро┐родроорпН, роЗ-роХроЯро┐родроорпН
ЁЯУй => ЁЯУй, рокрпЛрой роорпЖропро┐ро▓рпН, роЕройрпБрокрпНрокро┐роп роорпЖропро┐ро▓рпН, роорпЖропро┐ро▓рпН
ЁЯУд => ЁЯУд, роЕро╡рпБроЯрпНрокро╛роХрпНро╕рпН, рокрпЖроЯрпНроЯро┐, роЕроЮрпНроЪро▓рпН рокрпЖроЯрпНроЯро┐, родроЯрпНроЯрпБ
ЁЯУе => ЁЯУе, роЗройрпНрокро╛роХрпНро╕рпН, рокрпЖроЯрпНроЯро┐, роЕроЮрпНроЪро▓рпН рокрпЖроЯрпНроЯро┐, родроЯрпНроЯрпБ
ЁЯУж => ЁЯУж, рокро╛ро░рпНроЪро▓рпН, рокро╛роХрпНро╕рпН, рокрпЗроХрпН
ЁЯУл => ЁЯУл, роЕроЮрпНроЪро▓рпН рокрпЖроЯрпНроЯро┐, роорпВроЯро┐роп родрокро╛ро▓рпН рокрпЖроЯрпНроЯро┐, рокрпЖроЯрпНроЯро┐, роХрпКроЯро┐рокро▒роХрпНроХрпБроорпН рокрпЖроЯрпНроЯро┐
ЁЯУк => ЁЯУк, родрокро╛ро▓рпН рокрпЖроЯрпНроЯро┐, роЕроЮрпНроЪро▓рпН рокрпЖроЯрпНроЯро┐, родрокро╛ро▓рпН, роорпВроЯро┐роп рокрпЖроЯрпНроЯро┐, роХрпКроЯро┐ роЪро╛ропрпНроирпНрод рокрпЖроЯрпНроЯро┐
ЁЯУм => ЁЯУм, роЕроЮрпНроЪро▓рпН рокрпЖроЯрпНроЯро┐, родро┐ро▒роирпНрод родрокро╛ро▓рпН рокрпЖроЯрпНроЯро┐, рокрпЖроЯрпНроЯро┐, роХрпКроЯро┐рокро▒роХрпНроХрпБроорпН рокрпЖроЯрпНроЯро┐
ЁЯУн => ЁЯУн, роЕроЮрпНроЪро▓рпН рокрпЖроЯрпНроЯро┐, родро┐ро▒роирпНрод родрокро╛ро▓рпН рокрпЖроЯрпНроЯро┐, рокрпЖроЯрпНроЯро┐, роХрпКроЯро┐роЪро╛ропрпНроирпНрод рокрпЖроЯрпНроЯро┐, роЕроЮрпНроЪро▓рпН
ЁЯУо => ЁЯУо, рокрпЛро╕рпНроЯрпНрокро╛роХрпНро╕рпН
ЁЯЧ│ => ЁЯЧ│, ро╡ро╛роХрпНроХрпБрокрпН рокрпЖроЯрпНроЯро┐, ро╡ро╛роХрпНроХрпБ, родрпЗро░рпНродро▓рпН, ро╡ро╛роХрпНроХро│ро┐родрпНродро▓рпН, ро╡ро╛роХрпНроХро│ро┐рокрпНрокрпБ
тЬП => тЬП, роЖро░роорпНрокрокрпНрокро│рпНро│ро┐
тЬТ => тЬТ, рокрпЗройро╛ роорпБройрпИ, рокрпЗройро╛
ЁЯЦЛ => ЁЯЦЛ, рокрпЗройро╛
ЁЯЦК => ЁЯЦК, рокро╛ро▓рпНрокро╛ропрпНрогрпНроЯрпН рокрпЗройро╛
ЁЯЦМ => ЁЯЦМ, рокрпЖропро┐ройрпНроЯрпНроЯро┐роЩрпН
ЁЯЦН => ЁЯЦН, роХро┐ро░рпЗропро╛ройрпНро╕рпН, ро╡рогрпНрогроорпН родрпАроЯрпНроЯрпБродро▓рпН
ЁЯУЭ => ЁЯУЭ, роирпЛроЯрпН, роХрпБро▒ро┐рокрпНрокрпБ, роХрпБро▒ро┐рокрпНрокрпБрокрпН рокрпБродрпНродроХроорпН
ЁЯТ╝ => ЁЯТ╝, рокрпЖроЯрпНроЯро┐
ЁЯУБ => ЁЯУБ, роГрокрпЛро▓рпНроЯро░рпН, роХрпЛрокрпНрокрпБ, рокрпИро▓рпН
ЁЯУВ => ЁЯУВ, родро┐ро▒роирпНрод роГрокрпЛро▓рпНроЯро░рпН, родро┐ро▒роирпНрод рокрпИро▓рпН
ЁЯЧВ => ЁЯЧВ, роХро╛ро░рпНроЯрпБ, роЗройрпНроЯрпЗроХрпНро╕рпН, роЯро┐ро╡рпИроЯро░рпНро╕рпН
ЁЯУЕ => ЁЯУЕ, роиро╛роЯрпНроХро╛роЯрпНроЯро┐, роХро╛ро▓рпЗрогрпНроЯро░рпН, роХро╛ро▓рогрпНроЯро░рпН
ЁЯУЖ => ЁЯУЖ, роХро┐ро┤ро┐роХрпНроХрпБроорпН роиро╛роЯрпНроХро╛роЯрпНроЯро┐, роХро┐ро┤ро┐роХрпНроХрпБроорпН роиро╛ро│рпНроХро╛роЯрпНроЯро┐, роХро┐ро┤ро┐роХрпНроХрпБроорпН роХро╛ро▓рпЗрогрпНроЯро░рпН, роХро┐ро┤ро┐роХрпНроХрпБроорпН роХро╛ро▓рогрпНроЯро░рпН
ЁЯЧТ => ЁЯЧТ, ро╕рпНрокрпИро░ро▓рпН, роирпЛроЯрпНрокрпЗроЯрпБ
ЁЯЧУ => ЁЯЧУ, ро╕рпНрокрпИро░ро▓рпН, роХрпЗро▓рпЖрогрпНроЯро░рпН
ЁЯУЗ => ЁЯУЗ, ро╡ро░ро┐роЪрпИ роОрогрпН, ро░рпЛро▓ро┐роЩрпН рокрпЗрокрпНрокро░рпН, ро╡ро░ро┐роЪрпИ
ЁЯУИ => ЁЯУИ, роорпЗро▓рпН роирпЛроХрпНроХро┐ роЪрпЖро▓рпНро▓рпБродро▓рпН, роКроХрпНроХроорпН, роЪро╛ро░рпНроЯрпН
ЁЯУЙ => ЁЯУЙ, родро╛ро┤рпНро╡рпБ, ро╡рпАро┤рпНродро▓рпН
ЁЯУК => ЁЯУК, рокро╛ро░рпН ро╡ро░рпИрокроЯроорпН, рокро╛ро░рпН роХро┐ро░ро╛рокрпН, рокро╛ро░рпН роЪро╛ро░рпНроЯрпН
ЁЯУЛ => ЁЯУЛ, роХро┐ро│ро┐рокрпН, роХро┐ро│ро┐рокрпН рокрпЛро░рпНроЯрпБ
ЁЯУМ => ЁЯУМ, роКроЪро┐
ЁЯУН => ЁЯУН, рокро┐ройрпН
ЁЯУО => ЁЯУО, роХро┐ро│ро┐рокрпН
ЁЯЦЗ => ЁЯЦЗ, рокрпЗрокрпНрокро░рпН роХро┐ро│ро┐рокрпН, роЗрогрпИроХрпНроХрокрпНрокроЯрпНроЯ рокрпЗрокрпНрокро░рпН роХро┐ро│ро┐рокрпН
ЁЯУП => ЁЯУП, роЕроЯро┐ро╕рпНроХрпЗро▓рпН, ро╕рпНроХрпЗро▓рпН
ЁЯУР => ЁЯУР, роЪрпЖроЯрпН ро╕рпНроХрпКропро░рпН, роЕро│ро╡рпБроХрпЛро▓рпН, роорпБроХрпНроХрпЛрогроорпН
тЬВ => тЬВ, роХродрпНродро┐ро░ро┐, родрпИропро▓рпН, ро╡рпЖроЯрпНроЯрпБ, ро╡рпЖроЯрпНроЯрпБродро▓рпН
ЁЯЧГ => ЁЯЧГ, роХро╛ро░рпНроЯрпБ, рокрпИро▓рпН, рокро╛роХрпНро╕рпН
ЁЯЧД => ЁЯЧД, рокрпИро▓рпН, роХрпЗрокро┐ройроЯрпН
ЁЯЧС => ЁЯЧС, роХрпБрокрпНрокрпИроХрпН роХрпВроЯрпИ
ЁЯФТ => ЁЯФТ, рокрпВроЯрпНроЯро┐ропродрпБ
ЁЯФУ => ЁЯФУ, рокрпВроЯрпНроЯрпБ, рокрпВроЯрпНроЯро╛родродрпБ, родро┐ро▒роирпНродродрпБ
ЁЯФП => ЁЯФП, рокрпВроЯрпНроЯрпБ, роЙро░ро┐роорпИ, рокрпЗройро╛, роОройродрпБро░ро┐роорпИ
ЁЯФР => ЁЯФР, рокрпВроЯрпНроЯрпБ роЪро╛ро╡ро┐, рокро╛родрпБроХро╛рокрпНрокрпБ, рокрпВроЯрпНроЯрпБ, роЪро╛ро╡ро┐
ЁЯФС => ЁЯФС, рокро╛ро╕рпНро╡рпЗро░рпНроЯрпН, роХроЯро╡рпБроЪрпНроЪрпКро▓рпН
ЁЯЧЭ => ЁЯЧЭ, роХрпБро▒ро┐рокрпНрокрпБ, рокрпВроЯрпНроЯрпБ, роЪро╛ро╡ро┐, рокро┤рпИропродрпБ
ЁЯФи => ЁЯФи, роЪрпБродрпНродро┐ропро▓рпН, роХро░рпБро╡ро┐
тЫП => тЫП, роЪрпБро░роЩрпНроХ ро╡рпЗро▓рпИ, роХро░рпБро╡ро┐
тЪТ => тЪТ, роЪрпБродрпНродро┐ропрпБроорпН роХрпЛроЯро░ро┐ропрпБроорпН, роЪрпБродрпНродро┐ропро▓рпН, роХрпЛроЯро░ро┐, роХро░рпБро╡ро┐
ЁЯЫа => ЁЯЫа, роЪрпБродрпНродро┐ропро▓рпН, роЗроЯрпБроХрпНроХро┐, роХро░рпБро╡ро┐
ЁЯФз => ЁЯФз, роХро░рпБро╡ро┐, роЯрпВро▓рпН
ЁЯФй => ЁЯФй, роироЯрпНроЯрпБ, рокрпЛро▓рпНроЯрпН, роХро░рпБро╡ро┐, роЯрпВро▓рпН, роироЯрпН
ЁЯЧЬ => ЁЯЧЬ, роХроорпНрокрпНро░ро╖ройрпН, роХро░рпБро╡ро┐, роЯрпВро▓рпН
тЪЧ => тЪЧ, ро╡роЯро┐роХро▓ройрпН, ро╡рпЗродро┐ропро┐ропро▓рпН, роХро░рпБро╡ро┐
тЪЦ => тЪЦ, роОроЯрпИ, родрпБро▓ро╛роорпН, роОроЯрпИ рокрпЛроЯрпБродро▓рпН, роЕро│ро╡ро┐роЯрпБродро▓рпН
ЁЯФЧ => ЁЯФЧ, роЗрогрпИ, роЪрпЗро░рпН, роХроЯрпНроЯрпБ
тЫУ => тЫУ, роЪрпЖропро┐ройрпН, роЪроЩрпНроХро┐ро▓ро┐
ЁЯТЙ => ЁЯТЙ, роЪро┐ро░ро┐роЮрпНроЪро┐, рооро░рпБродрпНродрпБро╡роорпН, рооро░рпБродрпНродрпБро╡ро░рпН, рооро░рпБродрпНродрпБро╡рооройрпИ, роКроЪро┐роХрпБродрпНродрпБродро▓рпН
ЁЯТК => ЁЯТК, рооро░рпБроирпНродрпБ, рооро░рпБродрпНродрпБро╡роорпН, рооро░рпБродрпНродрпБро╡ро░рпН, рооро░рпБроирпНродрпБроХроЯрпИ, рооро░рпБродрпНродрпБро╡рооройрпИ
ЁЯЧб => ЁЯЧб, роХродрпНродро┐, роЖропрпБродроорпН, роХро░рпБро╡ро┐
ЁЯФк => ЁЯФк, роХродрпНродро┐, ро╡рпЖроЯрпНроЯрпБ роХродрпНродро┐, роХро╛ропрпНроХро▒ро┐ ро╡рпЖроЯрпНроЯрпБродро▓рпН
тЪФ => тЪФ, роХрпБро▒рпБроХрпНроХро╛рой ро╡ро╛ро│рпНроХро│рпН, роХрпБро▒рпБроХрпНроХро╛ройродрпБ, роЖропрпБродроорпН
ЁЯФл => ЁЯФл, ро░ро┐ро╡ро╛ро▓рпНро╡ро░рпН, рокро┐ро╕рпНроЯро▓рпН
ЁЯЫб => ЁЯЫб, ропрпБродрпНродроорпН, рокро╛родрпБроХро╛рокрпНрокрпБ роЖропрпБродроорпН
ЁЯП╣ => ЁЯП╣, родройрпБроЪрпБ, родройрпБроЪрпБ ро░ро╛роЪро┐, роЖропрпБродроорпН, ропрпБродрпНродроорпН
ЁЯПБ => ЁЯПБ, ро░рпЗро╕рпН, ро░рпЗро╕рпН роХрпКроЯро┐, ро╡ро┐ро│рпИропро╛роЯрпНроЯрпБ
ЁЯП│ => ЁЯП│, ро╡рпЖро│рпНро│рпИроХрпН роХрпКроЯро┐, роХрпКроЯро┐, роЪрооро╛родро╛ройроорпН, рокро▒роХрпНроХрпБроорпН роХрпКроЯро┐
ЁЯП│тАНЁЯМИ => ЁЯП│тАНЁЯМИ, ро╡ро╛ройро╡ро┐ро▓рпН, роХрпКроЯро┐
ЁЯП┤ => ЁЯП┤, роХро░рпБрокрпНрокрпБроХрпН роХрпКроЯро┐, роХрпКроЯро┐, родрпБроХрпНроХроорпН, рокро▒роХрпНроХрпБроорпН роХрпКроЯро┐
ЁЯЪй => ЁЯЪй, роХроорпНрокродрпНродро┐ро▓рпН роорпБроХрпНроХрпЛрог роХрпКроЯро┐
ЁЯЪм => ЁЯЪм, рокрпБроХрпИродрпНродро▓рпН
тЪ░ => тЪ░, роЗро▒рокрпНрокрпБ, родрпБроХрпНроХроорпН, роЕроЯроХрпНроХроорпН, роЪро╡рокрпНрокрпЖроЯрпНроЯро┐
тЪ▒ => тЪ▒, роЗро▒рпБродро┐роЪрпНроЪроЯроЩрпНроХрпБ, роЕроЯроХрпНроХроорпН
ЁЯЧ┐ => ЁЯЧ┐, роЪро┐ро▓рпИ
ЁЯЫв => ЁЯЫв, роОрогрпНрогрпЖропрпН, роЯро┐ро░роорпН, роЖропро┐ро▓рпН
ЁЯФо => ЁЯФо, рокроирпНродрпБ, роХро┐ро▒ро┐ро╕рпНроЯро▓рпН рокро╛ро▓рпН
ЁЯПз => ЁЯПз, ро╡роЩрпНроХро┐, родро╛ройро┐ропроЩрпНроХро┐ роЗропроирпНродро┐ро░роорпН
ЁЯЪо => ЁЯЪо, роХрпБрокрпНрокрпИропрпИ роЙро░ро┐роп роЗроЯродрпНродро┐ро▓рпН рокрпЛроЯро╡рпБроорпН
ЁЯЪ░ => ЁЯЪ░, роХрпБроЯро┐ родрогрпНрогрпАро░рпН роЪро┐ройрпНройроорпН
тЩ┐ => тЩ┐, роЪроХрпНроХро░ роиро╛ро▒рпНроХро╛ро▓ро┐ роЪро┐ройрпНройроорпН, рооро╛ро▒рпНро▒рпБродрпНродро┐ро▒ройро╛ро│ро┐
ЁЯЪ╣ => ЁЯЪ╣, роЖрогрпНроХро│рпН
ЁЯЪ║ => ЁЯЪ║, рокрпЖрогрпНроХро│рпН
ЁЯЪ╗ => ЁЯЪ╗, роЯро╛ропрпНро▓рпЖроЯрпН, рокро╛родрпНро░рпВроорпН
ЁЯЪ╝ => ЁЯЪ╝, роХрпБро┤роирпНродрпИ, рокро╛рокрпНрокро╛, роХрпИроХрпНроХрпБро┤роирпНродрпИ
ЁЯЪ╛ => ЁЯЪ╛, роЪро┐ро▒рпБроирпАро░рпН роХро┤ро┐рокрпНрокро┐роЯроорпН
ЁЯЫВ => ЁЯЫВ, рокро╛ро╕рпНрокрпЛро░рпНроЯрпН
ЁЯЫГ => ЁЯЫГ, роХро╕рпНроЯроорпНро╕рпН
ЁЯЫД => ЁЯЫД, рокрпЗроХрпНроХрпЗроЬрпН ро╡ро╛роЩрпНроХрпБрооро┐роЯроорпН
ЁЯЫЕ => ЁЯЫЕ, рокрпЗроХрпНроХрпЗроЬрпН ро╡ро┐роЯрпБроорпН роЗроЯроорпН
тЪа => тЪа, роЕрокро╛ропроорпН, ро╡ро╛ро░рпНройро┐роЩрпН
ЁЯЪ╕ => ЁЯЪ╕, роХрпБро┤роирпНродрпИроХро│рпН роХроЯроирпНродрпБроЪрпЖро▓рпНро▓рпБроорпН рокро╛родрпИ
тЫФ => тЫФ, родроЯрпИроЪрпЖропрпНропрокрпНрокроЯрпНроЯ рокроХрпБродро┐, роЕройрпБроородро┐ роЗро▓рпНро▓рпИ роЪро┐ройрпНройроорпН
ЁЯЪл => ЁЯЪл, роЕройрпБроородро┐ роЗро▓рпНро▓рпИ, роЕройрпБроородро┐ роЗро▓рпНро▓рпИ роЪро┐ройрпНройроорпН
ЁЯЪ│ => ЁЯЪ│, роЪрпИроХрпНроХро┐ро│рпН роиро┐ро▒рпБродрпНродроХрпНроХрпВроЯро╛родрпБ
ЁЯЪн => ЁЯЪн, рокрпБроХрпИродрпНродро▓рпН родроЯрпИроЪрпЖропрпНропрокрпНрокроЯрпНроЯрпБро│рпНро│родрпБ, рокрпБроХрпИродрпНродро▓рпН родроЯрпИроЪрпЖропрпНропрокрпНрокроЯрпНроЯ рокроХрпБродро┐
ЁЯЪп => ЁЯЪп, роХрпБрокрпНрокрпИ рокрпЛроЯро╛родрпАро░рпН!, роХрпБрокрпНрокрпИропрпИрокрпН рокрпЛроЯроХрпНроХрпВроЯро╛родрпБ роЪро┐ройрпНройроорпН
ЁЯЪ▒ => ЁЯЪ▒, роХрпБроЯро┐рокрпНрокродро▒рпНроХро╛рой родрогрпНрогрпАро░рпН роЕро▓рпНро▓
ЁЯЪ╖ => ЁЯЪ╖, рокро╛родроЪро╛ро░ро┐роХро│рпБроХрпНроХрпБ роЕройрпБроородро┐ роЗро▓рпНро▓рпИ
тШв => тШв, ро░рпЗроЯро┐ропрпЛроЖроХрпНроЯро┐ро╡рпН
тШг => тШг, роЪрпБро▒рпНро▒рпБроЪрпНроЪрпВро┤ро▓рпН рокро╛родро┐рокрпНрокрпБ, родрпАроорпИ
тмЖ => тмЖ, родро┐роЪрпИ, ро╡роЯроХрпНроХрпБ
тЖЧ => тЖЧ, родро┐роЪрпИ, ро╡роЯ роХро┐ро┤роХрпНроХрпБ
тЮб => тЮб, родро┐роЪрпИ, роХро┐ро┤роХрпНроХрпБ
тЖШ => тЖШ, родро┐роЪрпИ, родрпЖройрпНроХро┐ро┤роХрпНроХрпБ
тмЗ => тмЗ, родро┐роЪрпИ, родрпЖро▒рпНроХрпБ
тЖЩ => тЖЩ, родро┐роЪрпИ, родрпЖройрпНроорпЗро▒рпНроХрпБ
тмЕ => тмЕ, родро┐роЪрпИ, роорпЗро▒рпНроХрпБ
тЖЦ => тЖЦ, родро┐роЪрпИ, ро╡роЯроорпЗро▒рпНроХрпБ
тЖХ => тЖХ, роЕроорпНрокрпБроХрпНроХрпБро▒ро┐
тЖФ => тЖФ, роЕроорпНрокрпБроХрпНроХрпБро▒ро┐
тЖй => тЖй, роЗроЯрокрпНрокроХрпНроХроорпН ро╡ро│рпИроирпНрод ро╡ро▓родрпБ роЕроорпНрокрпБроХрпНроХрпБро▒ро┐, роЕроорпНрокрпБроХрпНроХрпБро▒ро┐
тЖк => тЖк, ро╡ро▓рокрпНрокроХрпНроХроорпН ро╡ро│рпИроирпНрод роЗроЯродрпБ роЕроорпНрокрпБроХрпНроХрпБро▒ро┐, роЕроорпНрокрпБроХрпНроХрпБро▒ро┐
тд┤ => тд┤, роорпЗро▓рпН роирпЛроХрпНроХро┐ ро╡ро│рпИроирпНрод ро╡ро▓родрпБ роЕроорпНрокрпБроХрпНроХрпБро▒ро┐, роЕроорпНрокрпБроХрпНроХрпБро▒ро┐
тд╡ => тд╡, роХрпАро┤рпНроирпЛроХрпНроХро┐ ро╡ро│рпИроирпНрод ро╡ро▓родрпБ роЕроорпНрокрпБроХрпНроХрпБро▒ро┐, роЕроорпНрокрпБроХрпНроХрпБро▒ро┐
ЁЯФГ => ЁЯФГ, рооро╛ро▒рпНро▒рпБ, рокрпБродрпБрокрпНрокро┐рокрпНрокрпБ, ро░рпАро▓рпЛроЯрпН роЪро┐роорпНрокро▓рпН
ЁЯФД => ЁЯФД, роЗроЯроЮрпНроЪрпБро┤ро┐ роЕроорпНрокрпБроХрпНроХрпБро▒ро┐роХро│рпН, роЕроорпНрокрпБроХрпНроХрпБро▒ро┐роХро│рпН
ЁЯФЩ => ЁЯФЩ, родро┐ро░рпБроорпНрокро┐рокрпН рокрпЛ, рокро┐ройрпНроЪрпЖро▓рпНро▓рпБроорпН роЕроорпНрокрпБроХрпНроХрпБро▒ро┐
ЁЯФЪ => ЁЯФЪ, роорпБроЯро┐ро╡рпБ роЕроорпНрокрпБроХрпНроХрпБро▒ро┐, роЕроорпНрокрпБроХрпНроХрпБро▒ро┐
ЁЯФЫ => ЁЯФЫ, роЖройрпН роЕроорпНрокрпБроХрпНроХрпБро▒ро┐, роЗропроХрпНроХрпБ, роЖроЪрпНроЪро░ро┐роХрпНроХрпБро▒ро┐, роЖроЪрпНроЪро░ро┐ропроорпН, роЗро░рпБрокроХрпНроХ роЕроорпНрокрпБроХрпНроХрпБро▒ро┐
ЁЯФЬ => ЁЯФЬ, ро╡ро┐ро░рпИро╡ро┐ро▓рпН, роЕроорпНрокрпБроХрпНроХрпБро▒ро┐
ЁЯФЭ => ЁЯФЭ, роорпЗро▓рпЗ, роорпЗро▓рпН роЕроорпНрокрпБроХрпНроХрпБро▒ро┐
ЁЯЫР => ЁЯЫР, ро╡ро┤ро┐рокроЯрпБроорпН родро▓роорпН, роородроорпН, рокро┐ро░ро╛ро░рпНродрпНродройрпИ
тЪЫ => тЪЫ, роХрпЛро▓роорпН
ЁЯХЙ => ЁЯХЙ, роЗроирпНродрпБ роородроорпН, роороирпНродро┐ро░роорпН
тЬб => тЬб, роородроорпН
тШ╕ => тШ╕, рокрпБродрпНрод роородроорпН, роородроЪрпНроЪро┐ройрпНройроорпН
тШп => тШп, ропро╛роЩрпН, роородроорпН
тЬЭ => тЬЭ, роХро┐ро▒ро┐ро╕рпНродро╡ роородроорпН
тШж => тШж, роЖро░рпНродрпНродрпЛроЯро╛ро╕рпН роЪро┐ро▓рпБро╡рпИ, роХро┐ро▒ро┐ро╕рпНродро╡роорпН, роХро┐ро▒ро┐ро╕рпНродро╡ роородроорпН
тШк => тШк, роЗро╕рпНро▓ро╛рооро┐ропроорпН
тШо => тШо, роЪрооро╛родро╛ройроорпН
ЁЯХО => ЁЯХО, роорпЖро┤рпБроХрпБро╡ро░рпНродрпНродро┐ роПро▒рпНро▒рпБродро▓рпН
ЁЯФп => ЁЯФп, роироЯрпНроЪродрпНродро┐ро░роорпН, ро╕рпНроЯро╛ро░рпН
тЩ╗ => тЩ╗, рооро▒рпБроЪрпБро┤ро▒рпНроЪро┐ роЪро┐ройрпНройроорпН, роЪро┐ройрпНройроорпН
ЁЯУЫ => ЁЯУЫ, рокрпЖропро░рпН рокроЯрпНроЯро┐, рокрпЖропро░рпН роОро┤рпБродрпБроорпН роЗроЯроорпН
тЪЬ => тЪЬ, рокрпВ
ЁЯФ░ => ЁЯФ░, рокрпБродро┐ропро╡ро░рпН, рокроЪрпНроЪрпИ & роороЮрпНроЪро│рпН, роЗро│роЩрпНроХройрпНро▒рпБ
ЁЯФ▒ => ЁЯФ▒, роироЩрпНроХрпВро░роорпН, роЪрпВро▓роорпН, роЗро▓роЪрпНроЪро┐ройрпИ, роЪро┐ройрпНройроорпН
тнХ => тнХ, роЪро┐ро╡рокрпНрокрпБ ро╡роЯрпНроЯроорпН, ро╡роЯрпНроЯроорпН
тЬЕ => тЬЕ, роЯро┐роХрпН рооро╛ро░рпНроХрпН, роЯро┐роХрпН роЪрпЖропрпНропро╡рпБроорпН
тШС => тШС, роЯро┐роХрпН рооро╛ро░рпНроХрпН, ро╡ро╛роХрпНроХрпБрокрпН рокрпЖроЯрпНроЯро┐, рокрпЖроЯрпНроЯро┐
тЬФ => тЬФ, роХро░рпБрокрпНрокрпБ роиро┐ро▒ роЯро┐роХрпН, роЯро┐роХрпН рооро╛ро░рпНроХрпН, роЪро░ро┐
тЬЦ => тЬЦ, рокрпЖро░рпБроХрпНроХро▓рпН, рокрпЖро░рпБроХрпНроХро▓рпН роЪро┐ройрпНройроорпН, ро░родрпНродро╛ройродрпБ, ро░родрпНродрпБ роЪро┐ройрпНройроорпН, роХрогроХрпНроХрпБ
тЭМ => тЭМ, роХрогроХрпНроХрпБ, роЪро┐ройрпНройроорпН
тЭО => тЭО, роХрогроХрпНроХрпБ, роЪро┐ройрпНройроорпН
тЮХ => тЮХ, роХрпВроЯрпНроЯро▓рпН, роХрпВроЯрпНроЯро▓рпН роХрпБро▒ро┐, роЕроЯро░рпН роХро░рпБрокрпНрокро┐ро▓рпН роХрпВроЯрпНроЯро▓рпН роХрпБро▒ро┐, роХрогроХрпНроХрпБ
тЮЦ => тЮЦ, роХро┤ро┐родрпНродро▓рпН, роХро┤ро┐родрпНродро▓рпН роХрпБро▒ро┐, роЕроЯро░рпН роХро░рпБрокрпНрокро┐ро▓рпН роХро┤ро┐родрпНродро▓рпН роХрпБро▒ро┐, роХрогроХрпНроХрпБ
тЮЧ => тЮЧ, ро╡роХрпБродрпНродро▓рпН, ро╡роХрпБродрпНродро▓рпН роХрпБро▒ро┐, роЕроЯро░рпН роХро░рпБрокрпНрокро┐ро▓рпН ро╡роХрпБродрпНродро▓рпН роХрпБро▒ро┐, роХрогроХрпНроХрпБ
тЮ░ => тЮ░, роЪрпБро░рпБро│рпН
тЮ┐ => тЮ┐, роЗро░роЯрпНроЯрпИ роЪрпБро░рпБро│рпН
уА╜ => уА╜, рооро╛ро▒рпБроорпН роЪро┐ройрпНройроорпН, рокро╛родро┐ рооро╛ро▒рпБроорпН роЪро┐ройрпНройроорпН
тЬ│ => тЬ│, роироЯрпНроЪродрпНродро┐ро░роХрпН роХрпБро▒ро┐
тЬ┤ => тЬ┤, роОроЯрпНроЯрпБ роорпБройрпИ, роироЯрпНроЪродрпНродро┐ро░роорпН
тЭЗ => тЭЗ, родро┐роЯрпАро░рпН ро╡рпЖро│ро┐роЪрпНроЪроорпН
ЁЯТ▒ => ЁЯТ▒, роиро╛рогропроорпН, рокрогроорпН, рокро░ро┐рооро╛ро▒рпНро▒роорпН, рокрогрокрпН рокро░ро┐рооро╛ро▒рпНро▒роорпН, ро╡роЩрпНроХро┐
ЁЯТ▓ => ЁЯТ▓, роЯро╛ро▓ро░рпН роЪро┐ройрпНройроорпН, роЯро╛ро▓ро░рпН, рокрогроорпН, роиро╛рогропроорпН
тА╝ => тА╝, роЖроЪрпНроЪро░рпНропроорпН, роХрпБро▒ро┐, роиро┐ро▒рпБродрпНродро▒рпНроХрпБро▒ро┐
тБЙ => тБЙ, роЖроЪрпНроЪро░ро┐ропроорпН, роЖроЪрпНроЪро░ро┐ропроХрпНроХрпБро▒ро┐, роХрпБро▒ро┐, роиро┐ро▒рпБродрпНродро▒рпНроХрпБро▒ро┐, роХрпЗро│рпНро╡ро┐роХрпНроХрпБро▒ро┐
тЭУ => тЭУ, роХрпЗро│рпНро╡ро┐роХрпН роХрпБро▒ро┐, роЕроЯро░рпН роиро┐ро▒ роХрпЗро│рпНро╡ро┐роХрпН роХрпБро▒ро┐, роХрпБро▒ро┐, роиро┐ро▒рпБродрпНродро▒рпНроХрпБро▒ро┐
тЭФ => тЭФ, роХрпЗро│рпНро╡ро┐роХрпН роХрпБро▒ро┐, ро╡рпЖро│ро┐ро░рпН роиро┐ро▒роХрпН роХрпЗро│рпНро╡ро┐роХрпН роХрпБро▒ро┐, роХрпБро▒ро┐, роиро┐ро▒рпБродрпНродро▒рпНроХрпБро▒ро┐
тЭХ => тЭХ, роЖроЪрпНроЪро░ро┐ропроХрпНроХрпБро▒ро┐, роХрпБро▒ро┐, роиро┐ро▒рпБродрпНродро▒рпНроХрпБро▒ро┐
тЭЧ => тЭЧ, роЖроЪрпНроЪро░ро┐ропроХрпНроХрпБро▒ро┐, роЪро┐ро╡рокрпНрокрпБ роиро┐ро▒ роЖроЪрпНроЪро░ро┐ропроХрпНроХрпБро▒ро┐, роХрпБро▒ро┐, роиро┐ро▒рпБродрпНродро▒рпНроХрпБро▒ро┐
уА░ => уА░, роЕро▓рпИ роУроЪрпИ, роЕро▓рпИ роЪродрпНродроорпН, роЗро░рпИроЪрпНроЪро▓рпН роЪродрпНродроорпН
┬й => ┬й, рокродро┐рокрпНрокрпБро░ро┐роорпИ
┬о => ┬о, рокродро┐ро╡рпБроЪрпЖропрпНрод роЪро┐ройрпНройроорпН, рокродро┐ро╡рпБ роЪро┐ройрпНройроорпН
тДв => тДв, ро╡ро░рпНродрпНродроХ роорпБродрпНродро┐ро░рпИроЪрпН роЪро┐ройрпНройроорпН, ро╡ро░рпНродрпНродроХроЪрпН роЪро┐ройрпНройроорпН
тЩИ => тЩИ, ро░ро╛роЪро┐, роЗро░ро╛роЪро┐, роироЯрпНроЪродрпНродро┐ро░роорпН
тЩЙ => тЩЙ, ро░ро╛роЪро┐, роЗро░ро╛роЪро┐, роироЯрпНроЪродрпНродро┐ро░роорпН
тЩК => тЩК, ро░ро╛роЪро┐, роЗро░ро╛роЪро┐, роироЯрпНроЪродрпНродро┐ро░роорпН
тЩЛ => тЩЛ, ро░ро╛роЪро┐, роЗро░ро╛роЪро┐, роироЯрпНроЪродрпНродро┐ро░роорпН
тЩМ => тЩМ, ро░ро╛роЪро┐, роЗро░ро╛роЪро┐, роироЯрпНроЪродрпНродро┐ро░роорпН
тЩН => тЩН, ро░ро╛роЪро┐, роЗро░ро╛роЪро┐, роироЯрпНроЪродрпНродро┐ро░роорпН
тЩО => тЩО, ро░ро╛роЪро┐, роЗро░ро╛роЪро┐, роироЯрпНроЪродрпНродро┐ро░роорпН
тЩП => тЩП, ро░ро╛роЪро┐, роЗро░ро╛роЪро┐, роироЯрпНроЪродрпНродро┐ро░роорпН
тЩР => тЩР, ро░ро╛роЪро┐, роЗро░ро╛роЪро┐, роироЯрпНроЪродрпНродро┐ро░роорпН
тЩС => тЩС, ро░ро╛роЪро┐, роЗро░ро╛роЪро┐, роироЯрпНроЪродрпНродро┐ро░роорпН
тЩТ => тЩТ, ро░ро╛роЪро┐, роЗро░ро╛роЪро┐, роХрпБроорпНрокроорпН, роироЯрпНроЪродрпНродро┐ро░роорпН
тЩУ => тЩУ, ро░ро╛роЪро┐, роЗро░ро╛роЪро┐, роироЯрпНроЪродрпНродро┐ро░роорпН
тЫО => тЫО, роироЯрпНроЪродрпНродро┐ро░роорпН
ЁЯФА => ЁЯФА, роЕроорпНрокрпБроХрпНроХрпБро▒ро┐роХро│рпН
ЁЯФБ => ЁЯФБ, роЕроорпНрокрпБроХрпНроХрпБро▒ро┐роХро│рпН
ЁЯФВ => ЁЯФВ, роТройрпНро▒рпБроЯройрпН роХроЯро┐роХро╛ро░ родро┐роЪрпИ роЕроорпНрокрпБроХрпНроХрпБро▒ро┐роХро│рпН
тЦ╢ => тЦ╢, рокро┐ро│рпЗ рокроЯрпНроЯройрпН, роЗропроХрпНроХрпБ, рокро┐ро│рпЗ, рокрпКродрпНродро╛ройрпН
тПй => тПй, ро╡ро▓рокрпНрокроХрпНроХродрпНродрпИроЪрпН роЪрпБроЯрпНроЯро┐роХрпНроХро╛роЯрпНроЯрпБроорпН роЗро░роЯрпНроЯрпИ роорпБроХрпНроХрпЛрогроорпН, роЪро┐ройрпНройроорпН, роГрокро╛ро╕рпНроЯрпН рокро╛ро░рпНро╡ро░рпНроЯрпБ
тПн => тПн, роЕроЯрпБродрпНродродрпБ, роЕроЯрпБродрпНродрпБ роЪрпЖро▓рпН, роЕроЯрпБродрпНродрпБ роЪрпЖро▓рпНро╡родро▒рпНроХро╛рой роХрпБро▒ро┐
тПп => тПп, рокро┐ро│рпЗ рокроЯрпНроЯройрпН, роЗропроХрпНроХрпБ, рокро┐ро│рпЗ, рокрпКродрпНродро╛ройрпН, роиро┐ро▒рпБродрпНродрпБ
тЧА => тЧА, рокрпЗроХрпН рокроЯрпНроЯройрпН
тПк => тПк, роЪро┐ройрпНройроорпН, ро░рпАро╡рпИрогрпНроЯрпН
тПо => тПо, роЯро┐ро░ро╛роХрпН рокроЯрпНроЯройрпН, роХроЯрпИроЪро┐ роЯро┐ро░ро╛роХрпН
ЁЯФ╝ => ЁЯФ╝, роорпБроХрпНроХрпЛрог рокроЯрпНроЯройрпН, рокроЯрпНроЯройрпН
тПл => тПл, роорпЗро▓рпЗ роЪрпБроЯрпНроЯро┐роХрпНроХро╛роЯрпНроЯрпБроорпН роЗро░роЯрпНроЯрпИ роорпБроХрпНроХрпЛрогроорпН, роЪро┐ройрпНройроорпН
ЁЯФ╜ => ЁЯФ╜, роорпБроХрпНроХрпЛрог рокроЯрпНроЯройрпН, рокроЯрпНроЯройрпН
тПм => тПм, роЪро┐ройрпНройроорпН
тП╕ => тП╕, рокро╛ро╕рпН рокроЯрпНроЯройрпН, роиро┐ро▒рпБродрпНродрпБ
тП╣ => тП╣, ро╕рпНроЯро╛рокрпН рокроЯрпНроЯройрпН
тП║ => тП║, ро░ро┐роХрпНроХро╛ро░рпНроЯрпН рокроЯрпНроЯройрпН
тПП => тПП, роОроЬрпЖроХрпНроЯрпН рокроЯрпНроЯройрпН
ЁЯОж => ЁЯОж, роорпВро╡ро┐, родро┐ро░рпИрокрпНрокроЯроорпН рокро╛ро░рпНродрпНродро▓рпН, родро┐ро░рпИропро░роЩрпНроХроорпН, рокрпКро┤рпБродрпБрокрпЛроХрпНроХрпБ
ЁЯФЕ => ЁЯФЕ, роороЩрпНроХро▓рпН, роЯро┐роорпН, роХрпБро▒рпИро╡ро╛рой ро╡рпЖро│ро┐роЪрпНроЪроорпН, роХрпБро▒рпИ ро╡рпЖро│ро┐роЪрпНроЪроХрпН роХрпБро▒ро┐
ЁЯФЖ => ЁЯФЖ, роиро▓рпНро▓ ро╡рпЖро│ро┐роЪрпНроЪроорпН, роЕродро┐роХ ро╡рпЖро│ро┐роЪрпНроЪроХрпН роХрпБро▒ро┐
ЁЯУ╢ => ЁЯУ╢, роХро╡ро░рпЗроЬрпН, роорпКрокрпИро▓рпН, роЯро╡ро░рпН
ЁЯУ╡ => ЁЯУ╡, роЪрпЖро▓рпН родроЯрпИ, роЪрпЖро▓рпН родроЯрпИ роЪрпЖропрпНропрокрпНрокроЯрпНроЯ рокроХрпБродро┐
ЁЯУ│ => ЁЯУ│, роЕродро┐ро░рпБроорпН роЪрпЖро▓рпНрокрпЛройрпН
ЁЯУ┤ => ЁЯУ┤, роЕрогрпИродрпНрод роЪрпЖро▓рпН, роорпКрокрпИро▓рпН, роЖроГрокрпН
#тГг => #тГг, ро╣рпЗро╖рпН, рокро╡рпБрогрпНроЯрпБ
*тГг => *тГг, роЖро╕рпНроЯро░ро┐роХрпН, ро╕рпНроЯро╛ро░рпН, роХрпА роХрпЗрокрпН
ЁЯФЯ => ЁЯФЯ, 10 роЖроорпН роОрогрпН
ЁЯТп => ЁЯТп, роорпБро┤рпБ роородро┐рокрпНрокрпЖрогрпН, роорпБро┤рпБ ро╕рпНроХрпЛро░рпН, 100
ЁЯФЮ => ЁЯФЮ, 18
ЁЯФа => ЁЯФа, рокрпЗро░рпЖро┤рпБродрпНродрпБ, роХрпЗрокро┐роЯро▓рпН, роЖроЩрпНроХро┐ро▓роорпН, ро▓родрпНродрпАройрпН роОро┤рпБродрпНродрпБ, родроЯрпНроЯроЪрпНроЪрпБ
ЁЯФб => ЁЯФб, роЪро┐ро▒рпНро▒рпЖро┤рпБродрпНродрпБ, роЖроЩрпНроХро┐ро▓роорпН, ро▓родрпНродрпАройрпН роОро┤рпБродрпНродрпБ, родроЯрпНроЯроЪрпНроЪрпБ
ЁЯФв => ЁЯФв, роОрогрпН, роОрогрпН родроЯрпНроЯроЪрпНроЪрпБ
ЁЯФг => ЁЯФг, роХрпБро▒ро┐ропрпАроЯрпБ, роЪро┐роорпНрокро▓рпН
ЁЯФд => ЁЯФд, роОрогрпН родроЯрпНроЯроЪрпНроЪрпБ, роЖроЩрпНроХро┐ро▓роорпН, ABC
ЁЯЕ░ => ЁЯЕ░, A роХрпБро░рпВрокрпН, роЗро░родрпНрод ро╡роХрпИ
ЁЯЖО => ЁЯЖО, AB роХрпБро░рпВрокрпН, роЗро░родрпНрод ро╡роХрпИ
ЁЯЕ▒ => ЁЯЕ▒, B роХрпБро░рпВрокрпН, роЗро░родрпНрод ро╡роХрпИ
ЁЯЖС => ЁЯЖС, CL, роЕро┤ро┐
ЁЯЖТ => ЁЯЖТ, роХрпВро▓рпН роЪро┐ройрпНройроорпН
ЁЯЖУ => ЁЯЖУ, роЗро▓ро╡роЪроЪрпН роЪро┐ройрпНройроорпН
тД╣ => тД╣, роЖродро╛ро░роорпН
ЁЯЖФ => ЁЯЖФ, роЕроЯрпИропро╛ро│роорпН, роЪро┐ройрпНройроорпН
тУВ => тУВ, роЪро░рпНроХрпНроХро┐ро│рпН роОроорпН ро▓рпЖроЯрпНроЯро░рпН
ЁЯЖХ => ЁЯЖХ, рокрпБродро┐ропродрпБ, рокрпБродро┐роп роЪро┐ройрпНройроорпН
ЁЯЖЦ => ЁЯЖЦ, роЪро░ро┐ропро▓рпНро▓, рокрпЛроХро╛родрпЗ
ЁЯЕ╛ => ЁЯЕ╛, O роХрпБро░рпВрокрпН, роЗро░родрпНрод ро╡роХрпИ
ЁЯЖЧ => ЁЯЖЧ, роЪро░ро┐
ЁЯЕ┐ => ЁЯЕ┐, рокро╛ро░рпНроХро┐роЩрпН ро▓ро╛роЯрпН, ро╡ро╛роХройроорпН роиро┐ро▒рпБродрпНродрпБрооро┐роЯроорпН
ЁЯЖШ => ЁЯЖШ, роЙродро╡ро┐, роЕро╡роЪро░роорпН
ЁЯЖЩ => ЁЯЖЩ, рокрпБродро┐ропродрпБ, рокрпБродрпБрокрпНрокро┐рокрпНрокрпБ
ЁЯЖЪ => ЁЯЖЪ, роирпЗро░рпБроХрпНроХрпБ роирпЗро░рпН
ЁЯИБ => ЁЯИБ, роЬрокрпНрокро╛ройрпН роорпКро┤ро┐
ЁЯИВ => ЁЯИВ, роЬрокрпНрокро╛ройрпН роорпКро┤ро┐
ЁЯИ╖ => ЁЯИ╖, роЬрокрпНрокро╛ройрпН роорпКро┤ро┐
ЁЯИ╢ => ЁЯИ╢, роЬрокрпНрокро╛ройрпН роорпКро┤ро┐
ЁЯИп => ЁЯИп, роЬрокрпНрокро╛ройрпН роорпКро┤ро┐
ЁЯЙР => ЁЯЙР, роЬрокрпНрокро╛ройрпН роорпКро┤ро┐
ЁЯИ╣ => ЁЯИ╣, роЬрокрпНрокро╛ройрпН роорпКро┤ро┐
ЁЯИЪ => ЁЯИЪ, роЬрокрпНрокро╛ройрпН роорпКро┤ро┐
ЁЯИ▓ => ЁЯИ▓, роЬрокрпНрокро╛ройрпН роорпКро┤ро┐
ЁЯЙС => ЁЯЙС, роЪрпАрой роорпКро┤ро┐
ЁЯИ╕ => ЁЯИ╕, роЪрпАрой роорпКро┤ро┐
ЁЯИ┤ => ЁЯИ┤, роЪрпАрой роорпКро┤ро┐
ЁЯИ│ => ЁЯИ│, роЪрпАрой роорпКро┤ро┐
уКЧ => уКЧ, ро╡ро╛ро┤рпНродрпНродрпБроХро│рпН, роЪрпИройрпАро╕рпН, роРроЯро┐ропрпЛроХро┐ро░ро╛роГрокрпН
уКЩ => уКЩ, ро╡ро╛ро┤рпНродрпНродрпБроХро│рпН, роЪрпИройрпАро╕рпН, роЪрпАроХрпНро░рпЖроЯрпН
ЁЯИ║ => ЁЯИ║, роЪрпИройрпАро╕рпН, роЪрпАройроорпН, роорпКро┤ро┐, ро╡ро╛ро░рпНродрпНродрпИ
ЁЯИ╡ => ЁЯИ╡, роЪрпИройрпАро╕рпН, роЪрпАройроорпН, роорпКро┤ро┐, ро╡ро╛ро░рпНродрпНродрпИ
тЦк => тЦк, рокро┐ро│ро╛роХрпН ро╕рпНроХрпКропро░рпН, роХро░рпБрокрпНрокрпБ роЪродрпБро░роорпН
тЦл => тЦл, роТропро┐роЯрпН ро╕рпНроХрпКропро░рпН, ро╡рпЖро│рпНро│рпИ роЪродрпБро░роорпН
тЧ╗ => тЧ╗, роорпАроЯро┐ропроорпН ро╕рпНроХрпКропро░рпН, ро╡рпЖро│рпНро│рпИ роЪродрпБро░роорпН
тЧ╝ => тЧ╝, роорпАроЯро┐ропрпЛ рокро┐ро│ро╛роХрпН ро╕рпНроХрпКропро░рпН, роХро░рпБрокрпНрокрпБ роЪродрпБро░роорпН
тЧ╜ => тЧ╜, роТропро┐роЯрпН роорпАроЯро┐ропроорпН ро╕рпНроХрпКропро░рпН
тЧ╛ => тЧ╛, рокро┐ро│ро╛роХрпН роорпАроЯро┐ропроорпН ро╕рпНроХрпКропро░рпН
тмЫ => тмЫ, рокро┐ро│ро╛роХрпН, ро▓ро╛ро░рпНроЬрпН ро╕рпНроХрпКропро░рпН
тмЬ => тмЬ, роТропро┐роЯрпН, ро▓ро╛ро░рпНроЬрпН ро╕рпНроХрпКропро░рпН
ЁЯФ╢ => ЁЯФ╢, рокрпЖро░ро┐роп ро╡рпИро░роорпН, роЖро░роЮрпНроЪрпБ, роЯрпИроорогрпНроЯрпН, ро╡рпИро░роорпН
ЁЯФ╖ => ЁЯФ╖, рокрпЖро░ро┐роп ро╡рпИро░роорпН, роирпАро▓роорпН, роЯрпИроорогрпНроЯрпН, ро╡рпИро░роорпН
ЁЯФ╕ => ЁЯФ╕, роЪро┐ро▒ро┐роп ро╡рпИро░роорпН, роЖро░роЮрпНроЪрпБ, роЯрпИроорогрпНроЯрпН, ро╡рпИро░роорпН
ЁЯФ╣ => ЁЯФ╣, роЪро┐ро▒ро┐роп ро╡рпИро░роорпН, роирпАро▓роорпН, роЯрпИроорогрпНроЯрпН, ро╡рпИро░роорпН
ЁЯФ║ => ЁЯФ║, роорпЗро▓рпНроирпЛроХрпНроХро┐роп роорпБроХрпНроХрпЛрогроорпН, роорпЗро▓рпН роорпБроХрпНроХрпЛрогроорпН, роЪро┐ро╡рокрпНрокрпБ, роорпБроХрпНроХрпЛрогроорпН
ЁЯФ╗ => ЁЯФ╗, роХрпАро┤рпНроирпЛроХрпНроХро┐роп роорпБроХрпНроХрпЛрогроорпН, роХрпАро┤рпН роорпБроХрпНроХрпЛрогроорпН, роЪро┐ро╡рокрпНрокрпБ, роорпБроХрпНроХрпЛрогроорпН
ЁЯТа => ЁЯТа, рокрпВ роЗродро┤рпН, ро╡рпИро░ ро╡роЯро┐ро╡роорпН, роХро┐ропрпВроЯрпН, ро╡рпИро░роорпН, роЙрогро░рпНроЪрпНроЪро┐
ЁЯФШ => ЁЯФШ, рокроЯрпНроЯройрпН, рокрпКродрпНродро╛ройрпН
ЁЯФ▓ => ЁЯФ▓, роХро░рпБрокрпНрокрпБ роЪродрпБро░роорпН, рокро┐ро│ро╛роХрпН ро╕рпНроХрпКропро░рпН, роЪродрпБро░ рокроЯрпНроЯройрпН, рокроЯрпНроЯройрпН
ЁЯФ│ => ЁЯФ│, ро╡рпЖро│рпНро│рпИ роЪродрпБро░роорпН, роТропро┐роЯрпН ро╕рпНроХрпКропро░рпН, роЪродрпБро░ рокроЯрпНроЯройрпН, рокроЯрпНроЯройрпН
тЪк => тЪк, ро╡роЯрпНроЯроорпН, роЬро┐ропрпЛроорпЖроЯрпНро░ро┐роХрпН
тЪл => тЪл, роЪро░рпНроХрпНроХро┐ро│рпН, роЬро┐ропрпЛроорпЖроЯрпНро░ро┐роХрпН
ЁЯФ┤ => ЁЯФ┤, ро░рпЖроЯрпН роЪро░рпНроХрпНроХро┐ро│рпН
ЁЯФ╡ => ЁЯФ╡, рокрпНро│рпВ, роЪро░рпНроХрпНроХро┐ро│рпН
ЁЯЫС => ЁЯЫС, роиро┐ро▓рпН, роиро┐ро▒рпБродрпНродроорпН
ЁЯЫТ => ЁЯЫТ, ро╖ро╛рокрпНрокро┐роЩрпН, роХрпВроЯрпИ
ЁЯЫ┤ => ЁЯЫ┤, роХро┐роХрпН, ро╕рпНроХрпВроЯрпНроЯро░рпН
ЁЯЫ╡ => ЁЯЫ╡, ро╕рпНроХрпВроЯрпНроЯро░рпН, роорпЛроЯрпНроЯро╛ро░рпН
ЁЯЫ╢ => ЁЯЫ╢, рокроЯроХрпБ
0тГг => 0тГг, роЗро▓роХрпНроХроорпН, рокрпВроЬрпНропроорпН
1тГг => 1тГг, роТройрпНро▒рпБ
2тГг => 2тГг, роЗро░рогрпНроЯрпБ
3тГг => 3тГг, роорпВройрпНро▒рпБ
4тГг => 4тГг, роиро╛ройрпНроХрпБ
5тГг => 5тГг, роРроирпНродрпБ
6тГг => 6тГг, роЖро▒рпБ
7тГг => 7тГг, роПро┤рпБ
8тГг => 8тГг, роОроЯрпНроЯрпБ
9тГг => 9тГг, роТройрпНрокродрпБ
ЁЯЗжЁЯЗи => ЁЯЗжЁЯЗи, роЕро╖ройрпНро╖ро┐ропройрпН родрпАро╡рпБ
ЁЯЗжЁЯЗй => ЁЯЗжЁЯЗй, роЕройрпНроЯрпЛро░ро╛
ЁЯЗжЁЯЗк => ЁЯЗжЁЯЗк, роРроХрпНроХро┐роп роЕро░рокрпБ роОрооро┐ро░рпЗроЯрпНро╕рпН
ЁЯЗжЁЯЗл => ЁЯЗжЁЯЗл, роЖрокрпНроХро╛ройро┐ро╕рпНродро╛ройрпН
ЁЯЗжЁЯЗм => ЁЯЗжЁЯЗм, роЖрогрпНроЯро┐роХрпБро╡ро╛ рооро▒рпНро▒рпБроорпН рокро╛ро░рпНрокрпБроЯро╛
ЁЯЗжЁЯЗо => ЁЯЗжЁЯЗо, роЕроЩрпНроХрпБропрпНро▓ро╛
ЁЯЗжЁЯЗ▒ => ЁЯЗжЁЯЗ▒, роЕро▓рпНрокрпЗройро┐ропро╛
ЁЯЗжЁЯЗ▓ => ЁЯЗжЁЯЗ▓, роЕро░рпНроорпЗройро┐ропро╛
ЁЯЗжЁЯЗ┤ => ЁЯЗжЁЯЗ┤, роЕроЩрпНроХрпЛро▓ро╛
ЁЯЗжЁЯЗ╢ => ЁЯЗжЁЯЗ╢, роЕрогрпНроЯро╛ро░рпНроЯро┐роХро╛
ЁЯЗжЁЯЗ╖ => ЁЯЗжЁЯЗ╖, роЕро░рпНроЬрпЖройрпНроЯро┐ройро╛
ЁЯЗжЁЯЗ╕ => ЁЯЗжЁЯЗ╕, роЕроорпЖро░ро┐роХрпНроХ роЪроорпЛро╡ро╛
ЁЯЗжЁЯЗ╣ => ЁЯЗжЁЯЗ╣, роЖро╕рпНродро┐ро░ро┐ропро╛
ЁЯЗжЁЯЗ║ => ЁЯЗжЁЯЗ║, роЖро╕рпНродро┐ро░рпЗро▓ро┐ропро╛
ЁЯЗжЁЯЗ╝ => ЁЯЗжЁЯЗ╝, роЕро░рпВрокро╛
ЁЯЗжЁЯЗ╜ => ЁЯЗжЁЯЗ╜, роЖро▓роирпНродрпБ родрпАро╡рпБроХро│рпН
ЁЯЗжЁЯЗ┐ => ЁЯЗжЁЯЗ┐, роЕроЪро░рпНрокрпИроЬро╛ройрпН
ЁЯЗзЁЯЗж => ЁЯЗзЁЯЗж, рокрпЛро╕рпНройро┐ропро╛ & ро╣рпЖро░рпНро╕роХрпЛро╡ро┐ройро╛
ЁЯЗзЁЯЗз => ЁЯЗзЁЯЗз, рокро╛ро░рпНрокроЯрпЛро╕рпН
ЁЯЗзЁЯЗй => ЁЯЗзЁЯЗй, рокроЩрпНроХро│ро╛родрпЗро╖рпН
ЁЯЗзЁЯЗк => ЁЯЗзЁЯЗк, рокрпЖро▓рпНроЬро┐ропроорпН
ЁЯЗзЁЯЗл => ЁЯЗзЁЯЗл, рокрпБро░рпНроХро┐ройро╛ роГрокро╛ро╕рпЛ
ЁЯЗзЁЯЗм => ЁЯЗзЁЯЗм, рокро▓рпНроХрпЗро░ро┐ропро╛
ЁЯЗзЁЯЗн => ЁЯЗзЁЯЗн, рокро╣рпНро░рпИройрпН
ЁЯЗзЁЯЗо => ЁЯЗзЁЯЗо, рокрпБро░рпБрогрпНроЯро┐
ЁЯЗзЁЯЗп => ЁЯЗзЁЯЗп, рокрпЖройро┐ройрпН
ЁЯЗзЁЯЗ▒ => ЁЯЗзЁЯЗ▒, роЪрпЖропро┐ройрпНроЯрпН рокро╛ро░рпНродрпЗро▓рпЖрооро┐
ЁЯЗзЁЯЗ▓ => ЁЯЗзЁЯЗ▓, рокрпЖро░рпНроорпБроЯро╛
ЁЯЗзЁЯЗ│ => ЁЯЗзЁЯЗ│, рокрпБро░рпБройрпЗ
ЁЯЗзЁЯЗ┤ => ЁЯЗзЁЯЗ┤, рокрпКро▓ро┐ро╡ро┐ропро╛
ЁЯЗзЁЯЗ╢ => ЁЯЗзЁЯЗ╢, роХро░рпАрокро┐ропройрпН роирпЖродро░рпНро▓ро╛роирпНродрпБ
ЁЯЗзЁЯЗ╖ => ЁЯЗзЁЯЗ╖, рокро┐ро░рпЗроЪро┐ро▓рпН
ЁЯЗзЁЯЗ╕ => ЁЯЗзЁЯЗ╕, рокро╣ро╛рооро╛ро╕рпН
ЁЯЗзЁЯЗ╣ => ЁЯЗзЁЯЗ╣, рокрпВроЯро╛ройрпН
ЁЯЗзЁЯЗ╗ => ЁЯЗзЁЯЗ╗, рокрпКро╡рпЗроЯрпН родрпАро╡рпБроХро│рпН
ЁЯЗзЁЯЗ╝ => ЁЯЗзЁЯЗ╝, рокрпЛроЯрпНро╕рпНро╡ро╛ройро╛
ЁЯЗзЁЯЗ╛ => ЁЯЗзЁЯЗ╛, рокрпЖро▓ро╛ро░рпВро╕рпН
ЁЯЗзЁЯЗ┐ => ЁЯЗзЁЯЗ┐, рокрпЖро▓ро┐ро╕рпН
ЁЯЗиЁЯЗж => ЁЯЗиЁЯЗж, роХройроЯро╛
ЁЯЗиЁЯЗи => ЁЯЗиЁЯЗи, роХрпЛроХрпЛро╕рпН (роХрпАро▓ро┐роЩрпН) родрпАро╡рпБроХро│рпН
ЁЯЗиЁЯЗй => ЁЯЗиЁЯЗй, роХро╛роЩрпНроХрпЛ - роХро┐ройрпНро╖ро╛роЪро╛
ЁЯЗиЁЯЗл => ЁЯЗиЁЯЗл, роородрпНродро┐роп роЖрокрпНро░ро┐роХрпНроХроХрпН роХрпБроЯро┐ропро░роЪрпБ
ЁЯЗиЁЯЗм => ЁЯЗиЁЯЗм, роХро╛роЩрпНроХрпЛ - рокрпНро░ро╛ро╕ро╛ро╡ро┐ро▓рпНро▓рпЗ
ЁЯЗиЁЯЗн => ЁЯЗиЁЯЗн, ро╕рпНро╡ро┐роЯрпНроЪро░рпНро▓ро╛роирпНродрпБ
ЁЯЗиЁЯЗо => ЁЯЗиЁЯЗо, роХрпЛроЯрпН родро┐тАЩро╡ро╛ропро░рпН
ЁЯЗиЁЯЗ░ => ЁЯЗиЁЯЗ░, роХрпБроХрпН родрпАро╡рпБроХро│рпН
ЁЯЗиЁЯЗ▒ => ЁЯЗиЁЯЗ▒, роЪро┐ро▓ро┐
ЁЯЗиЁЯЗ▓ => ЁЯЗиЁЯЗ▓, роХрпЗрооро░рпВройрпН
ЁЯЗиЁЯЗ│ => ЁЯЗиЁЯЗ│, роЪрпАройро╛
ЁЯЗиЁЯЗ┤ => ЁЯЗиЁЯЗ┤, роХрпКро▓роорпНрокро┐ропро╛
ЁЯЗиЁЯЗ╡ => ЁЯЗиЁЯЗ╡, роХро┐ро▓ро┐рокрпНрокро░рпНроЯройрпН родрпАро╡рпБ
ЁЯЗиЁЯЗ╖ => ЁЯЗиЁЯЗ╖, роХрпЛро╕рпНроЯро╛ро░ро┐роХро╛
ЁЯЗиЁЯЗ║ => ЁЯЗиЁЯЗ║, роХро┐ропрпВрокро╛
ЁЯЗиЁЯЗ╗ => ЁЯЗиЁЯЗ╗, роХрпЗрокрпН ро╡рпЖро░рпНроЯрпЗ
ЁЯЗиЁЯЗ╝ => ЁЯЗиЁЯЗ╝, роХрпБро░ро╛роХро╡рпН
ЁЯЗиЁЯЗ╜ => ЁЯЗиЁЯЗ╜, роХро┐ро▒ро┐ро╕рпНродрпБрооро╕рпН родрпАро╡рпБ
ЁЯЗиЁЯЗ╛ => ЁЯЗиЁЯЗ╛, роЪрпИрокрпНро░ро╕рпН
ЁЯЗиЁЯЗ┐ => ЁЯЗиЁЯЗ┐, роЪрпЖроХрпН роХрпБроЯро┐ропро░роЪрпБ
ЁЯЗйЁЯЗк => ЁЯЗйЁЯЗк, роЬрпЖро░рпНрооройро┐
ЁЯЗйЁЯЗм => ЁЯЗйЁЯЗм, роЯро┐ропроХрпЛ роХро╛ро░рпНро╖ро┐ропро╛
ЁЯЗйЁЯЗп => ЁЯЗйЁЯЗп, роЬро┐рокрпМроЯрпНроЯро┐
ЁЯЗйЁЯЗ░ => ЁЯЗйЁЯЗ░, роЯрпЖройрпНрооро╛ро░рпНроХрпН
ЁЯЗйЁЯЗ▓ => ЁЯЗйЁЯЗ▓, роЯрпКрооро┐ройро┐роХро╛
ЁЯЗйЁЯЗ┤ => ЁЯЗйЁЯЗ┤, роЯрпКрооро┐ройро┐роХройрпН роХрпБроЯро┐ропро░роЪрпБ
ЁЯЗйЁЯЗ┐ => ЁЯЗйЁЯЗ┐, роЕро▓рпНроЬрпАро░ро┐ропро╛
ЁЯЗкЁЯЗж => ЁЯЗкЁЯЗж, роЪро┐ропрпВроЯро╛ & роорпЖро▓ро┐ро▓рпНро▓ро╛
ЁЯЗкЁЯЗи => ЁЯЗкЁЯЗи, роИроХрпНро╡роЯро╛ро░рпН
ЁЯЗкЁЯЗк => ЁЯЗкЁЯЗк, роОро╕рпНроЯрпЛройро┐ропро╛
ЁЯЗкЁЯЗм => ЁЯЗкЁЯЗм, роОроХро┐рокрпНродрпБ
ЁЯЗкЁЯЗн => ЁЯЗкЁЯЗн, роорпЗро▒рпНроХрпБ роЪро╣ро╛ро░ро╛
ЁЯЗкЁЯЗ╖ => ЁЯЗкЁЯЗ╖, роОро░ро┐роЯрпНро░ро┐ропро╛
ЁЯЗкЁЯЗ╕ => ЁЯЗкЁЯЗ╕, ро╕рпНрокрпЖропро┐ройрпН
ЁЯЗкЁЯЗ╣ => ЁЯЗкЁЯЗ╣, роОродрпНродро┐ропрпЛрокрпНрокро┐ропро╛
ЁЯЗкЁЯЗ║ => ЁЯЗкЁЯЗ║, роРро░рпЛрокрпНрокро┐роп ропрпВройро┐ропройрпН
ЁЯЗлЁЯЗо => ЁЯЗлЁЯЗо, рокро┐ройрпНро▓ро╛роирпНродрпБ
ЁЯЗлЁЯЗп => ЁЯЗлЁЯЗп, роГрокро┐роЬро┐
ЁЯЗлЁЯЗ░ => ЁЯЗлЁЯЗ░, роГрокро╛роХрпНро▓ро╛роирпНродрпБ родрпАро╡рпБроХро│рпН
ЁЯЗлЁЯЗ▓ => ЁЯЗлЁЯЗ▓, роорпИроХрпНро░рпЛройрпЗро╖ро┐ропро╛
ЁЯЗлЁЯЗ┤ => ЁЯЗлЁЯЗ┤, роГрокро╛ро░рпЛ родрпАро╡рпБроХро│рпН
ЁЯЗлЁЯЗ╖ => ЁЯЗлЁЯЗ╖, рокро┐ро░ро╛ройрпНро╕рпН
ЁЯЗмЁЯЗж => ЁЯЗмЁЯЗж, роХрпЗрокро╛ройрпН
ЁЯЗмЁЯЗз => ЁЯЗмЁЯЗз, ропрпБройрпИроЯрпЖроЯрпН роХро┐роЩрпНроЯроорпН
ЁЯЗмЁЯЗй => ЁЯЗмЁЯЗй, роХро┐ро░ройрпЖроЯро╛
ЁЯЗмЁЯЗк => ЁЯЗмЁЯЗк, роЬро╛ро░рпНроЬро┐ропро╛
ЁЯЗмЁЯЗл => ЁЯЗмЁЯЗл, рокро┐ро░рпЖроЮрпНроЪрпБ роХропро╛ройро╛
ЁЯЗмЁЯЗм => ЁЯЗмЁЯЗм, роХрпЖро░рпНройрпНроЪро┐
ЁЯЗмЁЯЗн => ЁЯЗмЁЯЗн, роХро╛ройро╛
ЁЯЗмЁЯЗо => ЁЯЗмЁЯЗо, роЬро┐рокрпНро░ро╛ро▓рпНроЯро░рпН
ЁЯЗмЁЯЗ▒ => ЁЯЗмЁЯЗ▒, роХро┐ро░рпАройрпНро▓ро╛роирпНродрпБ
ЁЯЗмЁЯЗ▓ => ЁЯЗмЁЯЗ▓, роХро╛роорпНрокро┐ропро╛
ЁЯЗмЁЯЗ│ => ЁЯЗмЁЯЗ│, роХро┐ройро┐ропро╛
ЁЯЗмЁЯЗ╡ => ЁЯЗмЁЯЗ╡, роХрпНро╡ро╛родрпЗро▓рпЛрокрпН
ЁЯЗмЁЯЗ╢ => ЁЯЗмЁЯЗ╢, роИроХрпНро╡роЯрпЛро░ро┐ропро▓рпН роХро┐ройро┐ропро╛
ЁЯЗмЁЯЗ╖ => ЁЯЗмЁЯЗ╖, роХро┐ро░рпАро╕рпН
ЁЯЗмЁЯЗ╕ => ЁЯЗмЁЯЗ╕, родрпЖро▒рпНроХрпБ роЬро╛ро░рпНроЬро┐ропро╛ рооро▒рпНро▒рпБроорпН родрпЖро▒рпНроХрпБ роЪро╛рогрпНроЯрпНро╡ро┐роЪрпН родрпАро╡рпБроХро│рпН
ЁЯЗмЁЯЗ╣ => ЁЯЗмЁЯЗ╣, роХро╡рпБродрооро╛ро▓ро╛
ЁЯЗмЁЯЗ║ => ЁЯЗмЁЯЗ║, роХрпБро╡ро╛роорпН
ЁЯЗмЁЯЗ╝ => ЁЯЗмЁЯЗ╝, роХро┐ройро┐ропро╛-рокро┐ро╕рпНро╕ро╛ро╡рпН
ЁЯЗмЁЯЗ╛ => ЁЯЗмЁЯЗ╛, роХропро╛ройро╛
ЁЯЗнЁЯЗ░ => ЁЯЗнЁЯЗ░, ро╣ро╛роЩрпНроХро╛роЩрпН роОро╕рпНроПроЖро░рпН роЪрпАройро╛
ЁЯЗнЁЯЗ▓ => ЁЯЗнЁЯЗ▓, ро╣рпЗро░рпНроЯрпН рооро▒рпНро▒рпБроорпН роорпЖроХрпНроЯрпКройро╛ро▓рпНроЯрпБ родрпАро╡рпБроХро│рпН
ЁЯЗнЁЯЗ│ => ЁЯЗнЁЯЗ│, ро╣рпЛрогрпНроЯрпВро░ро╛ро╕рпН
ЁЯЗнЁЯЗ╖ => ЁЯЗнЁЯЗ╖, роХрпБро░рпЗро╖ро┐ропро╛
ЁЯЗнЁЯЗ╣ => ЁЯЗнЁЯЗ╣, ро╣рпИроЯрпНроЯро┐
ЁЯЗнЁЯЗ║ => ЁЯЗнЁЯЗ║, ро╣роЩрпНроХрпЗро░ро┐
ЁЯЗоЁЯЗи => ЁЯЗоЁЯЗи, роХрпЗройро░ро┐ родрпАро╡рпБроХро│рпН
ЁЯЗоЁЯЗй => ЁЯЗоЁЯЗй, роЗроирпНродрпЛройрпЗроЪро┐ропро╛
ЁЯЗоЁЯЗк => ЁЯЗоЁЯЗк, роЕропро░рпНро▓ро╛роирпНродрпБ
ЁЯЗоЁЯЗ▒ => ЁЯЗоЁЯЗ▒, роЗро╕рпНро░рпЗро▓рпН
ЁЯЗоЁЯЗ▓ => ЁЯЗоЁЯЗ▓, роРро▓рпН роЖроГрокрпН роорпЗройрпН
ЁЯЗоЁЯЗ│ => ЁЯЗоЁЯЗ│, роЗроирпНродро┐ропро╛
ЁЯЗоЁЯЗ┤ => ЁЯЗоЁЯЗ┤, рокро┐ро░ро┐роЯрпНроЯро┐ро╖рпН роЗроирпНродро┐ропрокрпН рокрпЖро░рпБроЩрпНроХроЯро▓рпН рокро┐ро░родрпЗроЪроорпН
ЁЯЗоЁЯЗ╢ => ЁЯЗоЁЯЗ╢, роИро░ро╛роХрпН
ЁЯЗоЁЯЗ╖ => ЁЯЗоЁЯЗ╖, роИро░ро╛ройрпН
ЁЯЗоЁЯЗ╕ => ЁЯЗоЁЯЗ╕, роРро╕рпНро▓ро╛роирпНродрпБ
ЁЯЗоЁЯЗ╣ => ЁЯЗоЁЯЗ╣, роЗродрпНродро╛ро▓ро┐
ЁЯЗпЁЯЗк => ЁЯЗпЁЯЗк, роЬрпЖро░рпНроЪро┐
ЁЯЗпЁЯЗ▓ => ЁЯЗпЁЯЗ▓, роЬроорпИроХро╛
ЁЯЗпЁЯЗ┤ => ЁЯЗпЁЯЗ┤, роЬрпЛро░рпНроЯро╛ройрпН
ЁЯЗпЁЯЗ╡ => ЁЯЗпЁЯЗ╡, роЬрокрпНрокро╛ройрпН
ЁЯЗ░ЁЯЗк => ЁЯЗ░ЁЯЗк, роХрпЖройрпНропро╛
ЁЯЗ░ЁЯЗм => ЁЯЗ░ЁЯЗм, роХро┐ро░рпНроХро┐ро╕рпНродро╛ройрпН
ЁЯЗ░ЁЯЗн => ЁЯЗ░ЁЯЗн, роХроорпНрокрпЛроЯро┐ропро╛
ЁЯЗ░ЁЯЗо => ЁЯЗ░ЁЯЗо, роХро┐ро░ро┐рокро╛роЯрпНроЯро┐
ЁЯЗ░ЁЯЗ▓ => ЁЯЗ░ЁЯЗ▓, роХрпЛрооро░рпЛро╕рпН
ЁЯЗ░ЁЯЗ│ => ЁЯЗ░ЁЯЗ│, роЪрпЖропро┐ройрпНроЯрпН роХро┐роЯрпНро╕рпН & роирпЖро╡ро┐ро╕рпН
ЁЯЗ░ЁЯЗ╡ => ЁЯЗ░ЁЯЗ╡, ро╡роЯ роХрпКро░ро┐ропро╛
ЁЯЗ░ЁЯЗ╖ => ЁЯЗ░ЁЯЗ╖, родрпЖройрпН роХрпКро░ро┐ропро╛
ЁЯЗ░ЁЯЗ╝ => ЁЯЗ░ЁЯЗ╝, роХрпБро╡рпИродрпН
ЁЯЗ░ЁЯЗ╛ => ЁЯЗ░ЁЯЗ╛, роХрпЖропрпНроорпЖройрпН родрпАро╡рпБроХро│рпН
ЁЯЗ░ЁЯЗ┐ => ЁЯЗ░ЁЯЗ┐, роХро╕роХро╕рпНродро╛ройрпН
ЁЯЗ▒ЁЯЗж => ЁЯЗ▒ЁЯЗж, ро▓ро╛ро╡рпЛро╕рпН
ЁЯЗ▒ЁЯЗз => ЁЯЗ▒ЁЯЗз, ро▓рпЖрокройро╛ройрпН
ЁЯЗ▒ЁЯЗи => ЁЯЗ▒ЁЯЗи, роЪрпЖропро┐ройрпНроЯрпН ро▓рпВроЪро┐ропро╛
ЁЯЗ▒ЁЯЗо => ЁЯЗ▒ЁЯЗо, ро▓ро┐роЪрпНроЪрпЖрогрпНро╕рпНроЯрпЖропрпНройрпН
ЁЯЗ▒ЁЯЗ░ => ЁЯЗ▒ЁЯЗ░, роЗро▓роЩрпНроХрпИ
ЁЯЗ▒ЁЯЗ╖ => ЁЯЗ▒ЁЯЗ╖, ро▓рпИрокрпАро░ро┐ропро╛
ЁЯЗ▒ЁЯЗ╕ => ЁЯЗ▒ЁЯЗ╕, ро▓рпЖроЪрпЛродрпЛ
ЁЯЗ▒ЁЯЗ╣ => ЁЯЗ▒ЁЯЗ╣, ро▓ро┐родрпБро╡рпЗройро┐ропро╛
ЁЯЗ▒ЁЯЗ║ => ЁЯЗ▒ЁЯЗ║, ро▓роХрпНро╕рпНроЪроорпНрокро░рпНроХрпН
ЁЯЗ▒ЁЯЗ╗ => ЁЯЗ▒ЁЯЗ╗, ро▓ро╛роЯрпНро╡ро┐ропро╛
ЁЯЗ▒ЁЯЗ╛ => ЁЯЗ▒ЁЯЗ╛, ро▓ро┐рокро┐ропро╛
ЁЯЗ▓ЁЯЗж => ЁЯЗ▓ЁЯЗж, роорпКро░ро╛роХрпНроХрпЛ
ЁЯЗ▓ЁЯЗи => ЁЯЗ▓ЁЯЗи, роорпКройро╛роХрпНроХрпЛ
ЁЯЗ▓ЁЯЗй => ЁЯЗ▓ЁЯЗй, рооро╛ро▓рпНроЯрпЛро╡ро╛
ЁЯЗ▓ЁЯЗк => ЁЯЗ▓ЁЯЗк, рооро╛ройрпНроЯрпЗройрпЖроХрпНро░рпЛ
ЁЯЗ▓ЁЯЗл => ЁЯЗ▓ЁЯЗл, роЪрпЖропро┐ройрпНроЯрпН рооро╛ро░рпНроЯрпНроЯрпАройрпН
ЁЯЗ▓ЁЯЗм => ЁЯЗ▓ЁЯЗм, роороЯроХро╛ро╕рпНроХро░рпН
ЁЯЗ▓ЁЯЗн => ЁЯЗ▓ЁЯЗн, рооро╛ро░рпНро╖ро▓рпН родрпАро╡рпБроХро│рпН
ЁЯЗ▓ЁЯЗ░ => ЁЯЗ▓ЁЯЗ░, рооро╛роЪро┐роЯрпЛройро┐ропро╛
ЁЯЗ▓ЁЯЗ▒ => ЁЯЗ▓ЁЯЗ▒, рооро╛ро▓ро┐
ЁЯЗ▓ЁЯЗ▓ => ЁЯЗ▓ЁЯЗ▓, рооро┐ропро╛ройрпНрооро╛ро░рпН (рокро░рпНрооро╛)
ЁЯЗ▓ЁЯЗ│ => ЁЯЗ▓ЁЯЗ│, роороЩрпНроХрпЛро▓ро┐ропро╛
ЁЯЗ▓ЁЯЗ┤ => ЁЯЗ▓ЁЯЗ┤, роороХро╛ро╡рпН роОро╕рпНроПроЖро░рпН роЪрпАройро╛
ЁЯЗ▓ЁЯЗ╡ => ЁЯЗ▓ЁЯЗ╡, ро╡роЯроХрпНроХрпБ рооро░ро┐ропро╛ройро╛ родрпАро╡рпБроХро│рпН
ЁЯЗ▓ЁЯЗ╢ => ЁЯЗ▓ЁЯЗ╢, рооро╛ро░рпНроЯро┐ройро┐роХрпН
ЁЯЗ▓ЁЯЗ╖ => ЁЯЗ▓ЁЯЗ╖, роорпМро░ро┐роЯро╛ройро┐ропро╛
ЁЯЗ▓ЁЯЗ╕ => ЁЯЗ▓ЁЯЗ╕, рооро╛рогрпНроЯрпНроЪрпЖро░ро╛роЯрпН
ЁЯЗ▓ЁЯЗ╣ => ЁЯЗ▓ЁЯЗ╣, рооро╛ро▓рпНроЯро╛
ЁЯЗ▓ЁЯЗ║ => ЁЯЗ▓ЁЯЗ║, роорпКро░ро┐роЪро┐ропро╕рпН
ЁЯЗ▓ЁЯЗ╗ => ЁЯЗ▓ЁЯЗ╗, рооро╛ро▓родрпНродрпАро╡рпБ
ЁЯЗ▓ЁЯЗ╝ => ЁЯЗ▓ЁЯЗ╝, рооро▓ро╛ро╡ро┐
ЁЯЗ▓ЁЯЗ╜ => ЁЯЗ▓ЁЯЗ╜, роорпЖроХрпНроЪро┐роХрпЛ
ЁЯЗ▓ЁЯЗ╛ => ЁЯЗ▓ЁЯЗ╛, рооро▓рпЗроЪро┐ропро╛
ЁЯЗ▓ЁЯЗ┐ => ЁЯЗ▓ЁЯЗ┐, роорпКроЪро╛роорпНрокро┐роХрпН
ЁЯЗ│ЁЯЗж => ЁЯЗ│ЁЯЗж, роироорпАрокро┐ропро╛
ЁЯЗ│ЁЯЗи => ЁЯЗ│ЁЯЗи, роиро┐ропрпВ роХрпЗро▓ро┐роЯрпЛройро┐ропро╛
ЁЯЗ│ЁЯЗк => ЁЯЗ│ЁЯЗк, роирпИроЬро░рпН
ЁЯЗ│ЁЯЗл => ЁЯЗ│ЁЯЗл, роиро╛ро░рпНроГрокрпЛроХрпН родрпАро╡рпБроХро│рпН
ЁЯЗ│ЁЯЗм => ЁЯЗ│ЁЯЗм, роирпИроЬрпАро░ро┐ропро╛
ЁЯЗ│ЁЯЗо => ЁЯЗ│ЁЯЗо, роиро┐роХро░роХрпБро╡ро╛
ЁЯЗ│ЁЯЗ▒ => ЁЯЗ│ЁЯЗ▒, роирпЖродро░рпНро▓ро╛роирпНродрпБ
ЁЯЗ│ЁЯЗ┤ => ЁЯЗ│ЁЯЗ┤, роиро╛ро░рпНро╡рпЗ
ЁЯЗ│ЁЯЗ╡ => ЁЯЗ│ЁЯЗ╡, роирпЗрокро╛ро│роорпН
ЁЯЗ│ЁЯЗ╖ => ЁЯЗ│ЁЯЗ╖, роирпМро░рпБ
ЁЯЗ│ЁЯЗ║ => ЁЯЗ│ЁЯЗ║, роиро┐ропрпВ
ЁЯЗ│ЁЯЗ┐ => ЁЯЗ│ЁЯЗ┐, роиро┐ропрпВроЪро┐ро▓ро╛роирпНродрпБ
ЁЯЗ┤ЁЯЗ▓ => ЁЯЗ┤ЁЯЗ▓, роУрооройрпН
ЁЯЗ╡ЁЯЗж => ЁЯЗ╡ЁЯЗж, рокройро╛рооро╛
ЁЯЗ╡ЁЯЗк => ЁЯЗ╡ЁЯЗк, рокрпЖро░рпБ
ЁЯЗ╡ЁЯЗл => ЁЯЗ╡ЁЯЗл, рокро┐ро░рпЖроЮрпНроЪрпБ рокро╛ро▓ро┐ройрпЗро╖ро┐ропро╛
ЁЯЗ╡ЁЯЗм => ЁЯЗ╡ЁЯЗм, рокрокрпНрокрпБро╡ро╛ роиро┐ропрпВ роХро┐ройро┐ропро╛
ЁЯЗ╡ЁЯЗн => ЁЯЗ╡ЁЯЗн, рокро┐ро▓ро┐рокрпНрокрпИройрпНро╕рпН
ЁЯЗ╡ЁЯЗ░ => ЁЯЗ╡ЁЯЗ░, рокро╛роХро┐ро╕рпНродро╛ройрпН
ЁЯЗ╡ЁЯЗ▒ => ЁЯЗ╡ЁЯЗ▒, рокрпЛро▓роирпНродрпБ
ЁЯЗ╡ЁЯЗ▓ => ЁЯЗ╡ЁЯЗ▓, роЪрпЖропро┐ройрпНроЯрпН рокро┐ропро░рпН & рооро┐роХрпНро╡рпЗро▓ро╛ройрпН
ЁЯЗ╡ЁЯЗ│ => ЁЯЗ╡ЁЯЗ│, рокро┐роЯрпНроХрпЖропрпНро░рпНройрпН родрпАро╡рпБроХро│рпН
ЁЯЗ╡ЁЯЗ╖ => ЁЯЗ╡ЁЯЗ╖, рокро┐ропрпВро░рпНроЯрпЛ ро░ро┐роХрпЛ
ЁЯЗ╡ЁЯЗ╕ => ЁЯЗ╡ЁЯЗ╕, рокро╛ро▓ро╕рпНродрпАройро┐роп рокро┐ро░родрпЗроЪроЩрпНроХро│рпН
ЁЯЗ╡ЁЯЗ╣ => ЁЯЗ╡ЁЯЗ╣, рокрпЛро░рпНроЪрпНроЪрпБроХрпНроХро▓рпН
ЁЯЗ╡ЁЯЗ╝ => ЁЯЗ╡ЁЯЗ╝, рокро╛ро▓рпЛ
ЁЯЗ╡ЁЯЗ╛ => ЁЯЗ╡ЁЯЗ╛, рокро░ро╛роХрпБро╡рпЗ
ЁЯЗ╢ЁЯЗж => ЁЯЗ╢ЁЯЗж, роХродрпНродро╛ро░рпН
ЁЯЗ╢ЁЯЗ┤ => ЁЯЗ╢ЁЯЗ┤, ро╡рпЖро│ро┐рокрпНрокрпБро▒ роУро╖ро┐ропро╛ройро┐ропро╛
ЁЯЗ╖ЁЯЗк => ЁЯЗ╖ЁЯЗк, ро░рпАропрпВройро┐ропройрпН
ЁЯЗ╖ЁЯЗ┤ => ЁЯЗ╖ЁЯЗ┤, ро░рпБроорпЗройро┐ропро╛
ЁЯЗ╖ЁЯЗ╕ => ЁЯЗ╖ЁЯЗ╕, роЪрпЖро░рпНрокро┐ропро╛
ЁЯЗ╖ЁЯЗ║ => ЁЯЗ╖ЁЯЗ║, ро░ро╖рпНропро╛
ЁЯЗ╖ЁЯЗ╝ => ЁЯЗ╖ЁЯЗ╝, ро░рпБро╡ро╛рогрпНроЯро╛
ЁЯЗ╕ЁЯЗж => ЁЯЗ╕ЁЯЗж, роЪро╡рпВродро┐ роЕро░рпЗрокро┐ропро╛
ЁЯЗ╕ЁЯЗз => ЁЯЗ╕ЁЯЗз, роЪро╛ро▓рооройрпН родрпАро╡рпБроХро│рпН
ЁЯЗ╕ЁЯЗи => ЁЯЗ╕ЁЯЗи, роЪрпАро╖рпЖро▓рпНро╕рпН
ЁЯЗ╕ЁЯЗй => ЁЯЗ╕ЁЯЗй, роЪрпВроЯро╛ройрпН
ЁЯЗ╕ЁЯЗк => ЁЯЗ╕ЁЯЗк, ро╕рпНро╡рпАроЯройрпН
ЁЯЗ╕ЁЯЗм => ЁЯЗ╕ЁЯЗм, роЪро┐роЩрпНроХрокрпНрокрпВро░рпН
ЁЯЗ╕ЁЯЗн => ЁЯЗ╕ЁЯЗн, роЪрпЖропро┐ройрпНроЯрпН ро╣рпЖро▓рпЖройро╛
ЁЯЗ╕ЁЯЗо => ЁЯЗ╕ЁЯЗо, ро╕рпНро▓рпЛро╡рпЗройро┐ропро╛
ЁЯЗ╕ЁЯЗп => ЁЯЗ╕ЁЯЗп, ро╕рпНро╡ро▓рпНрокро╛ро░рпНроЯрпБ & роЬро╛ройрпН роорпЗропройрпН
ЁЯЗ╕ЁЯЗ░ => ЁЯЗ╕ЁЯЗ░, ро╕рпНро▓рпЛро╡ро╛роХро┐ропро╛
ЁЯЗ╕ЁЯЗ▒ => ЁЯЗ╕ЁЯЗ▒, роЪро┐ропро╛ро░ро╛ ро▓ро┐ропрпЛройрпН
ЁЯЗ╕ЁЯЗ▓ => ЁЯЗ╕ЁЯЗ▓, роЪро╛ройрпН рооро░ро┐ройрпЛ
ЁЯЗ╕ЁЯЗ│ => ЁЯЗ╕ЁЯЗ│, роЪрпЖройрпЖроХро▓рпН
ЁЯЗ╕ЁЯЗ┤ => ЁЯЗ╕ЁЯЗ┤, роЪрпЛрооро╛ро▓ро┐ропро╛
ЁЯЗ╕ЁЯЗ╖ => ЁЯЗ╕ЁЯЗ╖, роЪрпБро░ро┐ройро╛роорпН
ЁЯЗ╕ЁЯЗ╕ => ЁЯЗ╕ЁЯЗ╕, родрпЖро▒рпНроХрпБ роЪрпВроЯро╛ройрпН
ЁЯЗ╕ЁЯЗ╣ => ЁЯЗ╕ЁЯЗ╣, роЪро╛ро╡рпН родрпЛроорпН & рокрпНро░ро┐ройрпНроЪро┐рокро┐
ЁЯЗ╕ЁЯЗ╗ => ЁЯЗ╕ЁЯЗ╗, роОро▓рпН роЪро╛ро▓рпНро╡роЯро╛ро░рпН
ЁЯЗ╕ЁЯЗ╜ => ЁЯЗ╕ЁЯЗ╜, роЪро┐ройрпНроЯрпН рооро╛ро░рпНроЯрпЖройрпН
ЁЯЗ╕ЁЯЗ╛ => ЁЯЗ╕ЁЯЗ╛, роЪро┐ро░ро┐ропро╛
ЁЯЗ╕ЁЯЗ┐ => ЁЯЗ╕ЁЯЗ┐, ро╕рпНро╡ро╛ро╕ро┐ро▓ро╛роирпНродрпБ
ЁЯЗ╣ЁЯЗж => ЁЯЗ╣ЁЯЗж, роЯро┐ро░ро┐ро╕рпНроЯройрпН роЯро╛ роХрпБройрпНро╣ро╛
ЁЯЗ╣ЁЯЗи => ЁЯЗ╣ЁЯЗи, роЯро░рпНроХрпНро╕рпН & роХрпИроХрпЛро╕рпН родрпАро╡рпБроХро│рпН
ЁЯЗ╣ЁЯЗй => ЁЯЗ╣ЁЯЗй, роЪро╛роЯрпН
ЁЯЗ╣ЁЯЗл => ЁЯЗ╣ЁЯЗл, рокро┐ро░рпЖроЮрпНроЪрпБ родрпЖро▒рпНроХрпБ рокро┐ро░родрпЗроЪроЩрпНроХро│рпН
ЁЯЗ╣ЁЯЗм => ЁЯЗ╣ЁЯЗм, роЯрпЛроХрпЛ
ЁЯЗ╣ЁЯЗн => ЁЯЗ╣ЁЯЗн, родро╛ропрпНро▓ро╛роирпНродрпБ
ЁЯЗ╣ЁЯЗп => ЁЯЗ╣ЁЯЗп, родроЬро┐роХро┐ро╕рпНродро╛ройрпН
ЁЯЗ╣ЁЯЗ░ => ЁЯЗ╣ЁЯЗ░, роЯрпЛроХрпЗро▓рпЛ
ЁЯЗ╣ЁЯЗ▒ => ЁЯЗ╣ЁЯЗ▒, родрпИроорпВро░рпН-ро▓рпЖро╕рпНродрпЗ
ЁЯЗ╣ЁЯЗ▓ => ЁЯЗ╣ЁЯЗ▓, родрпБро░рпНроХрпНроорпЖройро┐ро╕рпНродро╛ройрпН
ЁЯЗ╣ЁЯЗ│ => ЁЯЗ╣ЁЯЗ│, роЯрпБройро┐роЪро┐ропро╛
ЁЯЗ╣ЁЯЗ┤ => ЁЯЗ╣ЁЯЗ┤, роЯрпЛроЩрпНроХро╛
ЁЯЗ╣ЁЯЗ╖ => ЁЯЗ╣ЁЯЗ╖, родрпБро░рпБроХрпНроХро┐
ЁЯЗ╣ЁЯЗ╣ => ЁЯЗ╣ЁЯЗ╣, роЯро┐ро░ро┐ройро┐роЯро╛роЯрпН & роЯрпКрокро╛роХрпЛ
ЁЯЗ╣ЁЯЗ╗ => ЁЯЗ╣ЁЯЗ╗, родрпБро╡ро╛ро▓рпВ
ЁЯЗ╣ЁЯЗ╝ => ЁЯЗ╣ЁЯЗ╝, родрпИро╡ро╛ройрпН
ЁЯЗ╣ЁЯЗ┐ => ЁЯЗ╣ЁЯЗ┐, родро╛ройрпНроЪро╛ройро┐ропро╛
ЁЯЗ║ЁЯЗж => ЁЯЗ║ЁЯЗж, роЙроХрпНро░рпИройрпН
ЁЯЗ║ЁЯЗм => ЁЯЗ║ЁЯЗм, роЙроХро╛рогрпНроЯро╛
ЁЯЗ║ЁЯЗ▓ => ЁЯЗ║ЁЯЗ▓, ропрпВ.роОро╕рпН. ро╡рпЖро│ро┐рокрпНрокрпБро▒родрпН родрпАро╡рпБроХро│рпН
ЁЯЗ║ЁЯЗ│ => ЁЯЗ║ЁЯЗ│, роРроХрпНроХро┐роп роиро╛роЯрпБроХро│рпН
ЁЯЗ║ЁЯЗ╕ => ЁЯЗ║ЁЯЗ╕, роЕроорпЖро░ро┐роХрпНроХро╛
ЁЯЗ║ЁЯЗ╛ => ЁЯЗ║ЁЯЗ╛, роЙро░рпБроХрпБро╡рпЗ
ЁЯЗ║ЁЯЗ┐ => ЁЯЗ║ЁЯЗ┐, роЙро╕рпНрокрпЖроХро┐ро╕рпНродро╛ройрпН
ЁЯЗ╗ЁЯЗж => ЁЯЗ╗ЁЯЗж, ро╡ро╛роЯро┐роХройрпН роироХро░роорпН
ЁЯЗ╗ЁЯЗи => ЁЯЗ╗ЁЯЗи, роЪрпЖропро┐ройрпНроЯрпН ро╡ро┐ройрпНроЪрпЖройрпНроЯрпН & роХро┐ро░рпЖройроЯрпИройрпНро╕рпН
ЁЯЗ╗ЁЯЗк => ЁЯЗ╗ЁЯЗк, ро╡рпЖройро┐роЪрпБро▓ро╛
ЁЯЗ╗ЁЯЗм => ЁЯЗ╗ЁЯЗм, рокро┐ро░ро┐роЯрпНроЯрпАро╖рпН роХройрпНройро┐родрпН родрпАро╡рпБроХро│рпН
ЁЯЗ╗ЁЯЗо => ЁЯЗ╗ЁЯЗо, ропрпВ.роОро╕рпН. роХройрпНройро┐родрпН родрпАро╡рпБроХро│рпН
ЁЯЗ╗ЁЯЗ│ => ЁЯЗ╗ЁЯЗ│, ро╡ро┐ропроЯрпНроиро╛роорпН
ЁЯЗ╗ЁЯЗ║ => ЁЯЗ╗ЁЯЗ║, ро╡ройрпБро╡ро╛роЯрпНроЯрпБ
ЁЯЗ╝ЁЯЗл => ЁЯЗ╝ЁЯЗл, ро╡ро╛ро▓ро┐ро╕рпН рооро▒рпНро▒рпБроорпН роГрокрпБроЯрпБройро╛
ЁЯЗ╝ЁЯЗ╕ => ЁЯЗ╝ЁЯЗ╕, роЪроорпЛро╡ро╛
ЁЯЗ╜ЁЯЗ░ => ЁЯЗ╜ЁЯЗ░, роХрпКроЪрпЛро╡рпЛ
ЁЯЗ╛ЁЯЗк => ЁЯЗ╛ЁЯЗк, роПрооройрпН
ЁЯЗ╛ЁЯЗ╣ => ЁЯЗ╛ЁЯЗ╣, рооропрпЛроЯрпН
ЁЯЗ┐ЁЯЗж => ЁЯЗ┐ЁЯЗж, родрпЖройрпН роЖрокрпНрокро┐ро░ро┐роХрпНроХро╛
ЁЯЗ┐ЁЯЗ▓ => ЁЯЗ┐ЁЯЗ▓, роЬро╛роорпНрокро┐ропро╛
ЁЯЗ┐ЁЯЗ╝ => ЁЯЗ┐ЁЯЗ╝, роЬро┐роорпНрокро╛рокрпНро╡рпЗ
ЁЯЗ┐ЁЯЗ┐ => ЁЯЗ┐ЁЯЗ┐, роЕро▒ро┐ропрокрпНрокроЯро╛род рокро┐ро░родрпЗроЪроорпН