ЁЯП╗ => ЁЯП╗, рдХрд╛рддреАрдЪреЛ рд░рдВрдЧ, рдкреНрд░рдХрд╛рд░ 1тАУ2, рд╡рд┐рд░рд│ рдХрд╛рддреАрдЪреЛ рд░рдВрдЧ
ЁЯП╝ => ЁЯП╝, рдХрд╛рддреАрдЪреЛ рд░рдВрдЧ, рдкреНрд░рдХрд╛рд░ 3, рдордзреНрдпрдо-рд╡рд┐рд░рд│ рдХрд╛рддреАрдЪреЛ рд░рдВрдЧ
ЁЯП╜ => ЁЯП╜, рдХрд╛рддреАрдЪреЛ рд░рдВрдЧ, рдкреНрд░рдХрд╛рд░ 4, рдордзреНрдпрдо рдХрд╛рддреАрдЪреЛ рд░рдВрдЧ
ЁЯП╛ => ЁЯП╛, рдХрд╛рддреАрдЪреЛ рд░рдВрдЧ, рдкреНрд░рдХрд╛рд░ 5, рдордзреНрдпрдо-рджрд╛рдЯ рдХрд╛рддреАрдЪреЛ рд░рдВрдЧ
ЁЯП┐ => ЁЯП┐, рдХрд╛рддреАрдЪреЛ рд░рдВрдЧ, рджрд╛рдЯ рдХрд╛рддреАрдЪреЛ рд░рдВрдЧ, рдкреНрд░рдХрд╛рд░ 6
тАа => тАа, рдбреЕрдЧрд░ рдЪрд┐рдиреНрди, рдбреЕрдЧрд░ред рдСрдмреЗрд▓рд┐рд╕реНрдХред рдУрдмрд┐рд▓рд╕
тАб => тАб, рдбрдмрд▓ рдбреЕрдЧрд░ рдЪрд┐рдиреНрди, рдбреЕрдЧрд░ред рдбрдмрд▓ред рдСрдмреЗрд▓рд┐рд╕реНрдХред рдУрдмреЗрд▓рд╕
тАв => тАв, рдмреБрд▓реЗрдЯ, рдмреБрд▓реЗрдЯред рдмрд┐рдВрджреВ
┬░ => ┬░, рдкрджрд╡реА, рдкрджрд╡реАред рд╡рд░ред рдкреБрд░рд╛рд╡реЛ
тДЧ => тДЧ, рдзреНрд╡рдиреА рд░реЕрдХреЙрд░реНрдбреАрдВрдЧ рдорд╛рд▓рдХреАрд╣рдХреНрдХ, рдорд╛рд▓рдХреАрд╣рдХреНрдХред рд░реЕрдХреЙрд░реНрдбреАрдВрдЧред рдзреНрд╡рдиреА
тЖР => тЖР, рджрд╛рд╡реНрдпрд╛рди рдЦреБрдгрд╛рд╡рдкреА рдмрд╛рдг, рдмрд╛рдгред рджрд╛рд╡реНрдпрд╛рдиред рджрд╛рд╡реНрдпрд╛рди рдЦреБрдгрд╛рд╡рдкреА рдмрд╛рдг
тЖТ => тЖТ, рдЙрдЬрд╡реНрдпрд╛рди рдЦреБрдгрд╛рд╡рдкреА рдмрд╛рдг, рдмрд╛рдгред рдЙрдЬрд╡реЗрдВред рдЙрдЬрд╡реНрдпрд╛рди рдЦреБрдгрд╛рд╡рдкреА рдмрд╛рдг
тЖС => тЖС, рдмрд╛рдгред рд╡рдпрд░ред рд╡рдпрд░ рдЦреБрдгрд╛рд╡рдкреА рдмрд╛рдг, рд╡рдпрд░ рдЦреБрдгрд╛рд╡рдкреА рдмрд╛рдг
тЖУ => тЖУ, рдмрд╛рдгред рд╕рдХрдпрд▓ред рд╕рдХрдпрд▓ рдЦреБрдгрд╛рд╡рдкреА рдмрд╛рдг, рд╕рдХрдпрд▓ рдЦреБрдгрд╛рд╡рдкреА рдмрд╛рдг
тЗЕ => тЗЕ, рдмрд╛рдгред рд╕рдХрдпрд▓ред рд╡рдпрд░ред рд╡рдпрд░ рдЦреБрдгрд╛рд╡рдкреА рдЖрдиреА рд╕рдХрдпрд▓ рдЦреБрдгрд╛рд╡рдкреА рдмрд╛рдг, рд╡рдпрд░ рдЦреБрдгрд╛рд╡рдкреА рдЖрдиреА рд╕рдХрдпрд▓ рдЦреБрдгрд╛рд╡рдкреА рдмрд╛рдг
тЗЖ => тЗЖ, рдЙрдЬрд╡реНрдпрд╛рди рдЦреБрдгрд╛рд╡рдкреА рдмрд╛рдгрд╛рдВрдЪреЗрд░ рджрд╛рд╡реНрдпрд╛рди рдЦреБрдгрд╛рд╡рдкреА рдмрд╛рдг, рдмрд╛рдгред рджрд╛рд╡реНрдпрд╛рдиред рдЙрдЬрд╡реНрдпрд╛рди рдЦреБрдгрд╛рд╡рдкреА рдмрд╛рдгрд╛рдВрдЪреЗрд░ рджрд╛рд╡реНрдпрд╛рди рдЦреБрдгрд╛рд╡рдкреА рдмрд╛рдгред рдЙрдЬрд╡реНрдпрд╛рди
тИЖ => тИЖ, рд╡реГрджреНрдзреА, рд╡реГрджреНрдзреАред рддреНрд░рд┐рдХреЛрдг
тИЗ => тИЗ, рдирд╛рдмреНрд▓рд╛, рдирд╛рдмреНрд▓рд╛ ред рддреНрд░рд┐рдХреЛрдг
тИИ => тИИ, рдЖрд╕рдкрд╛рд╡реАрддред рдШрдЯрдХред рдЪреЛ рдШрдЯрдХред рд╡рд╛рдВрдЧрдбреАрдкрджред рд╕рдВрдЪ, рдЪреЛ рдШрдЯрдХ
тБ╗ => тБ╗, рд╡рдЬрд╛ ред рд╕реБрдкрд░рд╕реНрдХреНрд░рд┐рдкреНрдЯ, рд╕реБрдкрд░рд╕реНрдХреНрд░рд┐рдкреНрдЯ рд╡рдЬрд╛
тИЪ => тИЪ, рдореМрд▓реАрдХред рдореВрд│ред рдореВрд│ рд╢рдмреНрджред рд╕рдордХреЛрдгред рд╕реБрд░реНрдж, рд╡рд░реНрдЧрдореВрд│
тИЮ => тИЮ, рдЕрд╕реАрдорддрд╛рдп, рдЕрд╕реАрдорддрд╛рдп рдХреБрд░реВ
тИй => тИй, рдкреНрд░рддрд┐рдЪреНрдЫреЗрджрди, рдкреНрд░рддрд┐рдЪреНрдЫреЗрджрдиред рд╕рдВрдЪ
тИк => тИк, рдПрдХрдард╛рд╡рдгреАред рд╕рдВрдЪред рд╕рдВрдШреАрдп, рд╕рдВрдШреАрдд
тЙб => тЙб, рдЬреБрд╕реНрддрд╛рдЬреБрд╕реНрддред рд╕рдорд░реБрдкреАред рддрд╛рдХрд╛ рд╕рдорд░реБрдкреАред рддрд┐рдЯреНрдЯреА, рд╕рдорд░реБрдкреА
тКВ => тКВ, рдЪреЛ рдЙрдк-рд╕рдВрдЪ, рд╕рдВрдЪред рдЙрдк-рд╕рдВрдЪред рдЪреЛ рдЙрдк-рд╕рдВрдЪ
тЦ▓ => тЦ▓, рдмрд╛рдгред рднрд░рд▓рд╛рдВред рд╡рдпрд░ рдЦреБрдгрд╛рд╡рдкреА рддреНрд░рд┐рдХреЛрдг рднрд░рд▓рд╛рдВред рддреНрд░рд┐рдХреЛрдгред рд╡рдпрд░, рд╡рдпрд░ рдЦреБрдгрд╛рд╡рдкреА рддреНрд░рд┐рдХреЛрдг рднрд░рд▓рд╛рдВ
тЦ╝ => тЦ╝, рдмрд╛рдгред рд╕рдХрдпрд▓ред рднрд░рд┐рд▓реНрд▓реЗрдВред рд╕рдХрдпрд▓ рдЦреБрдгрд╛рд╡рдкреА рддреНрд░рд┐рдХреЛрдг рднрд░рд▓рд╛рдВред рддреНрд░рд┐рдХреЛрдг, рд╕рдХрдпрд▓ рдЦреБрдгрд╛рд╡рдкреА рддреНрд░рд┐рдХреЛрдг рднрд░рд▓рд╛рдВ
тЧК => тЧК, рдбрд╛рдпрдордгреНрдбред рд╕рдордЪрддреБрд░реНрднреБрдЬред рд╡рд┐рд╖рдордХреЛрдг, рд╕рдордЪрддреБрд░реНрднреБрдЬ
тЧЛ => тЧЛ, рдмреБрд░рд╛рдХ рдЖрд╢рд┐рд▓реНрд▓реЗрдВ рд╡рд░реНрддреВрд│, рд╡рд░реНрддреВрд│ред рдмреБрд░рд╛рдХ рдЖрд╢рд┐рд▓реНрд▓реЗрдВ рд╡рд░реНрддреВрд│ред рд░рд┐рдВрдЧ
тЧП => тЧП, рднрд░рд┐рд▓реНрд▓реЗрдВ рддреНрд░рд┐рдХреЛрдг, рд╡рд░реНрддреВрд│ред рднрд░рд┐рд▓реНрд▓реЗрдВ рд╡рд░реНрддреВрд│
тЧп => тЧп, рд╡рд░реНрддреВрд│ред рд╡реНрд╣рдб рдмреБрд░рд╛рдХ рдЖрд╢рд┐рд▓реНрд▓реЗрдВ рд╡рд░реНрддреВрд│ред рд░рд┐рдВрдЧ, рд╡реНрд╣рдб рдмреБрд░рд╛рдХ рдЖрд╢рд┐рд▓реНрд▓реЗрдВ рд╡рд░реНрддреВрд│
ЁЯША => ЁЯША, рдЙрдХрддреНрдпрд╛ рддреЛрдВрдбрд╛рдЪреЛ рд╣рд╛рдВрд╕рдкреА рдЪреЗрд░реЛ, рдЪреЗрд░реЛ, рд╣рд╛рдВрд╕рдк, рд╣рд╛рдВрд╕рдкреА рдЪреЗрд░реЛ
ЁЯШГ => ЁЯШГ, рдЙрдХрддреЗрдВ, рдЪреЗрд░реЛ, рддреЛрдВрдб, рдореЛрдареНрдпрд╛ рджреЛрд│реНрдпрд╛рдВрдЪреЛ рд╣рд╛рдВрд╕рдкреА рдЪреЗрд░реЛ, рд╣рд╛рдВрд╕рдк
ЁЯШД => ЁЯШД, рдЙрдХрддреЗрдВ, рдЪреЗрд░реЛ, рддреЛрдВрдб, рджреЛрд│реЛ, рд╣рд╛рдВрд╕-рдпрд╛ рджреЛрд│реНрдпрд╛рдВрдЪреЛ рд╣рд╛рдВрд╕рдкреА рдЪреЗрд░реЛ, рд╣рд╛рдВрд╕рдк
ЁЯШБ => ЁЯШБ, рдЪреЗрд░реЛ, рджреЛрд│реЛ, рд╣рд╛рдВрд╕-рдпрд╛ рджреЛрд│реНрдпрд╛рдВрдЪреЛ рдЖрдирдВрджреА рдЪреЗрд░реЛ, рд╣рд╛рдВрд╕рдк, рд╣рд╛рдВрд╕рдкреА рджреЛрд│реНрдпрд╛рдВрдЪреЛ рдЖрдирдВрджреА рдЪреЗрд░реЛ, рд╣рд╛рдВрд╕реНрдп
ЁЯШЖ => ЁЯШЖ, рдЪреЗрд░реЛ, рддреЛрдВрдб, рд╕рдорд╛рдзрд╛рдиреА, рд╣рд╛рдВрд╕рдк, рд╣рд╛рдВрд╕рдкреА рддрд┐рд░рд╕реЛ рдЪреЗрд░реЛ, рд╣рд╛рдВрд╕реЛ
ЁЯШЕ => ЁЯШЕ, рдЙрдХрддреЗрдВ, рдШрд╛рдо, рдШрд╛рдо рдЧрд│рдкреА рд╣рд╛рдВрд╕рдкреА рдЪреЗрд░реЛ, рдЪреЗрд░реЛ, рдердВрдб, рд╣рд╛рдВрд╕рдк
ЁЯдг => ЁЯдг, рдЪреЗрд░реЛ, рдЬрдордиреАрд░ рд▓реЛрд│реВрди рд╣рд╛рдВрд╕рдк, рдЬрдореАрди, рд▓реЛрд│рдк, рд╣рд╛рдВрд╕рдк
ЁЯШВ => ЁЯШВ, рдЖрдирдВрдж, рдЖрдирдВрджрд╛рд╢реНрд░реВрдЪреЛ рдЪреЗрд░реЛ, рдЪреЗрд░реЛ, рджреВрдХ, рд╣рд╛рдВрд╕рдк
ЁЯЩВ => ЁЯЩВ, рдЪреЗрд░реЛ, рдорд╛рддреНрд╢реЗрдВ рд╣рд╛рдВрд╕рдкреА рдЪреЗрд░реЛ, рд╣рд╛рдВрд╕рдк
ЁЯЩГ => ЁЯЩГ, рдЪреЗрд░реЛ, рддрдХрд▓реА рд╕рдХрдпрд▓ рдЖрд╕рдкреА рдЪреЗрд░реЛ, рд╕рдХрдпрд▓ рддрдХрд▓реА
ЁЯШЙ => ЁЯШЙ, рдЪреЗрд░реЛ, рджреЛрд│реЗ рдорд┐рдЪрдХрд╛рд╡рдк, рджреЛрд│реЗ рдорд┐рдЪрдХрд╛рд╡рдкреА рдЪреЗрд░реЛ, рдорд┐рдЪрдХрд╛рд╡рдк
ЁЯШК => ЁЯШК, рдЪреЗрд░реЛ, рджреЛрд│реЛ, рд▓рдЬреЗрд╡рдк, рд╣рд╛рдВрд╕-рдпрд╛ рджреЛрд│реНрдпрд╛рдВрдЪреЛ рд╣рд╛рдВрд╕рд░реЛ рдЪреЗрд░реЛ, рд╣рд╛рдВрд╕рдк
ЁЯШЗ => ЁЯШЗ, рдЪреЗрд░реЛ, рдирд╡рд▓рдХрдерд╛, рдирд┐рд╢реНрдкрд╛рдк, рдкрд░реА, рдкреНрд░рднрд╛, рдкреНрд░рднреЗ рд╕рдпрдд рд╣рд╛рдВрд╕рд░реЛ рдЪреЗрд░реЛ
ЁЯе░ => ЁЯе░, рдХрд╛рд│рдЬрд╛рдВ, рдХрд╛рд│рдЬрд╛рдВ рдЖрд╕рдкреА рд╣рд╛рдВрд╕рдкреА рдЪреЗрд░реЛ, рдХрд╛рд│рдЬрд╛рдВ рд╕рдпрдд рд╣рд╛рдВрд╕рдкреА рдЪреЗрд░реЛ, рдЦреВрдм рдореЛрдЧ, рдореЛрдЧрд╛рдВрдд рдЖрд╕рдк, рдореЛрдЧрд╛рдВрдд рдкрдбрдк
ЁЯШН => ЁЯШН, рдХрд╛рд│рдЬрд╛рдВ-рджреЛрд│реНрдпрд╛рдВрдЪреЛ рд╣рд╛рдВрд╕рдкреА рдЪреЗрд░реЛ, рдХрд╛рд│рдЬрд╛рдВрдЪреНрдпрд╛ рджреЛрд│реНрдпрд╛рдЪреЛ рд╣рд╛рдВрд╕рдкреА рдЪреЗрд░реЛ, рдЪреЗрд░реЛ, рджреЛрд│реЛ, рдореЛрдЧ, рд╣рд╛рд╕реНрдп
ЁЯдй => ЁЯдй, рдЪреЗрд░реЛ, рджреЛрд│реЗ, рдирдЦреЗрддреНрд░, рдирдЦреЗрддреНрд░рд╛рдВрдЪреА рдирдЬрд░, рд╣рд╛рд╕реНрдп
ЁЯШШ => ЁЯШШ, рдЙрдореЛ, рдЙрдореЛ рджрд┐рд╡рдкреА рдЪреЗрд░реЛ, рдХрд╛рд│рдЬрд╛рдВ рдЖрд╕рдкреА рдЙрдореЛ рджрд┐рд╡рдкреА рдЪреЗрд░реЛ, рдЪреЗрд░реЛ
ЁЯШЧ => ЁЯШЧ, рдЙрдореЛ, рдЙрдореЛ рджрд┐рд╡рдкреА рдЪреЗрд░реЛ, рдЪреЗрд░реЛ
тШ║ => тШ║, рдЖрд╛рд░рд╛рдорд╢реАрд░, рдЪреЗрд░реЛ, рд░реВрдкрд░реЗрдЦрд╛, рд╣рд╛рдВрд╕рдкреА рдЪреЗрд░реЛ, рд╣рд╛рд╕реНрдп
ЁЯШЪ => ЁЯШЪ, рдЙрдореЛ, рдЪреЗрд░реЛ, рджреЛрд│реЗ рдзрд╛рдВрдкреВрди рдЙрдореЛ рджрд┐рд╡рдкреА рдЪреЗрд░реЛ, рджреЛрд│реЗрдВ рдзрд╛рдВрдкреВрди рдЙрдореЛ рджрд┐рд╡рдкреА рдЪреЗрд░реЛ, рджреЛрд│реЛ, рдзрд╛рдВрдкрд┐рд▓реНрд▓реЛ
ЁЯШЩ => ЁЯШЩ, рдЙрдореЛ, рдЪреЗрд░реЛ, рджреЛрд│реЛ, рд╣рд╛рдВрд╕рдкреА рджреЛрд│реНрдпрд╛рдВрдЪреЛ рдЙрдореЛ рджрд┐рд╡рдкреА рдЪреЗрд░реЛ, рд╣рд╛рд╕реНрдп
ЁЯе▓ => ЁЯе▓, рдЖрднрд╛рд░реА, рдЧрд░реНрд╡, рджреБрдХрд╛рдВ рдЧрд│рдкреА рд╣рд╛рдВрд╕рдкреА рдЪреЗрд░реЛ, рджреВрдХ, рдордирд╛рдХ рд╕реНрдкрд░реНрд╢ рдХрд░рдкреА, рд╣рд╛рдВрд╕рдкреА, рд╣реБрд╕реНрдХреНрдпрд╛рдореЗрдХрд│реЛ
ЁЯШЛ => ЁЯШЛ, рдЕрдиреНрдирд╛рдЪреЛ рд╕реНрд╡рд╛рдж рдШреЗрд╡рдкреА рдЪреЗрд░реЛ, рдЪреЗрд░реЛ, рд░реБрдЪрдХрд░, рд░реБрдЪреНрдЪреАрдХ, рд╕реНрд╡рд╛рдж рдШреЗрд╡рдкреА, рд╣рд╛рдВрд╕рдкреА
ЁЯШЫ => ЁЯШЫ, рдЬреАрдм рднрд╛рдпрд░ рдХрд╛рдбрд┐рд▓реНрд▓реЗрдВ рдореБрдЦрд╛рдорд│, рдореБрдЦрд╛рдорд│ред рдЬреАрдм рднрд╛рдпрд░ рдХрд╛рдбрд┐рд▓реНрд▓реЗрдВ рдореБрдЦрд╛рдорд│ред рдЬреАрдм
ЁЯШЬ => ЁЯШЬ, рдЪреЗрд░реЛ, рдЬреАрдм рднрд╛рдпрд░ рдХрд╛рдбреВрди, рджреЛрд│реЛ рдорд┐рдЪрдХрд╛рд╡рдкреА рдореБрдЦрд╛рдорд│, рдЬреАрдн, рдЬреАрдн рднрд╛рдпрд░ рдХрд╛рдбрд┐рд▓реНрд▓реЛ рджреЛрд│реЗ рдорд┐рдЪрдХрд╛рд╡рдкреА рдЪреЗрд░реЛ, рдЬреАрдн рднрд╛рдпрд░ рдХрд╛рдбрд┐рд▓реНрд▓реЛ рджреЛрд│реЗ рдорд┐рдЪрд╛рдХрд╡рдкреА рдЪреЗрд░реЛ, рджреЛрд│реЗ, рджреЛрд│реЗ рдорд┐рдЪрдХрд╛рд╡рдк, рд╡рд┐рдиреЛрдж
ЁЯдк => ЁЯдк, рджреЛрд│реЛ, рдорд╕реНрдХрд░реЛ рдЪреЗрд░реЛ, рдореБрдореБрд░реНрдХреЛ рд╣рд╛рдВрд╕реЛ рдЖрд╢рд┐рд▓реНрд▓реЗрдВ рдореБрдЦрд╛рдорд│, рдореВрд░реНрдЦ, рд▓реНрд╣рд╛рди, рд╡реНрд╣рдб
ЁЯШЭ => ЁЯШЭ, рдЪреЗрд░реЛ, рдЬреАрдн, рдЬреАрдн рднрд╛рдпрд░ рдХрд╛рдбрдкреА рддрд┐рд░рд╕реЛ рдЪреЗрд░реЛ, рдЬреАрдн рднрд╛рдпрд░ рдХрд╛рдбрд┐рд▓реНрд▓реЛ рддрд┐рд░рд╕реЛ рдЪреЗрд░реЛ, рджреЛрд│реЛ, рднрд┐рд░рд╛рдВрдХреБрд│, рд░реБрдЪреА
ЁЯдС => ЁЯдС, рдЪреЗрд░реЛ, рддреЛрдВрдб, рдкрдпрд╢реЗ, рдкрдпрд╢реЗ  рддреЛрдВрдб рдЪреЗрд░реЛ, рдкрдпрд╢реЗ-рддреЛрдВрдб рдЖрд╕рдкреА рдЪреЗрд░реЛ
ЁЯдЧ => ЁЯдЧ, рдЪреЗрд░реЛ, рд╡реЗрдВрдЧ, рд╡реЗрдВрдЧ рдорд╛рд░рдкреА, рд╡реЗрдВрдЧ рдорд╛рд░рдкреА рдЪреЗрд░реЛ
ЁЯдн => ЁЯдн, рддреЛрдВрдбрд╛рд░ рд╣рд╛рдд рджрд╡рд░рд┐рд▓реНрд▓реЛ рдЪреЗрд░реЛ, рд╢реА
ЁЯдл => ЁЯдл, рдУрдЧреНрдЧреА, рдУрдЧреНрдЧреА рд░рд╛рд╡реВрдВрдХ рд╕рд╛рдВрдЧрдкреА рдЪреЗрд░реЛ, рдЪреВрдк рдХрд░рдкреА рдЪреЗрд░реЛ, рдердВрдб
ЁЯдФ => ЁЯдФ, рдЪреЗрд░реЛ, рд╡рд┐рдЪрд╛рд░ рдХрд░рддрд╛, рд╡рд┐рдЪрд╛рд░реА рдЪреЗрд░реЛ
ЁЯдР => ЁЯдР, рдЪреЗрд░реЛ, рдЭрд┐рдкрд░, рдЭрд┐рдкрд░-рддреЛрдВрдб рдЪреЗрд░реЛ, рддреЛрдВрдб
ЁЯди => ЁЯди, рдЕрд╡рд┐рд╕реНрд╡рд╛рд╕, рдЙрдЦрд▓рд┐рд▓реНрд▓реНрдпрд╛ рднреЛрдВрд╡рдпрд╛рдВрдЪреЛ рдЪреЗрд░реЛ, рдЙрдВрдЪрд╛рдпрд┐рд▓реНрд▓реНрдпрд╛ рднреЛрдВрд╡рдпрд╛рдВрдЪреЛ рдЪреЗрд░реЛ, рд╕рдВрд╢рдпреА
ЁЯШР => ЁЯШР, рдЪреЗрд░реЛ, рддрдЯрд╕реНрде, рдирд┐рд░реНрд╡рд┐рдХрд╛рд░, рдореЗрд╣
ЁЯШС => ЁЯШС, рдЪреЗрд░реЛ, рдореЗрд╣, рд╣рд╛рд╡рднрд╛рд╡ рдирд╛рд╕рдкреА, рд╣рд╛рд╡рднрд╛рд╡ рдирд╛рд╕рдкреА рдЪреЗрд░реЛ, рд╣рд╛рдВрд╡рднрд╛рд╡рдирд╛рдд, рд╣рд╛рд╡рднрд╛рд╡рд╡рд┐рд░рдпрдд
ЁЯШ╢ => ЁЯШ╢, рдУрдЧреНрдЧреА, рдЪреЗрд░реЛ, рддреЛрдВрдб, рддреЛрдВрдбрд╛ рд╢рд┐рд╡рд╛рдп рдЪреЗрд░реЛ, рддреЛрдВрдбрд╛рд╢рд┐рд╡рд╛рдп рдЪреЗрд░реЛ, рдердВрдб
ЁЯШП => ЁЯШП, рдЪреЗрд░реЛ, рдореБрд░рдореБрд░рдЦреНрдпрд╛рдВрдиреА, рдореБрд░рдореБрд░рдЦреНрдпрд╛рдВрдиреА рд╣рд╛рд╕рдкреА рдЪреЗрд░реЛ, рдореБрд░рдореБрд░рдЦреНрдпрд╛рдВрдиреА рд╣рд╛рдВрд╕рдкреА рдЪреЗрд░реЛ
ЁЯШТ => ЁЯШТ, рдЪреЗрд░реЛ, рджреБрдЦреНрдЦреА, рдирд┐рд░рд╕
ЁЯЩД => ЁЯЩД, рдШреБрдВрд╡рдкреА, рдШреБрдВрд╡рдкреА рджреЛрд│реЛ, рдШреБрдВрд╡рдкреА рджреЛрд│реНрдпрд╛рдВрдЪреЛ рдЪреЗрд░реЛ, рдЪреЗрд░реЛ, рджреЛрд│реЗ
ЁЯШм => ЁЯШм, рдЦрд┐рдиреНрди рддреЛрдВрдб, рдЦрд┐рдиреНрдирддрд╛рдп, рдЪреЗрд░реЛ
ЁЯде => ЁЯде, рдЪреЗрд░реЛ, рдкрд┐рдиреЛрдЪрд┐рдпреЛ, рдлрдЯ, рдлрдЯрдХрд┐рд░реЛ рдЪреЗрд░реЛ
ЁЯШМ => ЁЯШМ, рдЪреЗрд░реЛ, рд╣реБрд╕реНрдХреНрдпрд╛рдореЗрдХрд│реЛ
ЁЯШФ => ЁЯШФ, рдЙрджрд╛рд╕, рдЪреЗрд░реЛ, рд╣рддрд╛рд╢ рдЬрд╛рд▓реНрд▓реЛ
ЁЯШк => ЁЯШк, рдЪреЗрд░реЛ, рдиреНрд╣рд┐рджрдкреА рдЪреЗрд░реЛ, рдиреНрд╣реАрдж, рдиреНрд╣реАрджрдкреА рдЪреЗрд░реЛ
ЁЯдд => ЁЯдд, рдЪреЗрд░реЛ, рд▓рд╛рд│ рдЧрд│реЛрд╡рдкреА, рд▓рд╛рд│ рдЧрд│реЛрд╡рдкреА рдЪреЗрд░реЛ
ЁЯШ┤ => ЁЯШ┤, рдиреНрд╣рд┐рджрдкреА zzz рдЪреЗрд░реЛ, рдореБрдЦрд╛рдорд│ред рдиреНрд╣реАрджред рдЬреЗрдорд┐рд▓реНрд▓реЗрдВ рдореБрдЦрд╛рдорд│ред zzz
ЁЯШ╖ => ЁЯШ╖, рдЪреЗрд░реЛ, рдердВрдб, рджреБрдпреЗрдВрдд, рджреЛрддреЛрд░, рдорд╛рд╕реНрдХ, рд╡реИрджреНрдпрдХреАрдп рдорд╛рд╕реНрдХ рдШрд╛рд▓реНрд▓реЛ рдЪреЗрд░реЛ
ЁЯдТ => ЁЯдТ, рдЪреЗрд░реЛ, рдерд░реНрдореЛрдореАрдЯрд░, рдерд░реНрдореЛрдореАрдЯрд░ рдЖрд╕рдкреА рдЪреЗрд░реЛ, рдерд░реНрдореЛрдореАрдЯрд░ рддреЛрдВрдбрд╛рди рдЖрд╕рдкреА рдЪреЗрд░реЛ, рджреБрдпреЗрдВрдд, рджреБрдпреЗрдВрд╕
ЁЯдХ => ЁЯдХ, рдЪреЗрд░реЛ, рддрдХрд▓реЗрдХ рдмрдБрдбреЗрдЬ рдХреЗрд▓реНрд▓реЛ рдЪреЗрд░реЛ, рджреБрдЦрд╛рдкрдд, рджреВрдЦ, рдмрдБрдбреЗрдЬ
ЁЯдв => ЁЯдв, рдУрдВрдХрд╛рд░реА, рдЪреЗрд░реЛ, рдорд│рдорд│рдкреА
ЁЯдо => ЁЯдо, рдУрдВрдХрд╛рд░реА, рдУрдВрдХрд╛рд░реЛ рдпреЗрд╡рдкреА рдЪреЗрд░реЛ, рджреБрдпреЗрдВрдд
ЁЯдз => ЁЯдз, рдЪреЗрд░реЛ, рджреЗрд╡ рднреЛрдЧрд╕реВрдВ, рд╢рд┐рдВрдХрддрд╛, рд╢рд┐рдВрдХрдкреА рдЪреЗрд░реЛ
ЁЯе╡ => ЁЯе╡, рдЙрд╖реНрдг, рдЙрд╖реНрдг рдЪреЗрд░реЛ, рдЙрд╖реНрдгрддреЗрдЪреЛ рдЖрдШрд╛рдд, рдШрд╛рдо рдпреЗрддрд╛, рдЬреЛрд░ рдЖрдпрд┐рд▓реНрд▓реЛ, рддрд╛рдВрдмрдбреЛ рдЬрд╛рд▓реНрд▓реЛ рдЪреЗрд░реЛ
ЁЯе╢ => ЁЯе╢, рдердВрдб, рдердВрдб рдЪреЗрд░реЛ, рдирд┐рд│реЛ-рдЪреЗрд░реЛ, рдмрд░реНрдл рдЬрд╛рд╡рдк, рд╣рд┐рдордмрд╛рдзрд╛
ЁЯе┤ => ЁЯе┤, рдШреБрдВрд╡рдкреА рджреЛрд│реЗ, рдШреБрдВрд╡рд│ рдпреЗрд╡рдкреА рдЪреЗрд░реЛ, рдШреБрдВрд╡рд│ рдпреЗрд╡рдкреА рджреЛрд│реЗ, рдЪрдХреНрдХрд░ рдпреЗрд╡рдкреА, рддрд░рдВрдЧрдкреА рддреЛрдВрдб, рд╕реЛрд░реЛ, рд╕реЛрд░реЛ рдкрд┐рдпреЗрд▓реНрд▓реЛ
ЁЯШ╡ => ЁЯШ╡, рдШреБрдВрд╡рдкреА, рдШреБрдВрдВрд╡рдкреА рдЪреЗрд░реЛ, рдЪреЗрд░реЛ
ЁЯдп => ЁЯдп, рдЖрдШрд╛рдд рдЬрд╛рд╡рдк, рдлреБрдЯрдкреА рддрдХрд▓реА
ЁЯда => ЁЯда, рдХрд╛рд╡рдЧрд░реНрд▓, рдХрд╛рд╡рдмреЙрдп, рдХрд╛рд╡рдмреЙрдп рд╣реЕрдЯ рдШрд╛рд▓реНрд▓реЛ рдЪреЗрд░реЛ, рдЪреЗрд░реЛ, рд╣реЕрдЯ
ЁЯе│ => ЁЯе│, рдкрд╛рд░реНрдЯреА, рдкрд╛рд░реНрдЯреА рдХрд░рдкреА рдЪреЗрд░реЛ, рд╕реБрд╡рд╛рд│реЛ, рд╣реЕрдЯ, рд╣реЙрд░реНрди
ЁЯе╕ => ЁЯе╕, рдЧреБрдкреАрдд, рдЧреНрд▓рд╛рд╕, рдЪреЗрд░реЛ, рдирд╛рдХ, рд╡реЗрд╢рд╛рдВрддрд░, рд╡реЗрд╢рд╛рдВрддрд░ рдХреЗрд▓реНрд▓реЛ рдЪреЗрд░реЛ
ЁЯШО => ЁЯШО, рдЙрдЬрд│, рдЪреЗрд░реЛ, рдердВрдб, рд╕рдирдЧреНрд▓рд╛рд╕, рд╕рдирдЧреНрд▓рд╛рд╕ рдШрд╛рд▓реНрд▓реЛ рд╣рд╛рдВрд╕рдкреА рдЪреЗрд░реЛ, рд╕реБрд░реНрдп
ЁЯдУ => ЁЯдУ, рдЙрддреНрд╕рд╛рд╣реАрдд, рдЪреЗрд░реЛ, рдорд┐рд╢реНрдХреАрд▓
ЁЯзР => ЁЯзР, рдореЛрдиреЛрдХрд▓ рдШрд╛рд▓реНрд▓реЛ рдЪреЗрд░реЛ, рд░рд╛рдЧрд┐рд╖реНрдЯ
ЁЯШХ => ЁЯШХ, рдЧреЛрдВрджрд│рд┐рд▓реНрд▓реЛ, рдЪреЗрд░реЛ, рдореЗрд╣
ЁЯШЯ => ЁЯШЯ, рдЪреЗрд░реЛ, рд╣реБрд╕реНрдХреЛ рдХрд░рдкреА, рд╣реБрд╕реНрдХреЛ рд▓рд╛рдЧрд┐рд▓реНрд▓реЛ рдЪреЗрд░реЛ
ЁЯЩБ => ЁЯЩБ, рдЪреЗрд░реЛ, рддрд┐рдбрдХ, рдорд╛рддреНрд╕реЛ рддрд┐рдбрдХрд▓реНрд▓реЛ рдЪреЗрд░реЛ
тШ╣ => тШ╣, рдЪреЗрд░реЛ, рддрд┐рдбрдХ, рддрд┐рдбрдХрд▓реНрд▓реЛ рдЪреЗрд░реЛ
ЁЯШо => ЁЯШо, рдЙрдХрддреЗрдВ, рдЙрдХрддреНрдпрд╛ рддреЛрдВрдбрд╛рдЪреЛ рдЪреЗрд░реЛ, рдЪреЗрд░реЛ, рддреЛрдВрдб, рджрдпрд╛
ЁЯШп => ЁЯШп, рдЕрдЬрд╛рдкреАрдд, рдЖрд╢реНрдЪрд░реНрдпрдЪрдХреАрдд, рдЪреЗрд░реЛ, рд╢рд╛рдВрдд рдЬрд╛рд▓реНрд▓реЛ, рд╢рд╛рдВрдд рдЬрд╛рд▓реНрд▓реЛ рдЪреЗрд░реЛ
ЁЯШ▓ => ЁЯШ▓, рдПрдХреВрдг, рдЪреЗрд░реЛ, рдердХреНрдХ, рд╡рд┐рд╕реНрдореАрдд
ЁЯШ│ => ЁЯШ│, рдЧреБрдВрдЧ, рдЪреЗрд░реЛ, рд▓рдЬреЗрд▓реНрд▓реЛ
ЁЯе║ => ЁЯе║, рджрдпрд╛ рдорд╛рдЧрдкреА, рдпрд╛рдЪрдирд╛ рдХрд░рдкреА, рд╡рд┐рдирдВрддреА рдХрд░рдкреА рдЪреЗрд░реЛ, рд╕рд╛рд╡ рджреЛрд│реЗ
ЁЯШж => ЁЯШж, рдЙрдХрддреЗрдВ, рдЙрдХрддреНрдпрд╛ рддреЛрдВрдбрд╛рдЪреЛ рддрд┐рдбрдХрд▓реНрд▓реЛ рдЪреЗрд░реЛ, рдЪреЗрд░реЛ, рддрд┐рдбрдХ, рддреЛрдВрдб
ЁЯШз => ЁЯШз, рдЪреЗрд░реЛ, рд╡реНрдпрдереАрдд
ЁЯШи => ЁЯШи, рдХрд╛рдЪрд╡реЗрд▓реНрд▓реЛ, рдЪреЗрд░реЛ, рднрдВрдп, рднрд┐рд▓реНрд▓реЛ
ЁЯШ░ => ЁЯШ░, рдШрд╛рдо, рдШрд╛рдо рджреЗрдВрд╡рдкреА рдЪрд┐рдВрддреЗрд╕реНрдд рдЪреЗрд░реЛ, рдЪреЗрд░реЛ, рдердВрдб, рдзрд╛рдВрд╡рдк
ЁЯШе => ЁЯШе, рдЪреЗрд░реЛ, рджреБрдЦреЗрд╕реНрдд рдкреВрдг рд╣реБрд╕реНрдХреНрдпрд╛рдореЗрдХрд│реЛ рдЪреЗрд░реЛ, рдирд┐рд░рд╢реЗрд▓реНрд▓реЛ, рдирд┐рд░рд╛рд╢, рд╣реБрд╕рдХреНрдпрд╛рдореЗрдХрд│реЛ рдкреВрдг рджреБрдЦреНрдЦреА рдЪреЗрд░реЛ, рд╣реБрд╕реНрдХреНрдпрд╛ рдореЗрдХрд│реЗрдВ
ЁЯШв => ЁЯШв, рдЪреЗрд░реЛ, рджреБрдЦреНрдЦреА, рджреВрдХ, рд░рдбрдк, рд░рдбрдкреА рдЪреЗрд░реЛ
ЁЯШн => ЁЯШн, рдЪреЗрд░реЛ, рджреБрдЦреНрдЦреА, рджреВрдХ, рд░рдбрдк, рд╡реНрд╣рдбрд▓реНрдпрд╛рди рд░рдбрдкреА рдЪреЗрд░реЛ, рд╣реБрдбрдХреЗрд╡рдк
ЁЯШ▒ => ЁЯШ▒, рдХрд╛рдЪрд╛рдмреВрд▓, рдЪреЗрд░реЛ, рднрдВрдп, рднрд┐рдпреЗрд▓реНрд▓реЛ, рднрд┐рд╡рдкреА
ЁЯШЦ => ЁЯШЦ, рдЧрдбрдмрдбрд┐рд▓реНрд▓реЛ, рдЪреЗрд░реЛ
ЁЯШг => ЁЯШг, рдЦрдВрдмреАрд░, рдЪреЗрд░реЛ
ЁЯШЮ => ЁЯШЮ, рдЪреЗрд░реЛ, рдирд┐рд░рд╛рд╢ рдЬрд╛рд▓реНрд▓реЛ рдЪреЗрд░реЛ, рдирд┐рд░рд╛рд╢рд╛ рдЬрд╛рд▓реНрд▓реЛ
ЁЯШУ => ЁЯШУ, рдШрд╛рдо, рдШрд╛рдо рджреЗрдВрд╡рдкреА рдкрдбрд┐рд▓реНрд▓реЛ рдЪреЗрд░реЛ, рдЪреЗрд░реЛ, рдердВрдб
ЁЯШй => ЁЯШй, рдЪреЗрд░реЛ, рддреНрд░рд╕реНрдд, рдкреБрд░реЛ рдЬрд╛рд▓реНрд▓реЗрдВ
ЁЯШл => ЁЯШл, рдЪреЗрд░реЛ, рдкреБрд░реЛ рдЬрд╛рд▓реНрд▓реЛ, рдкреБрд░реЛ рдЬрд╛рд▓реНрд▓реЛ рдЪреЗрд░реЛ
ЁЯе▒ => ЁЯе▒, рдЬрд╛рдВрднрдп, рдЬрд╛рдВрднрдп рджрд┐рд╡рдкреА рдЪреЗрд░реЛ, рдкреБрд░реЛ рдЬрд╛рд▓реНрд▓реЛ, рд╡рд╛рдЬреЗрд▓реНрд▓реЛ
ЁЯШд => ЁЯШд, рдЪреЗрд░реЛ, рдЬрд┐рдЦрдк, рдирд╛рдХрд╛рддрд▓реНрдпрд╛рди рд╡рд╛рдл рдпреЗрд╡рдкреА рдЪреЗрд░реЛ, рд╡рд┐рдЬрдп
ЁЯШб => ЁЯШб, рдЪреЗрд░реЛ, рддрд╛рдВрдмрдбреЛ, рдкрд╛рд╡рдЯ рдХрд░рдкреА, рдкрд╛рд╡рдЯ рдХрд░рдкреА рдЪреЗрд░реЛ, рдкрд┐рд╕реЛ, рд░рд╛рдЧ
ЁЯШа => ЁЯШа, рдЪреЗрд░реЛ, рдкрд┐рд╕реЛ, рд░рд╛рдЧ, рд░рд╛рдЧрд╛рд░ рдЪреЗрд░реЛ
ЁЯдм => ЁЯдм, рддреЛрдВрдбрд╛рд░ рдЪрд┐рдиреНрдирд╛рдВ рдЖрд╕рдкреА рдЪреЗрд░реЛ, рд╕реЛрдкреВрдд рдШреЗрд╡рдкреА
ЁЯШИ => ЁЯШИ, рдЪреЗрд░реЛ, рдирд╡рд▓рдХрдерд╛, рдкрд░рд┐ рдХрдерд╛, рд╢рд┐рдВрдЧрд╛рдВ, рд╢рд┐рдВрдЧрд╛рдВ рдЖрд╕рдкреА рд╣рд╛рдВрд╕рдкреА рдЪреЗрд░реЛ, рд╣рд╛рд╕реНрдп, рд╣реЙрд░реНрди рдЖрд╕рдкреА рд╣рд╛рдВрд╕рдкреА рдЪреЗрд░реЛ
ЁЯС┐ => ЁЯС┐, рдЪреЗрд░реЛ, рдирд╡рд▓рдХрдерд╛, рдореНрд╣рддреНрд╡, рд░рд╛рдХреЗрд╕, рд░рд╛рдХреНрд╖рд╕, рд╢рд┐рдВрдЧрд╛ рдЖрд╕рдкреА рд░рд╛рдЧрд╛рд░ рдЪреЗрд░реЛ, рд╢рд┐рдВрдЧрд╛рдВ рдЖрд╕рдкреА рд░рд╛рдЧрд╛рд░ рдЪреЗрд░реЛ
ЁЯТА => ЁЯТА, рдХрд╡рдЯреА, рдЪреЗрд░реЛ, рдкрд░рд┐рдХрдерд╛, рдорд░рдг, рд░рд╛рдХреНрд╖рд╕
тШа => тШа, рдХрд╡рдЯреА, рдХрд╡рдЯреА рдЖрдиреА рдЧреБрдгрд╛рдХрд╛рд░рд╛рди рджрд╡рд░рд┐рд▓реНрд▓реАрдВ рд╣рд╛рдбрд╛рдВ, рдЧреБрдгрд╛рдХрд╛рд░рд╛рди рджрд╡рд░рд┐рд▓реНрд▓реАрдВ рд╣рд╛рдбрд╛рдВ, рдЪреЗрд░реЛ, рдорд░рдг, рд░рд╛рдХреНрд╖рд╕
ЁЯТй => ЁЯТй, рдЧреБ, рдЧреБрд╡рд╛рдЪреА рд░рд╛рд╕, рдЧреВ, рдЪреЗрд░реЛ, рд░рд╛рдХреЗрд╕, рд╢реЗрдг
ЁЯдб => ЁЯдб, рдЪреЗрд░реЛ, рд╡рд┐рджреВрд╖рдХ
ЁЯС╣ => ЁЯС╣, рдЪреЗрд░реЛ, рдкрд░реА рдХрдерд╛, рдкреНрд░рд╛рдгреА, рд░рд╛рдХреЗрд╕, рд░рд╛рдХреНрд╖рд╕, рд▓рд╣рд░
ЁЯС║ => ЁЯС║, рдЪреЗрд░реЛ, рддрд╛рдВрдмрдбреЗрдВ рдкрд┐рд╢рд╛рдЪреНрдЪ, рдкрд░реА рдХрдерд╛, рдкрд┐рд╢рд╛рдЪреНрдЪ, рдкреНрд░рд╛рдгреА, рд░рд╛рдХреНрд╖рд╕, рд▓рд╣рд░
ЁЯС╗ => ЁЯС╗, рдЪреЗрд░реЛ, рдкрд░реА рдХрдерд╛, рдкреНрд░рд╛рдгреА, рднреВрдд, рд░рд╛рдХреНрд╖рд╕, рд▓рд╣рд░
ЁЯС╜ => ЁЯС╜, рдЪреЗрд░реЛ, рджреБрд╕рд░реЗ рдЬрдЧрд╛рддрд▓реЛ, рдкрд░рдЧреНрд░рд╣реА, рдкреНрд░рд╛рдгреА, рдпреБрдлреЛ, рд▓рд╣рд░
ЁЯС╛ => ЁЯС╛, рдЪреЗрд░реЛ, рджрд╕рд░реЗ рдЬрдЧрд╛рддрд▓реЛ, рдкрд░рдЧреНрд░рд╣реА, рдкреНрд░рд╛рдгреА, рдпреБрдлреЛ, рд░рд╛рдХреНрд╖рд╕
ЁЯдЦ => ЁЯдЦ, рдЪреЗрд░реЛ, рд░рд╛рдХреНрд╖рд╕, рд░реЛрдмреЛрдЯ
ЁЯШ║ => ЁЯШ║, рдЙрдХрддреЗрдВ, рдЪреЗрд░реЛ, рддреЛрдВрдб, рдорд╛рдЬрд░, рд╣рд╛рд╕рдкреА, рд╣рд╛рдВрд╕рдкреА рдорд╛рдЬрд░, рд╣рд╛рд╕реНрдп
ЁЯШ╕ => ЁЯШ╕, рдЪреЗрд░реЛ, рджреЛрд│реЛ, рдорд╛рдЬрд░, рд╣рд╛рд╕-рдпрд╛ рджреЛрд│реНрдпрд╛рдВрдЪреЗрдВ рд╣рд╛рдВрд╕рдкреА рдорд╛рдЬрд░, рд╣рд╛рдВрд╕-рдпрд╛ рджреЛрд│реНрдпрд╛рдВрд╕рдпрдд рд╣рд╛рд╕рдкреА рдорд╛рдЬрд░, рд╣рд╛рд╕реНрдп
ЁЯШ╣ => ЁЯШ╣, рдЖрдирдВрдж, рдЦреЛрд╢рдпреЗрдЪреАрдВ рджреБрдХрд╛рдВ рд╡реНрд╣рд╛рдВрд╡рдкреА рдорд╛рдЬрд░, рдЪреЗрд░реЛ, рджреВрдХ, рдорд╛рдЬрд░
ЁЯШ╗ => ЁЯШ╗, рдХрд╛рд│реАрдЬ, рдХрд╛рд│реАрдЬ-рджреЛрд│реЗ рдЖрд╕рдкреА рд╣рд╛рд╕рдкреА рдорд╛рдЬрд░, рджреЛрд│реЗ, рдорд╛рдЬрд░, рдореБрдЦрд╛рдорд│, рдореЛрдЧ, рдореЛрд╡рд╛рд│ рджреЛрд│реНрдпрд╛рдВрдЪреЗрдВ рд╣рд╛рдВрд╕рддреЗрдВ рдорд╛рдЬрд░, рд╣рд╛рдВрд╕реЛ
ЁЯШ╝ => ЁЯШ╝, рдЙрдкрд░реЛрдзрд┐рдХ, рдЪреЗрд░реЛ, рддрд┐рд░рдкреА, рддрд┐рд░рдкреЗрдВ рд╣рд╛рд╕реНрдп рдЖрд╢рд┐рд▓реНрд▓реЗрдВ рдорд╛рдЬрд░, рддрд┐рд░рдкреЗрдВ рд╣рд╛рд╕реНрдп рдЖрд╕рдкреА рдорд╛рдЬрд░, рдорд╛рдЬрд░, рд╣рд╛рд╕реНрдп
ЁЯШ╜ => ЁЯШ╜, рдЙрдореЛ, рдЙрдореЛ рджрд┐рд╡рдкреА рдорд╛рдЬрд░, рдЪреЗрд░реЛ, рджреЛрд│реЛ, рдорд╛рдЬрд░
ЁЯЩА => ЁЯЩА, рдЖрд╢реНрдЪрд░реНрдп, рдУрд╣, рдЪреЗрд░реЛ, рдорд╛рдЬрд░, рд╕рддрдпрд┐рд▓реНрд▓реЗрдВ
ЁЯШ┐ => ЁЯШ┐, рдЪреЗрд░реЛ, рджреБрдЦреЗрд╕реНрдд, рджреВрдХ, рдорд╛рдЬрд░, рд░рдбрдк, рд░рдбрдкреА рдорд╛рдЬрд░
ЁЯШ╛ => ЁЯШ╛, рдЪреЗрд░реЛ, рдкрд╛рд╡рдЯ рдХрд░рдк, рдкрд╛рд╡рдЯ рдХрд░рдкреА рдорд╛рдЬрд░, рдорд╛рдЬрд░
ЁЯЩИ => ЁЯЩИ, рдЪреЗрд░реЛ, рдирд┐рд╖рд┐рдзреНрдж, рдкрд│реЛрд╡рдЪреЗрдВ, рдорд╛рдХреЛрдб, рд╡рд╛рдпрдЯ, рд╡рд╛рдпрдЯ рдкрд│реЛрд╡рдЪреЗрдВ рдиреНрд╣рдп рд╕рд╛рдВрдЧрдкреА рдорд╛рдХреЛрдб
ЁЯЩЙ => ЁЯЩЙ, рдЖрдпрдХрдк, рдЪреЗрд░реЛ, рдирд┐рд╖рд┐рдзреНрдж, рдорд╛рдХреЛрдб, рд╡рд╛рдпрдЯ, рд╡рд╛рдпрдЯ рдЖрдпрдХрдЪреЗрдВ рдиреНрд╣рдп рдорд╛рдХреЛрдб
ЁЯЩК => ЁЯЩК, рдЙрд▓реЛрд╡рдк, рдЪреЗрд░реЛ, рдирд┐рд╖рд┐рдзреНрдж, рдорд╛рдХреЛрдб, рд╡рд╛рдпрдЯ, рд╡рд╛рдпрдЯ рдЙрд▓реЛрд╡рдЪреЗрдВ рдиреНрд╣рдп рдорд╛рдХреЛрдб
ЁЯТЛ => ЁЯТЛ, рдЙрдореЛ, рдЙрдореНрдпрд╛рдЪреА рдЦреВрдг, рдУрдВрда
ЁЯТМ => ЁЯТМ, рдХрд╛рд│реАрдЬ, рдЪрд┐рдЯреА, рдореЗрд▓, рдореЛрдЧ, рдореЛрдЧрд╛ рдЪрд┐рдЯреА
ЁЯТШ => ЁЯТШ, рдХрд╛рдорджреЗрд╡, рдмрд╛рдг, рдмрд╛рдг рдЖрд╕рдкреА рдХрд╛рд│реАрдЬ, рдмрд╛рдг рддреЛрдкрд┐рд▓реНрд▓реЗрдВ рдХрд╛рд│реАрдЬ
ЁЯТЭ => ЁЯТЭ, рд░рд┐рдмреАрди, рд░рд┐рдмреАрдирд╛рди рдЧреБрдард▓рд╛рдпрд┐рд▓реНрд▓реЗрдВ рдХрд╛рд│реАрдЬ, рд╡реЕрд▓реЗрдиреНрдЯрд╛рдпрди
ЁЯТЦ => ЁЯТЦ, рдЙрддреНрддреЗрдЬреАрдд, рдЪрдХрдЪрдХрдкреА, рдЪрдХрдЪрдХрдкреА рдХрд╛рд│реАрдЬ
ЁЯТЧ => ЁЯТЧ, рдЙрддреНрддреЗрдЬреАрдд, рдЧреЛрдВрджрд│рд┐рд▓реНрд▓реЗрдВ, рдареЛрдХреЗ, рд╡рд╛рдбрдкреА, рд╡рд╛рдбрдкреА рдХрд╛рд│реАрдЬ
ЁЯТУ => ЁЯТУ, рдХрд╛рд│рдЬрд╛рдЪреЗ рдареЛрдХреЗ, рдзрдбрдзрдб, рдзрдбрдзрдбрдкреА, рдзрдбрдзрдбрдкреА рдХрд╛рд│реАрдЬ
ЁЯТЮ => ЁЯТЮ, рдШреБрдВрд╡рдкреА, рдШреБрдВрд╡рдкреА рдХрд╛рд│рдЬрд╛рдВ
ЁЯТХ => ЁЯТХ, рджреЛрди рдХрд╛рд│рдЬрд╛рдВ, рдореЛрдЧ
ЁЯТЯ => ЁЯТЯ, рдХрд╛рд│реАрдЬ, рдХрд╛рд│реАрдЬ рд╢реНрд░реГрдВрдЧрд╛рд░
тЭг => тЭг, рдЙрджрдЧрд╛рд░рдЪрд┐рдиреНрди, рдХрд╛рд│реАрдЬ рдЙрджрдЧрд╛рд░рдЪрд┐рдиреНрди, рдЦреВрдг, рд╡рд┐рд░рд╛рдордЪрд┐рдиреНрди
ЁЯТФ => ЁЯТФ, рднрдВрдЧ, рднрдВрдЧ рдЬрд╛рд▓реНрд▓реЗрдВ, рднрдВрдЧ рдЬрд╛рд▓реНрд▓реЗрдВ рдХрд╛рд│реАрдЬ, рднрдВрдЧ рдкрд╛рд╡рд┐рд▓реНрд▓реЗрдВ рдХрд╛рд│реАрдЬ
тЭд => тЭд, рдХрд╛рд│реАрдЬ, рддрд╛рдВрдмрдбреЗрдВ рдХрд╛рд│реАрдЬ
ЁЯзб => ЁЯзб, рд▓рд╛рд░рд╛рдВрдЬреА, рд▓рд╛рд░рд╛рдВрдЬреА рдХрд╛рд│реАрдЬ
ЁЯТЫ => ЁЯТЫ, рд╣рд│рджреБрд╡реЗрдВ, рд╣рд│рджреБрд╡реЗрдВ рдХрд╛рд│реАрдЬ
ЁЯТЪ => ЁЯТЪ, рдкрд╛рдЪрд╡реЗрдВ, рдкрд╛рдЪрд╡реЗрдВ рдХрд╛рд│реАрдЬ
ЁЯТЩ => ЁЯТЩ, рдирд┐рд│реЗрдВ, рдирд┐рд│реЗрдВ рдХрд╛рд│реАрдЬ
ЁЯТЬ => ЁЯТЬ, рдЬрд╛рдВрднрд│реЗрдВ, рдЬрд╛рдВрднрд│реЗрдВ рдХрд╛рд│реАрдЬ
ЁЯдО => ЁЯдО, рддрдкрдХрд┐рд░реА, рддрдкрдХрд┐рд░реА рдХрд╛рд│реАрдЬ
ЁЯЦд => ЁЯЦд, рдХрд╛рд│реЗрдВ, рдХрд╛рд│реЗрдВ рдХрд╛рд│реАрдЬ, рджреБрд╖реНрдЯ, рд╡рд╛рдпрдЯ
ЁЯдН => ЁЯдН, рдХрд╛рд│реАрдЬ, рдзрд╡реЗрдВ
ЁЯТп => ЁЯТп, 100, рдкреВрд░реНрдг, рд╢рдВрднрд░, рд╢рдВрднрд░ рдЧреВрдг, рд╕реНрдХреЛрд░
ЁЯТв => ЁЯТв, рдкрд┐рд╢реЗрдВ, рд░рд╛рдЧ, рд░рд╛рдЧрд╛рдЪреА рдЦреВрдг, рд╡рд┐рдиреЛрджреА
ЁЯТе => ЁЯТе, рдЯрдХреНрдХрд░, рдмреВрдо, рд╡рд┐рдиреЛрджреА
ЁЯТл => ЁЯТл, рдШреБрдВрд╡рд│, рдирдЦреЗрддреНрд░, рд╡рд┐рдиреЛрджреА
ЁЯТж => ЁЯТж, рдШрд╛рдо, рдШрд╛рдорд╛рдЪреЗ рдереЗрдВрдмреЗ, рд╡рд┐рдиреЛреЗрджреА, рд╢рд┐рддрд╛рдбреЛ
ЁЯТи => ЁЯТи, рдзрд╛рдВрд╡рдк, рдзреБрдХрд▓рдк, рдзреБрдХрд▓реВрди рдЙрдбреЛрд╡рдк, рд╡рд┐рдиреЛрджреА
ЁЯХ│ => ЁЯХ│, рдмреБрд░рд╛рдХ
ЁЯТг => ЁЯТг, рдмрд╛рдБрдм, рд╡рд┐рдиреЛрджреА
ЁЯТм => ЁЯТм, рдлреБрдЧреЛ, рдмреЛрдорд╛рдбреЛ, рд╡рд╛рдЪрд╛, рд╡рд┐рдиреЛрджреА, рд╕рдВрд╡рд╛рдж
ЁЯСБтАНЁЯЧи => ЁЯСБтАНЁЯЧи, рдЧрд╡рд╛рдп, рджреЛрд│реЛ, рд╡рд╛рдЪрд╛ рдлреБрдЧреЛ, рд╡рд╛рдЪрд╛ рдлреБрдЧреНрдпрд╛рдВрдд рджреЛрд│реЛ
ЁЯЧи => ЁЯЧи, рджрд╛рд╡реЛ рд╡рд╛рдЪрд╛ рдлреБрдЧреЛ, рд╡рд╛рдЪрд╛, рд╕рдВрд╡рд╛рдж
ЁЯЧп => ЁЯЧп, рдЙрдЬрд╡реЛ рд░рд╛рдЧрд╛рд░ рдлреБрдЧреЛ, рдкрд┐рд╕реЛ, рдлреБрдЧреЛ, рдмреЛрдорд╛рдбреЛ, рд░рд╛рдЧрд╛рд░
ЁЯТн => ЁЯТн, рдлреБрдЧреЛ, рдмреЛрдорд╛рдбреЛ, рд╡рд┐рдЪрд╛рд░, рд╡рд┐рдЪрд╛рд░реА рдмреЛрдорд╛рдбреЛ, рд╡рд┐рдиреЛрджреА
ЁЯТд => ЁЯТд, zzz, рдиреНрд╣реАрдж, рд╡рд┐рдиреЛрджреА
ЁЯСЛ => ЁЯСЛ, рд╣рд╛рдд, рд╣рд╛рд▓рдпрддрд╛, рд╣рд╛рд▓реЛрд╡рдк
ЁЯдЪ => ЁЯдЪ, рдЙрдЦрд▓рд┐рд▓реНрд▓реНрдпрд╛ рд╣рд╛рддрд╛рдЪреА рдлрд╛рдЯ, рдЙрдмрд╛рд░рд┐рд▓реНрд▓реЛ, рд╣рд╛рддрд╛рдЪреА рдлрд╛рдЯ, рд╣рд╛рддрд╛рдЪреА рдлрд╛рдЯ рдЙрдмрд╛рд░рд▓реНрдпрд╛
ЁЯЦР => ЁЯЦР, рдмреЛрдЯ, рдмреЛрдЯрд╛рдВ рд╡рд┐рд╕реНрдХрд│реАрдд рдмреЛрдЯрд╛рдВ, рдмреЛрдЯрд╛рдВ рд╡рд┐рд╕реНрдХрд│реАрдд рд╣рд╛рдд, рд╡рд┐рд╕реНрдХрд│реАрдд, рд╣рд╛рдд
тЬЛ => тЬЛ, рдЙрдЦрд▓рд┐рд▓реНрд▓реЛ рд╣рд╛рдд, рд╣рд╛рдд
ЁЯЦЦ => ЁЯЦЦ, рдмреЛрдЯ, рд╡реБрд▓рдХрди, рд╡реБрд▓рдХрди рд╕реЕрд▓реНрдпреБрдЯ, рд╕реНрдкреЙрдХ, рд╣рд╛рдд
ЁЯСМ => ЁЯСМ, рдУрдХреЗ, рд╣рд╛рдд
ЁЯдМ => ЁЯдМ, рдЪрд╡рдХрд╢реА, рдЪрд┐рдордЯреАрдЪреАрдВ рдмреЛрдЯрд╛рдВ, рдЪрд┐рдордЯреЛ рдХрд╛рдбрдк, рдмреЛрдЯрд╛рдВ, рд╡реНрдпрдВрдЧрд╛рддреНрдордХ, рд╣рд╛рддрд╛рдЪреЛ рд╣рд╛рд╡рднрд╛рд╡
ЁЯдП => ЁЯдП, рдЪрд┐рдордЯреЛ рдХрд╛рдбрдкреА рд╣рд╛рдд, рд▓реНрд╣рд╛рди рдкреНрд░рдорд╛рдг
тЬМ => тЬМ, рд╡рд┐рдЬрдп, рд╡рд┐рдЬрдпрд╛рдЪреЛ рд╣рд╛рдд, рд╡реНрд╣реА, рд╣рд╛рдд
ЁЯдЮ => ЁЯдЮ, рдХреНрд░реЙрд╕, рдХреНрд░реЙрд╕ рдХреЗрд▓реНрд▓реАрдВ рдмреЛрдЯрд╛рдВ, рдирд╢реАрдм, рдмреЛрдЯ, рд╣рд╛рдд
ЁЯдЯ => ЁЯдЯ, рдЖрдпрд▓рд╡рдпреБ, рддреБрдЬреЗрд░ рдореЛрдЧ рдХрд░рддрд╛ рд╣рд╛рд╡рднрд╛рд╡, рд╣рд╛рдд
ЁЯдШ => ЁЯдШ, рдмреЛрдЯ, рд░реЙрдХ-рдСрди, рд╢рд┐рдВрдЧрд╛рдВ, рд╢рд┐рдВрдЧрд╛рдВрдЪреЗрдВ рдЪрд┐рдиреНрди, рд╣рд╛рдд
ЁЯдЩ => ЁЯдЩ, рдХреЙрд▓, рдореНрд╣рд╛рдХрд╛ рдХреЙрд▓ рдХрд░ рд╣рд╛рдд, рд╣рд╛рдд
ЁЯСИ => ЁЯСИ, рддрд░реНрдЬрдиреА, рддрд░реНрдЬрдиреА рджрд╛рд╡реНрдпрд╛рди рджрд╛рдЦреЛрд╡рдкреА рд╣рд╛рддрд╛рдЪреА рдлрд╛рдЯ, рджрд╛рдЦреЛрд╡рдк, рдмреЛрдЯ, рд╣рд╛рдд, рд╣рд╛рддрд╛рдЪреА рдлрд╛рдЯ
ЁЯСЙ => ЁЯСЙ, рддрд░реНрдЬрдиреА, рддрд░реНрдЬрдиреА рдЙрдЬрд╡реНрдпрд╛рди рджрд╛рдЦреЛрд╡рдкреА рд╣рд╛рддрд╛рдЪреА рдлрд╛рдЯ, рджрд╛рдЦреЛрд╡рдк, рдмреЛрдЯ, рд╣рд╛рдд, рд╣рд╛рддрд╛рдЪреА рдлрд╛рдЯ
ЁЯСЖ => ЁЯСЖ, рддрд░реНрдЬрдиреА рд╡рдпрд▓реЗ рд╡рдЯреЗрди рджрд╛рдЦреЛрд╡рдкреА рд╣рд╛рддрд╛рдЪреА рдлрд╛рдЯ, рджрд╛рдЦреЛрд╡рдк, рдмреЛрдЯ, рд╡рдпрд░, рд╣рд╛рдд, рд╣рд╛рддрд╛рдЪреА рдлрд╛рдЯ
ЁЯЦХ => ЁЯЦХ, рдмреЛрдЯ, рдорджрд▓реЗрдВ рдмреЛрдЯ, рд╣рд╛рдд
ЁЯСЗ => ЁЯСЗ, рддрд░реНрдЬрдиреА рд╕рдХрдпрд▓реЗ рд╡рдЯреЗрди рджрд╛рдЦреЛрд╡рдкреА рд╣рд╛рддрд╛рдЪреА рдлрд╛рдЯ, рджрд╛рдЦреЛрд╡рдк, рдмреЛрдЯ, рд╡рдпрд░, рд╣рд╛рдд, рд╣рд╛рддрд╛рдЪреА рдлрд╛рдЯ
тШЭ => тШЭ, рддрд░реНрдЬрдиреА, рджрд╛рдЦрдпрддрд╛, рдмреЛрдЯ, рд╡рдпрд░, рд╣рд╛рдд
ЁЯСН => ЁЯСН, +1, рдЖрдЦрд╛рдгреЛ, рд╡рдпрд░, рд╣рд╛рдд
ЁЯСО => ЁЯСО, -1, рдЖрдЦрд╛рдгреЛ, рд╕рдХрдпрд▓, рд╣рд╛рдд
тЬК => тЬК, рдЖрд╡рд│рд┐рд▓реНрд▓реА, рдЙрдЦрд▓рд┐рд▓реНрд▓реА рдореВрда, рдореВрда, рдореВрда рдорд╛рд░рдк, рд╣рд╛рдд
ЁЯСК => ЁЯСК, рдЖрд╡рд│рд┐рд▓реНрд▓реА, рдкрдбрдкреА рдореВрда, рдореВрда, рдореВрда рдорд╛рд░рдк, рд╣рд╛рдд
ЁЯдЫ => ЁЯдЫ, рджрд╛рд╡реНрдпрд╛рди, рджрд╛рд╡реНрдпрд╛рди рдорд╛рд░рдкреА рдореВрда, рдореВрда
ЁЯдЬ => ЁЯдЬ, рдЙрдЬрд╡реНрдпрд╛рди, рдЙрдЬрд╡реНрдпрд╛рди рдорд╛рд░рдкреА рдореВрда, рдореВрда
ЁЯСП => ЁЯСП, рддрд╛рд│рдпреЛ рдорд╛рд░рдкреА рд╣рд╛рдд, рддрд╛рд│реА рдорд╛рд░рдк, рддрд╛рд│реА рдорд╛рд░рдкреА рд╣рд╛рдд, рд╣рд╛рдд
ЁЯЩМ => ЁЯЩМ, рдЙрдЦрд▓рд┐рд▓реНрд▓реЗрдВ, рдЙрдЦрд▓рд┐рд▓реНрд▓реЗ рд╣рд╛рдд, рд╕реБрд╡рд╛рд│реЛ, рд╣рд╛рдд, рд╣рд╛рд╡рднрд╛рд╡, рд╣реБрд░реНрд░реЗ
ЁЯСР => ЁЯСР, рдЙрдХрддреЗрдВ, рдЙрдХрддреЗ рд╣рд╛рдд, рд╣рд╛рдд
ЁЯд▓ => ЁЯд▓, рдПрдХрдард╛рдВрдп рдУрдВрдЬрд│, рдУрдВрдЬрд│ рдПрдХрдард╛рдВрдп, рдкреНрд░рд╛рд░реНрдердирд╛
ЁЯдЭ => ЁЯдЭ, рдХрд░рд╛рд░, рдмрд╕рдХрд╛рдВ, рд╢реЗрдХ, рд╢реЗрдХрд╣рдБрдб, рд╣рд╛рдд
ЁЯЩП => ЁЯЩП, рдЬреЛрдбрд┐рд▓реНрд▓реЗ рд╣рд╛рдд, рджреЗрд╡ рдмрд░реЗрдВ рдХрд░реВрдВ, рдкреНрд░рд╛рд░реНрдердирд╛, рдпрд╛рдЪрдирд╛, рд╡рд┐рдЪрд╛рд░рдк, рд╣рд╛рдд, рд╣рд╛рдд рдЬреЛрдбрдк
тЬН => тЬН, рдмрд░реЛрд╡рдкрд╛рдЪреЛ рд╣рд╛рдд, рд╣рд╛рдд ред рдмрд░реЛрд╡рдк ред рдмрд░реЛрд╡рдкрд╛рдЪреЛ рд╣рд╛рдд
ЁЯТЕ => ЁЯТЕ, рдЬрддрди ред рд╕реМрдВрджрд░реНрдпрдкреНрд░рд╕рд╛рдзрди ред рдореЕрдирд┐рдХреНрдпреБрдЕрд░ редрдиреЗрд▓ рдкреЙрд▓рд┐рд╢, рдиреЗрд▓ рдкреЙрд▓рд┐рд╢
ЁЯд│ => ЁЯд│, рдХреЕрдореЗрд░рд╛, рдлреЛрди, рд╕реЗрд▓реНрдлреА
ЁЯТк => ЁЯТк, рдлреБрдЧ, рдлреБрдЧрд┐рд▓реНрд▓реЗ рдмрд╛рдпрд╕реЗрдкреНрд╕, рдмрд╛рдпрд╕реЗрдкреНрд╕, рд╡рд┐рдиреЛрдВрдж, рд╕реНрдирд╛рдпреВ
ЁЯж╛ => ЁЯж╛, рдНрдХреНрд╕реЕрд╕рд┐рдмрд┐рд▓рд┐рдЯреА, рдкреНрд░реЛрд╕реНрдереЗрдЯрд┐рдХ, рдпрд╛рдВрддреНрд░рд┐рдХ рджрдВрдб
ЁЯж┐ => ЁЯж┐, рдНрдХреНрд╕реЕрд╕рд┐рдмрд┐рд▓рд┐рдЯреА, рдкреНрд░реЛрд╕реНрдереЗрдЯрд┐рдХ, рдпрд╛рдВрддреНрд░рд┐рдХ рдкрд╛рдВрдп
ЁЯж╡ => ЁЯж╡, рдХрд┐рдХ, рдЧрд╛рддреНрд░, рдкрд╛рдВрдп
ЁЯж╢ => ЁЯж╢, рдХрд┐рдХ, рдкрд╛рдВрдп, рд╕реНрдЯреЛрдореНрдк
ЁЯСВ => ЁЯСВ, рдХрд╛рди, рдХреВрдб
ЁЯж╗ => ЁЯж╗, рдЖрдпрдХреБрдкрд╛рдЪреЗрдВ рдпрдВрддреНрд░ рдмрд╕рдпрд▓реНрд▓реЛ рдХрд╛рди, рдНрдХреНрд╕реЕрд╕рд┐рдмрд┐рд▓рд┐рдЯреАред рдЖрдпрдХреБрдкрд╛рдЪреЗрдВ рдпрдВрддреНрд░ рдмрд╕рдпрд▓реНрд▓реЛ рдХрд╛рдиред рдЖрдпрдХреВрдВрдХ рдХрдареАрдг
ЁЯСГ => ЁЯСГ, рдХреВрдб, рдирд╛рдХ
ЁЯза => ЁЯза, рдореЗрдВрджреВ, рд╣реБрд╢рд╛рд░рдХрд╛рдп
ЁЯлА => ЁЯлА, рдЕрд╡рдпрд╡ред рдХрд╛рд░реНрдбрд┐рдУрд▓реЙрдЬреАред рдХрд╛рд│реАрдЬред рдСрд░реНрдЧрдиред рдирд╛рдбреА, рдХрд╛рд│рдЬрд╛рдЪреЗ рдЕрд╡рдпрд╡
ЁЯлБ => ЁЯлБ, рдлреБрдлреВрд╕, рд╕реНрд╡рд╛рд╕ред рд╕реНрд╡рд╛рд╕реЛрдЪреНрдЫрд╡рд╛рд╕ред рд╕реНрд╡рд╛рд╕ рдШреЗрд╡рдкред рдлреБрдлреВрд╕ред рдСрд░реНрдЧрдиред рд╕реНрд╡рд╛рд╕ рд╕реЛрдбрдк
ЁЯж╖ => ЁЯж╖, рджрд╛рдВрдд, рджрд╛рддрд╛рдВрдЪреЛ рджреЛрддреЛрд░
ЁЯж┤ => ЁЯж┤, рд╕рд╛рдВрдкрд│реЛ, рд╣рд╛рдб
ЁЯСА => ЁЯСА, рдЪреЗрд░реЛ, рджреЛрд│реЗ, рджреЛрд│реЛ
ЁЯСБ => ЁЯСБ, рдХреВрдб, рджреЛрд│реЛ
ЁЯСЕ => ЁЯСЕ, рдХреВрдб, рдЬреАрдн
ЁЯСД => ЁЯСД, рдУрдВрда, рддреЛрдВрдб
ЁЯС╢ => ЁЯС╢, рд╢рд┐рд╢реБ, рд╕рд╛рди
ЁЯзТ => ЁЯзТ, рдмрд╛рд│рдХ ред рддрдЯрд╕реНрде рд▓рд┐рдВрдЧред рдЕрдирд┐рд░реНрджрд┐рд╢реНрдЯ рд▓рд┐рдВрдЧ ред рддрд░рдгрд╛рдЯреЛ, рднреБрд░рдЧреЗрдВ
ЁЯСж => ЁЯСж, рдЪрд▓реЛ, рд╕рд╛рди
ЁЯСз => ЁЯСз, рдХрдиреНрдпрд╛, рдЪрд▓реА, рд░рд╛рд╕, рд╕рд╛рди
ЁЯзС => ЁЯзС, рдкреНрд░реМрдв ред рддрдЯрд╕реНрде рд▓рд┐рдВрдЧ ред рд╡реНрдпрдХреНрддреА ред рдЕрдирд┐рд░реНрджрд┐рд╢реНрдЯ рд▓рд┐рдВрдЧ, рд╡реНрдпрдХреНрддреА
ЁЯС▒ => ЁЯС▒, рдХреЗрдВрд╕, рдкрд┐рдВрдЧрд╢реЗ, рдкрд┐рдВрдЧрд╢реНрдпрд╛ рдХреЗрдВрд╕рд╛рдЪреЛ рд╡реНрдпрдХреНрддреА: рдкрд┐рдВрдЧрд╢реЗ рдХреЗрдВрд╕, рд╡реНрдпрдХреНрддреА, рд╡реНрдпрдХреНрддреА: рдкрд┐рдВрдЧрд╢реЗ рдХреЗрдВрд╕
ЁЯСи => ЁЯСи, рджрд╛рджрд▓реЛ, рдкреНрд░реМрдв
ЁЯзФ => ЁЯзФ, рдЦрд╛рдб, рджрд╛рджрд▓реЛ, рджрд╛рджрд▓реЛ : рдЦрд╛рдб, рд╡реНрдпрдХреНрддреА
ЁЯС▒тАНтЩВ => ЁЯС▒тАНтЩВ, рдХреЗрдВрд╕, рджрд╛рджрд▓реЛ, рджрд╛рджрд▓реЛ : рдкрд┐рдВрдЧрд╢реЗ рдХреЗрдВрд╕, рдкрд┐рдВрдЧрд╢реЗ, рдкрд┐рдВрдЧрд╢реНрдпрд╛ рдХреЗрдВрд╕рд╛рдЪреЛ рдордиреАрд╕
ЁЯСй => ЁЯСй, рдкреНрд░реМрдв, рдмрд╛рдпрд▓
ЁЯС▒тАНтЩА => ЁЯС▒тАНтЩА, рдХреЗрдВрд╕, рдкрд┐рдВрдЧрд╢реЗ, рдкрд┐рдВрдЧрд╢реЗ рдХреЗрдВрд╕рд╛рдВрдЪреА рдмрд╛рдпрд▓, рдмрд╛рдпрд▓, рдмрд╛рдпрд▓ : рдкрд┐рдВрдЧрд╢реЗ рдХреЗрдВрд╕, рдмрд╛рдпрд▓: рдкрд┐рдВрдЧрд╢реЗ рдХреЗрдВрд╕
ЁЯзУ => ЁЯзУ, рдЕрдЙрд▓реНрд▓реЗрдЦреАрдд рд▓рд┐рдВрдЧ, рдЬрд╛рдгреНрдЯреЛ, рдЬрд╛рдгреНрдЯреЛ рдордиреАрд╕, рдкреНрд░реМрдв, рд▓рд┐рдВрдЧ-рддрдЯрд╕реНрде
ЁЯС┤ => ЁЯС┤, рдЬрд╛рдгреНрдЯреЛ, рджрд╛рджрд▓реЛ, рдкреНрд░реМрдв
ЁЯС╡ => ЁЯС╡, рдЬрд╛рдгреНрдЯреА рдмрд╛рдпрд▓, рдЬрд╛рдгреНрдЯреЛ, рдкреНрд░реМрдв, рдмрд╛рдпрд▓
ЁЯЩН => ЁЯЩН, рднрд┐рдпреЗрд╡рдк, рд╡реНрдпрдХреНрддреА рднрд┐рддрд╛, рд╡реНрдпрдХреНрддреА рднрд┐рдпреЗрддрд╛, рд╣рд╛рд╡рднрд╛рд╡
ЁЯЩНтАНтЩВ => ЁЯЩНтАНтЩВ, рджрд╛рджрд▓реЛ, рджрд╛рджрд▓реЛ рднрд┐рдпреЗрддрд╛, рднрд┐рдпреЗрд╡рдк, рд╣рд╛рд╡рднрд╛рд╡
ЁЯЩНтАНтЩА => ЁЯЩНтАНтЩА, рдмрд╛рдпрд▓, рднрд┐рдпреЗрд╡рдк, рд╣рд╛рд╡рднрд╛рд╡
ЁЯЩО => ЁЯЩО, рдкрд╛рд╡рдЯ рдХрд░рддрд╛, рд╡реНрдпрдХреНрддреА рдкрд╛рд╡рдЯ рдХрд░рддрд╛, рд╣рд╛рд╡рднрд╛рд╡
ЁЯЩОтАНтЩВ => ЁЯЩОтАНтЩВ, рджрд╛рджрд▓реЛ, рджрд╛рджрд▓реЛ рдкрд╛рд╡рдЯ рдХрд░рддрд╛, рдкрд╛рд╡рдЯ рдХрд░рддрд╛, рд╣рд╛рд╡рднрд╛рд╡
ЁЯЩОтАНтЩА => ЁЯЩОтАНтЩА, рдкрд╛рд╡рдЯ рдХрд░рддрд╛, рдмрд╛рдпрд▓, рдмрд╛рдпрд▓ рдкрд╛рд╡рдЯ рдХрд░рддрд╛, рд╣рд╛рд╡рднрд╛рд╡
ЁЯЩЕ => ЁЯЩЕ, рд╡рд░реНрдЬреАрдд рдХрд░рдкред рд╣рд╛рд╡рднрд╛рд╡ред рд╣рд╛рддред рдирд╛ рдЕрд╢реЗрдВ рджрд╛рдЦреЛрд╡рдкреА рд╡реНрдпрдХреНрддреАрдЪреЗ рд╣рд╛рд╡рднрд╛рд╡ред рдкреНрд░рддрд┐рдмрдВрдзреАрдд, рд╡реНрдпрдХреНрддреА рдирд╛ рдЕрд╕реЛ рд╣рд╛рд╡рднрд╛рд╡ рдХрд░рддрд╛
ЁЯЩЕтАНтЩВ => ЁЯЩЕтАНтЩВ, рдирд╛ рдЕрд╢реЗрдВ рджрд╛рдЦреЛрд╡рдкреА рд╣рд╛рд╡рднрд╛рд╡ рджрд╛рджрд▓реЛ рдХрд░рддрд╛, рд╡рд░реНрдЬреАрдд рдХрд░рдкред рд╣рд╛рд╡рднрд╛рд╡ред рд╣рд╛рддред рджрд╛рджрд▓реЛ ред рдирд╛ рдЕрд╢реЗрдВ рджрд╛рдЦреЛрд╡рдкреА рд╡реНрдпрдХреНрддреАрдЪреЗ рд╣рд╛рд╡рднрд╛рд╡ред рдкреНрд░рддрд┐рдмрдВрдзреАрдд
ЁЯЩЕтАНтЩА => ЁЯЩЕтАНтЩА, рдирд╛ рдЕрд╢реЗрдВ рджрд╛рдЦреЛрд╡рдкреА рд╣рд╛рд╡рднрд╛рд╡ рдмрд╛рдпрд▓ рдХрд░рддрд╛, рд╡рд░реНрдЬреАрдд рдХрд░рдкред рд╣рд╛рд╡рднрд╛рд╡ред рд╣рд╛рддред рдкреНрд░рддрд┐рдмрдВрдзреАрддред рдмрд╛рдпрд▓ред рдирд╛ рдЕрд╢реЗрдВ рджрд╛рдЦреЛрд╡рдкреА рдмрд╛рдпрд▓ рд╣рд╛рд╡рднрд╛рд╡ рдХрд░рддрд╛
ЁЯЩЖ => ЁЯЩЖ, рдмрд░реЗрдВ рдЖрд╕рд╛ рдЕрд╢реЗрдВ рд╡реНрдпрдХреНрддреА рджрд╛рдЦрдпрддрд╛, рд╣рд╛рд╡рднрд╛рд╡ред рд╣рд╛рддред рдмрд░реЗрдВ рдЖрд╕рд╛ред рдмрд░реЗрдВ рдЖрд╕рд╛ рдЕрд╕реЛ рд╣рд╛рд╡рднрд╛рд╡
ЁЯЩЖтАНтЩВ => ЁЯЩЖтАНтЩВ, рдмрд░реЗрдВ рдЖрд╕рд╛ рдЕрд╢реЗрдВ рджрд╛рдЦреЛрд╡рдкреА рд╣рд╛рд╡рднрд╛рд╡ рджрд╛рджрд▓реЛ рдХрд░рддрд╛, рд╣рд╛рд╡рднрд╛рд╡ред рд╣рд╛рддред рджрд╛рджрд▓реЛред рджрд╛рджрд▓реЛред рдмрд░реЗрдВ рдЖрд╕рд╛ рдЕрд╢реЗрдВ рджрд╛рдЦреЛрд╡реА рд╣рд╛рд╡рднрд╛рд╡ред рдмрд░реЗрдВ рдЖрд╕рд╛
ЁЯЩЖтАНтЩА => ЁЯЩЖтАНтЩА, рдмрд░реЗрдВ рдЖрд╕рд╛ рдЕрд╕реЛ рд╣рд╛рд╡рднрд╛рд╡ рдмрд╛рдпрд▓ рджрд╛рдЦрдпрддрд╛, рд╣рд╛рд╡рднрд╛рд╡ред рд╣рд╛рддред рдмрд░реЗрдВ рдЖрд╕рд╛ред рдмрд╛рдпрд▓ред рдмрд░реЗрдВ рдЖрд╕рд╛ рдЕрд╕реЛ рд╣рд╛рд╡рднрд╛рд╡ рдмрд╛рдпрд▓ рджрд╛рдЦрдпрддрд╛
ЁЯТБ => ЁЯТБ, рдмрд╛рдпрд░ рд╣рд╛рдд рд╡рдпрд░ рдХрд╛рдбрдЯрд╛, рд╣рд╛рддред рдЖрджрд╛рд░редрдорд╛рд╣рд┐рддреАред рд╡реНрдпрдХреНрддреА рд╣рд╛рдд рд╡рдпрд░ рдХрд╛рдбрдЯрд╛ред рд╕реЗрд╕реАред рд╣рд╛рдд рд╡рдпрд░ рдХрд╛рдбрдк
ЁЯТБтАНтЩВ => ЁЯТБтАНтЩВ, рджрд╛рджрд▓реЛред рджрд╛рджрд▓реЛ рд╣рд╛рдд рд╡рдпрд░ рдХрд╛рдбрдЯрд╛ред рд╕реЗрд╕реАред рд╣рд╛рдд рд╡рдпрд░ рдХрд╛рдбрдк, рджрд╛рджрд▓реНрдпрд╛рдЪреНрдпрд╛ рд╣рд╛рддрд╛рдВрдд рддрд╛рдЯрд▓реА рдЖрд╕рд╛
ЁЯТБтАНтЩА => ЁЯТБтАНтЩА, рдмрд╛рдпрд▓ рд╣рд╛рдд рд╡рдпрд░ рдХрд╛рдбрдЯрд╛, рд╕реЗрд╕реАред рд╣рд╛рдд рд╡рдпрд░ рдХрд╛рдбрдкред рдмрд╛рдпрд▓ред рдмрд╛рдпрд▓ рд╣рд╛рдд рд╡рдпрд░ рдХрд╛рдбрдЯрд╛
ЁЯЩЛ => ЁЯЩЛ, рд╡реНрдпрдХреНрддреА рд╣рд╛рдд рд╡рдпрд░ рдХрд╛рдбрдЯрд╛, рд╣рд╛рд╡рднрд╛рд╡ред рд╣рд╛рддред рдЦреБрд╢рд╛рд▓ред рд╡реНрдпрдХреНрддреА рд╣рд╛рдд рд╡рдпрд░ рдХрд╛рдбрдЯрд╛ред рд╡рдпрд░ рдХрд╛рдбрд▓рд╛
ЁЯЩЛтАНтЩВ => ЁЯЩЛтАНтЩВ, рджрд╛рджрд▓реЛ рд╣рд╛рдд рд╡рдпрд░ рдХрд╛рдбрдЯрд╛, рд╣рд╛рд╡рднрд╛рд╡ред рджрд╛рджрд▓реЛред рджрд╛рджрд▓реЛ рд╣рд╛рдд рд╡рдпрд░ рдХрд╛рдбрдЯрд╛ред рд╣рд╛рдд рд╡рдпрд░ рдХрд╛рдбрдЯрд╛
ЁЯЩЛтАНтЩА => ЁЯЩЛтАНтЩА, рдмрд╛рдпрд▓ рд╣рд╛рдд рдЙрдмрд╛рд░рддрд╛, рд╣рд╛рд╡рднрд╛рд╡ред рд╣рд╛рдд рд╡рдпрд░ рдХрд╛рдбрдЯрд╛ред рдмрд╛рдпрд▓ред рдмрд╛рдпрд▓ рд╣рд╛рдд рд╡рдпрд░ рдХрд╛рдбрдЯрд╛
ЁЯзП => ЁЯзП, рдЖрдпрдХрдк, рдНрдХреНрд╕реЕрд╕рд┐рдмрд┐рд▓рд┐рдЯреА, рдХрд╛рди, рднреЗрдбреНрдбреЛ, рднреЗрдбреНрдбреЛ рд╡реНрдпрдХреНрддреА
ЁЯзПтАНтЩВ => ЁЯзПтАНтЩВ, рджрд╛рджрд▓реЛ, рднреЗрдбреНрдбреЛ, рднреЗрдбреНрдбреЛ рдордиреАрд╕
ЁЯзПтАНтЩА => ЁЯзПтАНтЩА, рдмрд╛рдпрд▓, рднреЗрдбреНрдбреА
ЁЯЩЗ => ЁЯЩЗ, рдмрд╛рдЧрд╡рдк, рдорд╛рдл рдХрд░рдЪреЗрдВ, рдорд╛рдлреА рдорд╛рдЧрддрд╛, рд╡реНрдпрдХреНрддреА рдмрд╛рдЧрд╡рддрд╛, рд╣рд╛рд╡рднрд╛рд╡
ЁЯЩЗтАНтЩВ => ЁЯЩЗтАНтЩВ, рджрд╛рджрд▓реЛ, рджрд╛рджрд▓реЛ рдмрд╛рдЧрд╡рддрд╛, рдлрд╛рд╡реЛрд░, рдмрд╛рдЧрд╡рдк, рдорд╛рдл рдХрд░рдЪреЗрдВ, рдорд╛рдлреА рдорд╛рдЧрддрд╛, рд╣рд╛рд╡рднрд╛рд╡
ЁЯЩЗтАНтЩА => ЁЯЩЗтАНтЩА, рдлрд╛рд╡реЛрд░, рдмрд╛рдЧрд╡рдк, рдмрд╛рдпрд▓, рдмрд╛рдпрд▓ рдмрд╛рдЧрд╡рддрд╛, рдорд╛рдл рдХрд░рдЪреЗрдВ, рдорд╛рдлреА рдорд╛рдЧрддрд╛, рд╣рд╛рд╡рднрд╛рд╡
ЁЯдж => ЁЯдж, рдЕрд╡рд┐рд╕реНрд╡рд╛рд╕ред рдЙрддреНрдХрдВрдард╛ред рдореБрдЦрд╛рдорд│ред рддрд│рд╣рд╛рддред рд╡реНрдпрдХреНрддреА рдореБрдЦрд╛рдорд│рд╛рдЪреЗрд░ рд╣рд╛рдд рдзрд░рддрд╛, рд╡реНрдпрдХреНрддреА рдореБрдЦрд╛рдорд│рд╛рдЪреЗрд░ рд╣рд╛рдд рдзрд░рддрд╛
ЁЯджтАНтЩВ => ЁЯджтАНтЩВ, рдЕрд╡рд┐рд╕реНрд╡рд╛рд╕ред рдЙрддреНрдХрдВрдард╛ред рдореБрдЦрд╛рдорд│рд╛рдЪреЗрд░ рд╣рд╛рддред рджрд╛рджрд▓реЛред рджрд╛рджрд▓реЛ рдореБрдЦрд╛рдорд│рд╛рдЪреЗрд░ рд╣рд╛рдд рдзрд░рддрд╛, рджрд╛рджрд▓реЛ рдореБрдЦрд╛рдорд│рд╛рдЪреЗрд░ рд╣рд╛рдд рдзрд░рддрд╛
ЁЯджтАНтЩА => ЁЯджтАНтЩА, рдЕрд╡рд┐рд╕реНрд╡рд╛рд╕ред рдЙрддреНрдХрдВрдард╛ред рдореБрдЦрд╛рдорд│рд╛рдЪреЗрд░ рд╣рд╛рддред рдмрд╛рдпрд▓ред рдмрд╛рдпрд▓ рдореБрдЦрд╛рдорд│рд╛рдЪреЗрд░ рд╣рд╛рдд рдзрд░рддрд╛, рдмрд╛рдпрд▓ рдореБрдЦрд╛рдорд│рд╛рдЪреЗрд░ рд╣рд╛рдд рдзрд░рддрд╛
ЁЯд╖ => ЁЯд╖, рдЙрджрд╛рд╕реАрдирддрд╛, рджреБрдмрд╛рд╡, рджреБрд░реНрд▓рдХреНрд╖, рдирдХрд│реЛ рдореНрд╣реВрдг рдХреЗрд▓реНрд▓реЛ рд╣рд╛рд╡рднрд╛рд╡, рд╡реНрдпрдХреНрддреАрди рдЖрдкреВрдг рдиреНрд╣рдп рдореНрд╣реВрдг рдХреЗрд▓реНрд▓реЛ рд╣рд╛рд╡рднрд╛рд╡
ЁЯд╖тАНтЩВ => ЁЯд╖тАНтЩВ, рдЖрдкреВрдг рдирдХрд│реЛ рдореНрд╣реВрдг рджрд╛рджрд▓реНрдпрд╛рди рдХреЗрд▓реНрд▓реЛ рд╣рд╛рд╡рднрд╛рд╡, рдЙрджрд╛рд╕реАрдирддрд╛, рджреБрдмрд╛рд╡, рджреБрд░реНрд▓рдХреНрд╖, рдирдХрд│реЛ рдореНрд╣реВрдг рдХреЗрд▓реНрд▓реЛ рд╣рд╛рд╡рднрд╛рд╡, рд╡реНрдпрдХреНрддреАрди рдЖрдкреВрдг рдиреНрд╣рдп рдореНрд╣реВрдг рдХреЗрд▓реНрд▓реЛ рд╣рд╛рд╡рднрд╛рд╡
ЁЯд╖тАНтЩА => ЁЯд╖тАНтЩА, рджреБрдмрд╛рд╡, рджреБрд░реНрд▓рдХреНрд╖, рдирдХрд│реЛ рдореНрд╣реВрдг рдХреЗрд▓реНрд▓реЛ рд╣рд╛рд╡рднрд╛рд╡, рдмрд╛рдпрд▓реЗрди рдЖрдкреВрдг рдирдХрд│реЛ рдореНрд╣реВрдг рдХреЗрд▓реНрд▓реЛ рд╣рд╛рд╡рднрд╛рд╡, рдмрд╛рдпрд▓реЗрди рдЖрдкреВрдг рдиреНрд╣рдп рдореНрд╣реВрдг рдХреЗрд▓реНрд▓реЛ рд╣рд╛рд╡рднрд╛рд╡
ЁЯзСтАНтЪХ => ЁЯзСтАНтЪХ, рдереЕрд░рд╛рдкрд┐рд╕реНрдЯ, рджреЛрддреЛрд░, рдирд░реНрд╕, рднрд▓рд╛рдпрдХреА рдХрд░реНрдордЪрд╛рд░реА, рднрд▓рд╛рдпрдХреА рдЬрддрди
ЁЯСитАНтЪХ => ЁЯСитАНтЪХ, рдереЕрд░рд╛рдкрд┐рд╕реНрдЯ, рджрд╛рджрд▓реЛ, рджрд╛рджрд▓реЛ рднрд▓рд╛рдпрдХреА рдХрд░реНрдордЪрд╛рд░реА, рджрд╛рджрд▓реЛ рднрд▓рд╛рдпрдХреА рдХрд╛рдордЧрд╛рд░, рджреЛрддреЛрд░, рдирд░реНрд╕, рднрд▓рд╛рдпрдХреА рдЬрддрди
ЁЯСйтАНтЪХ => ЁЯСйтАНтЪХ, рдереЕрд░рд╛рдкрд┐рд╕реНрдЯ, рджреЛрддреЛрд░, рдирд░реНрд╕, рдмрд╛рдпрд▓, рдмрд╛рдпрд▓ рднрд▓рд╛рдпрдХреА рдХрд░реНрдордЪрд╛рд░реА, рднрд▓рд╛рдпрдХреА рдЬрддрди
ЁЯзСтАНЁЯОУ => ЁЯзСтАНЁЯОУ, рдкрджрд╡реАрдзрд░, рд╡рд┐рджреНрдпрд╛рд░реНрдереА
ЁЯСитАНЁЯОУ => ЁЯСитАНЁЯОУ, рджрд╛рджрд▓реЛ, рдкрджрд╡реАрдзрд░, рд╡рд┐рджреНрдпрд╛рд░реНрдереА
ЁЯСйтАНЁЯОУ => ЁЯСйтАНЁЯОУ, рдкрджрд╡реАрдзрд░, рдмрд╛рдпрд▓, рд╡рд┐рджреНрдпрд╛рд░реНрдереА
ЁЯзСтАНЁЯПл => ЁЯзСтАНЁЯПл, рдкреНрд░реЛрдлреЗрд╕рд░, рдорд╛рд░реНрдЧрджрд░реНрд╢рдХ, рд╢рд┐рдХреНрд╖рдХ
ЁЯСитАНЁЯПл => ЁЯСитАНЁЯПл, рджрд╛рджрд▓реЛ, рдкреНрд░реЛрдлреЗрд╕рд░, рдорд╛рд░реНрдЧрджрд░реНрд╢рдХ, рд╢рд┐рдХреНрд╖рдХ
ЁЯСйтАНЁЯПл => ЁЯСйтАНЁЯПл, рдкреНрд░реЛрдлреЗрд╕рд░, рдмрд╛рдпрд▓, рдорд╛рд░реНрдЧрджрд░реНрд╢рдХ, рд╢рд┐рдХреНрд╖рдХ
ЁЯзСтАНтЪЦ => ЁЯзСтАНтЪЦ, рдиреНрдпрд╛рдпрд╛рдзреАрд╢, рдкреНрд░рдорд╛рдгрд╛рдВ
ЁЯСитАНтЪЦ => ЁЯСитАНтЪЦ, рджрд╛рджрд▓реЛ, рджрд╛рджрд▓реЛ рдиреНрдпрд╛рдпрд╛рдзреАрд╢, рдиреНрдпрд╛рдп, рдкреНрд░рдорд╛рдгрд╛рдВ
ЁЯСйтАНтЪЦ => ЁЯСйтАНтЪЦ, рдиреНрдпрд╛рдпрд╛рдзреАрд╢, рдкреНрд░рдорд╛рдгрд╛рдВ, рдмрд╛рдпрд▓
ЁЯзСтАНЁЯМ╛ => ЁЯзСтАНЁЯМ╛, рдорд╛рдирд╛рдп, рд░рдБрдЪрд░, рд╢реЗрддрдХрд╛рд░
ЁЯСитАНЁЯМ╛ => ЁЯСитАНЁЯМ╛, рджрд╛рджрд▓реЛ, рдорд╛рдирд╛рдп, рд░рдБрдЪрд░, рд╢реЗрддрдХрд╛рд░
ЁЯСйтАНЁЯМ╛ => ЁЯСйтАНЁЯМ╛, рдмрд╛рдпрд▓ рд╢реЗрддрдХрд╛рдиреНрди, рд╢реЗрддрдХрд╛рд░ред рдорд╛рдирд╛рдпред рд░рдБрдЪрд░ред рдмрд╛рдпрд▓
ЁЯзСтАНЁЯН│ => ЁЯзСтАНЁЯН│, рдХреБрдЭрдиреЗрд░, рд╢реЕрдлред рдХреБрдЭрдиреЗрд░
ЁЯСитАНЁЯН│ => ЁЯСитАНЁЯН│, рджрд╛рджрд▓реЛ рдХреБрдЭрдиреЗрд░, рд╢реЕрдлред рдХреБрдЭрдиреЗрд░ред рджрд╛рджрд▓реЛ
ЁЯСйтАНЁЯН│ => ЁЯСйтАНЁЯН│, рдмрд╛рдпрд▓ рдХреБрдЭрдиреЗрд░, рд╢реЕрдлред рдХреБрдЭрдиреЗрд░ред рдмрд╛рдпрд▓
ЁЯзСтАНЁЯФз => ЁЯзСтАНЁЯФз, рдЗрд▓реЕрдХреНрдЯреНрд░рд┐рд╢рд┐рдпрди, рдкреНрд▓рдореНрдмрд░, рдореЕрдХрд╛рдиреАрдХ, рд╡реЗрдкрд╛рд░реА
ЁЯСитАНЁЯФз => ЁЯСитАНЁЯФз, рдЗрд▓реЕрдХреНрдЯреНрд░рд┐рд╢рд┐рдпрди, рджрд╛рджрд▓реЛ, рдкреНрд▓рдореНрдмрд░, рдореЕрдХрд╛рдиреАрдХ, рд╡реЗрдкрд╛рд░реА
ЁЯСйтАНЁЯФз => ЁЯСйтАНЁЯФз, рдЗрд▓реЕрдХреНрдЯреНрд░рд┐рд╢рд┐рдпрди, рдкреНрд▓рдореНрдмрд░, рдмрд╛рдпрд▓, рдореЕрдХрд╛рдиреАрдХ, рд╡реЗрдкрд╛рд░реА
ЁЯзСтАНЁЯПн => ЁЯзСтАНЁЯПн, рдЕрд╕реЕрдореНрдмрд▓реАред рдлреЕрдХреНрдЯреНрд░реАред рдЙрджреНрдпреЗрдЧрдзрдВрджреЛред рдХрд╛рдордЧрд╛рд░, рдлреЕрдХреНрдЯреНрд░реА рдХрд╛рдордЧрд╛рд░
ЁЯСитАНЁЯПн => ЁЯСитАНЁЯПн, рдЕрд╕реЕрдореНрдмрд▓реАред рдлреЕрдХреНрдЯреНрд░реАред рдЙрджреНрдпреЗрдЧрдзрдВрджреЛред рджрд╛рджрд▓реЛред рдХрд╛рдордЧрд╛рд░, рджрд╛рджрд▓реЛ рдлреЕрдХреНрдЯреНрд░реА рдХрд╛рдордЧрд╛рд░
ЁЯСйтАНЁЯПн => ЁЯСйтАНЁЯПн, рдЕрд╕реЕрдореНрдмрд▓реАред рдлреЕрдХреНрдЯреНрд░реАред рдЙрджреНрдпреЗрдЧрдзрдВрджреЛред рдмрд╛рдпрд▓ред рдХрд╛рдордЧрд╛рд░, рдмрд╛рдпрд▓ рдлреЕрдХреНрдЯреНрд░реА рдХрд╛рдордЧрд╛рд░
ЁЯзСтАНЁЯТ╝ => ЁЯзСтАНЁЯТ╝, рдХрдЪреЗрд░реЗрдВрддрд▓реЛ рдХрд╛рдордЧрд╛рд░, рдзрд╡реА-рдХреЙрд▓рд░, рд╡реЗрд╡рд╕рд╛рдп, рд╢рд┐рд▓реНрдкрдХрд▓рд╛рдВ
ЁЯСитАНЁЯТ╝ => ЁЯСитАНЁЯТ╝, рджрд╛рджрд▓реЛ, рджрд╛рджрд▓реЛ рдХрдЪреЗрд░реЗрддрд▓реЛ рдХрд╛рдордЧрд╛рд░, рджрд╛рджрд▓реЛ рдХрдЪреЗрд░реЗрдВрддрд▓реЛ рдХрд╛рдордЧрд╛рд░, рдзрд╡реА-рдХреЙрд▓рд░, рд╡реЗрд╡рд╕рд╛рдп, рд╡реЗрд╡рд╕реНрдерд╛рдкрдХ, рд╢рд┐рд▓реНрдкрдХрд▓рд╛
ЁЯСйтАНЁЯТ╝ => ЁЯСйтАНЁЯТ╝, рдзрд╡реА-рдХреЙрд▓рд░, рдмрд╛рдпрд▓, рдмрд╛рдпрд▓ рдХрдЪреЗрд░реЗрддрд▓реА рдХрд╛рдордЧрд╛рд░, рдмрд╛рдпрд▓ рдХрдЪреЗрд░реЗрдВрддрд▓реА рдХрд╛рдордЧрд╛рд░, рд╡реЗрд╡рд╕рд╛рдп, рд╡реЗрд╡рд╕реНрдерд╛рдкрдХ, рд╢рд┐рд▓реНрдкрдХрд▓рд╛
ЁЯзСтАНЁЯФм => ЁЯзСтАНЁЯФм, рдЗрдВрдЬрд┐рдирд┐рдпрд░, рдЬреАрд╡рд╢рд╛рд╕реНрддреНрд░рдЬреНрдЮ, рдлрд┐рдЬрд┐рд╕рд┐рд╕реНрдЯ, рд░рд╕рд╛рдпрдирд╢рд╛рд╕реНрддреНрд░рдЬреНрдЮ, рд╢рд╛рд╕реНрддреНрд░рдЬреНрдЮ
ЁЯСитАНЁЯФм => ЁЯСитАНЁЯФм, рдЗрдВрдЬрд┐рдирд┐рдпрд░, рдЬреАрд╡рд╢рд╛рд╕реНрддреНрд░рдЬреНрдЮ, рджрд╛рджрд▓реЛ, рдлрд┐рдЬрд┐рд╕рд┐рд╕реНрдЯ, рд░рд╕рд╛рдпрдирд╢рд╛рд╕реНрддреНрд░рдЬреНрдЮ, рд╢рд╛рд╕реНрддреНрд░рдЬреНрдЮ
ЁЯСйтАНЁЯФм => ЁЯСйтАНЁЯФм, рдЗрдВрдЬрд┐рдирд┐рдпрд░, рдЬреАрд╡рд╢рд╛рд╕реНрддреНрд░рдЬреНрдЮ, рдлрд┐рдЬрд┐рд╕рд┐рд╕реНрдЯ, рдмрд╛рдпрд▓, рд░рд╕рд╛рдпрдирд╢рд╛рд╕реНрддреНрд░рдЬреНрдЮ, рд╢рд╛рд╕реНрддреНрд░рдЬреНрдЮ
ЁЯзСтАНЁЯТ╗ => ЁЯзСтАНЁЯТ╗, рдЗрдирд╡реЗрдВрдЯрд░, рдХреЛрдбрд░, рдЯреЕрдХреНрдиреЛрд▓реЙрдЬрд┐рд╕реНрдЯ, рдбреЕрд╡рд▓реЙрдкрд░, рдмрд╛рдпрд▓, рд╕реЙрдлреНрдЯрд╡реЕрд░
ЁЯСитАНЁЯТ╗ => ЁЯСитАНЁЯТ╗, рдЗрдирд╡реЗрдВрдЯрд░, рдХреЛрдбрд░, рдЯреЕрдХреНрдиреЛрд▓реЙрдЬрд┐рд╕реНрдЯ, рдбреЕрд╡рд▓реЙрдкрд░, рджрд╛рджрд▓реЛ, рджрд╛рджрд▓реЛ рддрдВрддреНрд░рдЬреНрдЮрд╛рдиреА, рд╕реЙрдлреНрдЯрд╡реЕрд░
ЁЯСйтАНЁЯТ╗ => ЁЯСйтАНЁЯТ╗, рдЗрдирд╡реЗрдВрдЯрд░, рдХреЛрдбрд░, рдЯреЕрдХреНрдиреЛрд▓реЙрдЬрд┐рд╕реНрдЯ, рдбреЕрд╡рд▓реЙрдкрд░, рдмрд╛рдпрд▓, рд╕реЙрдлреНрдЯрд╡реЕрд░
ЁЯзСтАНЁЯОд => ЁЯзСтАНЁЯОд, рдХрд▓рд╛рдХрд╛рд░, рдЧрд╛рдпрдХ, рдЧрд╛рдпрд┐рдХрд╛, рдордирд░рд┐рдЬрд╡рдг рдХрд░рдкреА, рд░реЙрдХ, рд╕реНрдЯрд╛рд░
ЁЯСитАНЁЯОд => ЁЯСитАНЁЯОд, рдХрд▓рд╛рдХрд╛рд░, рдЧрд╛рдпрдХ, рджрд╛рджрд▓реЛ, рдордирд░рд┐рдЬрд╡рдг рдХрд░рдкреА, рд░реЙрдХ, рд╕реНрдЯрд╛рд░
ЁЯСйтАНЁЯОд => ЁЯСйтАНЁЯОд, рдХрд▓рд╛рдХрд╛рд░, рдЧрд╛рдпрд┐рдХрд╛, рдмрд╛рдпрд▓, рдордирд░рд┐рдЬрд╡рдг рдХрд░рдкреА, рд░реЙрдХ, рд╕реНрдЯрд╛рд░
ЁЯзСтАНЁЯОи => ЁЯзСтАНЁЯОи, рдХрд▓рд╛рдХрд╛рд░, рдкрд▓реЗрдЯреА
ЁЯСитАНЁЯОи => ЁЯСитАНЁЯОи, рдХрд▓рд╛рдХрд╛рд░, рджрд╛рджрд▓реЛ, рдкрд▓реЗрдЯреА
ЁЯСйтАНЁЯОи => ЁЯСйтАНЁЯОи, рдХрд▓рд╛рдХрд╛рд░, рдкрд▓реЗрдЯреА, рдмрд╛рдпрд▓
ЁЯзСтАНтЬИ => ЁЯзСтАНтЬИ, рдкрд╛рдпрд▓рдЯ, рд╡рд┐рдорд╛рди
ЁЯСитАНтЬИ => ЁЯСитАНтЬИ, рджрд╛рджрд▓реЛ, рдкрд╛рдпрд▓рдЯ, рд╡рд┐рдорд╛рди
ЁЯСйтАНтЬИ => ЁЯСйтАНтЬИ, рдкрд╛рдпрд▓рдЯ, рдмрд╛рдпрд▓, рд╡рд┐рдорд╛рди
ЁЯзСтАНЁЯЪА => ЁЯзСтАНЁЯЪА, рдЦрдЧреЛрд▓рд╢рд╛рд╕реНрддреНрд░рдЬреНрдЮ, рд░реЙрдХреЗрдЯ
ЁЯСитАНЁЯЪА => ЁЯСитАНЁЯЪА, рдЦрдЧреЛрд▓рд╢рд╛рд╕реНрддреНрд░рдЬреНрдЮ, рджрд╛рджрд▓реЛ, рд░реЙрдХреЗрдЯ
ЁЯСйтАНЁЯЪА => ЁЯСйтАНЁЯЪА, рдЦрдЧреЛрд▓рд╢рд╛рд╕реНрддреНрд░рдЬреНрдЮ, рдмрд╛рдпрд▓, рд░реЙрдХреЗрдЯ
ЁЯзСтАНЁЯЪТ => ЁЯзСтАНЁЯЪТ, рдЙрдЬреЛ рдкрд╛рд▓рд╡рдкреА, рдЙрдЬреЛ рдкрд╛рд▓рд╡рдкреА рдЯреНрд░рдХ
ЁЯСитАНЁЯЪТ => ЁЯСитАНЁЯЪТ, рдЙрдЬреЛ рдкрд╛рд▓рд╡рдкреА, рдЙрдЬреЛ рдкрд╛рд▓рд╡рдкреА рдЯреНрд░рдХ, рджрд╛рджрд▓реЛ, рджрд╛рджрд▓реЛ рдЙрдЬреЛрдкрд╛рд▓рд╡рдкреА
ЁЯСйтАНЁЯЪТ => ЁЯСйтАНЁЯЪТ, рдЙрдЬреЛ рдкрд╛рд▓рд╡рдкреА, рдЙрдЬреЛ рдкрд╛рд▓рд╡рдкреА рдЯреНрд░рдХ, рдмрд╛рдпрд▓, рдмрд╛рдпрд▓ рдЙрдЬреЛ рдкрд╛рд▓рд╡рдкреА
ЁЯСо => ЁЯСо, рдЕрдзрд┐рдХрд╛рд░реА, рдкреБрд▓рд┐рд╕, рд╢рд┐рдкрд╛рдп
ЁЯСотАНтЩВ => ЁЯСотАНтЩВ, рдЕрдзрд┐рдХрд╛рд░реА, рджрд╛рджрд▓реЛ, рдкреБрд▓рд┐рд╕, рд╢рд┐рдкрд╛рдп
ЁЯСотАНтЩА => ЁЯСотАНтЩА, рдЕрдзрд┐рдХрд╛рд░реА, рдкреБрд▓рд┐рд╕, рдмрд╛рдпрд▓, рд╢рд┐рдкрд╛рдп
ЁЯХ╡ => ЁЯХ╡, рдЧреБрдкреНрдд рдкреБрд▓рд┐рд╕, рдЧреБрдкреНрддрдЪрд░, рдЧреБрдкреНрддрд╣реЗрд░
ЁЯХ╡тАНтЩВ => ЁЯХ╡тАНтЩВ, рдЧреБрдкреНрдд рдкреБрд▓рд┐рд╕, рдЧреБрдкреНрддрдЪрд░, рдЧреБрдкреНрддрд╣реЗрд░, рджрд╛рджрд▓реЛ
ЁЯХ╡тАНтЩА => ЁЯХ╡тАНтЩА, рдЧреБрдкреАрдд рдкреБрд▓рд┐рд╕, рдЧреБрдкреНрддрдЪрд░, рдЧреБрдкреНрддрд╣реЗрд░, рдмрд╛рдпрд▓
ЁЯТВ => ЁЯТВ, рдЧрд╛рд░реНрдб
ЁЯТВтАНтЩВ => ЁЯТВтАНтЩВ, рдЧрд╛рд░реНрдб, рджрд╛рджрд▓реЛ
ЁЯТВтАНтЩА => ЁЯТВтАНтЩА, рдЧрд╛рд░реНрдб, рдмрд╛рдпрд▓
ЁЯе╖ => ЁЯе╖, рдирд┐рдиреНрдЬрд╛, рд▓рдврдкреА, рд▓рд┐рдкрдЪреЛрд░рдпрд╛рдВ, рд▓рд┐рдкрд┐рд▓реНрд▓реЛ
ЁЯС╖ => ЁЯС╖, рдХрд╛рдордЧрд╛рд░, рдмрд╛рдВрдзрдХрд╛рдо, рд╣реЕрдЯ
ЁЯС╖тАНтЩВ => ЁЯС╖тАНтЩВ, рдХрд╛рдордЧрд╛рд░, рджрд╛рджрд▓реЛ, рдмрд╛рдВрдзрдХрд╛рдо
ЁЯС╖тАНтЩА => ЁЯС╖тАНтЩА, рдХрд╛рдордЧрд╛рд░, рдмрд╛рдВрдзрдХрд╛рдо, рдмрд╛рдпрд▓
ЁЯд┤ => ЁЯд┤, рдХреБрдВрд╡рд░
ЁЯС╕ => ЁЯС╕, рдХреБрдВрд╡рд░реА, рдирд╡рд▓рдХрдерд╛, рдкрд░реА рдХрдерд╛
ЁЯС│ => ЁЯС│, рдлреЗрдЯреЛ, рдлреЗрдЯреЛ рдорд╛рд░рд┐рд▓реНрд▓реЛ рд╡реНрдпрдХреНрддреА
ЁЯС│тАНтЩВ => ЁЯС│тАНтЩВ, рджрд╛рджрд▓реЛ, рдлреЗрдЯреЛ, рдлреЗрдЯреЛ рдорд╛рд░рд┐рд▓реНрд▓реЛ рджрд╛рджрд▓реЛ
ЁЯС│тАНтЩА => ЁЯС│тАНтЩА, рдлреЗрдЯреЛ, рдлреЗрдЯреЛ рдорд╛рд░рд┐рд▓реНрд▓реА рдмрд╛рдпрд▓, рдмрд╛рдпрд▓
ЁЯС▓ => ЁЯС▓, рдЧреБрдЖ рдкреА рдорд╛рд╡, рдЪрд┐рдиреА рдХреЕрдк рдШрд╛рд▓реНрд▓реЛ рджрд╛рджрд▓реЛ, рджрд╛рджрд▓реЛ, рд╣реЕрдЯ
ЁЯзХ => ЁЯзХ, рдЯрд┐рдЪреЗрд▓, рддрдХрд▓реЗрдХ рд╕реНрдХрд╛рд░реНрдл, рддрдХрд▓реЗрдХ рд╕реНрдХрд╛рд░реНрдл рдмрд╛рдВрджрд┐рд▓реНрд▓реА рдмрд╛рдпрд▓, рдордБрдЯрд┐рд▓рд╛, рд╣рд┐рдЬрд╛рдм
ЁЯд╡ => ЁЯд╡, рдиреНрд╣рд╡рд░реЛ, рдлрд╛рдд, рдлрд╛рдд рдШрд╛рддрд┐рд▓реНрд▓реЛ рд╡реНрдпрдХреНрддреА, рд╡реНрдпрдХреНрддреА
ЁЯд╡тАНтЩВ => ЁЯд╡тАНтЩВ, рджрд╛рджрд▓реЛред рдлрд╛рдд рдШрд╛рддрд┐рд▓реНрд▓реЛ рджрд╛рджрд▓реЛред рдлрд╛рдд, рдлрд╛рдд рдШрд╛рддрд┐рд▓реНрд▓реЛ рджрд╛рджрд▓реЛ
ЁЯд╡тАНтЩА => ЁЯд╡тАНтЩА, рдлрд╛рдд рдШрд╛рддрд┐рд▓реНрд▓реА рдмрд╛рдпрд▓, рдлрд╛рддред рдмрд╛рдпрд▓ред рдлрд╛рдд рдШрд╛рддрд┐рд▓реНрд▓реА рдмрд╛рдпрд▓
ЁЯС░ => ЁЯС░, рд▓рдЧреНрди, рд╡реЗрд▓, рд╡реЗрд▓ рдШрд╛рддрд┐рд▓реНрд▓реА рд╡реНрдпрдХреНрддреА, рд╡реНрдпрдХреНрддреА, рд╡реНрд╣рдВрдХрд▓
ЁЯС░тАНтЩВ => ЁЯС░тАНтЩВ, рджрд╛рджрд▓реЛред рд╡реЗрд▓ рдШрд╛рддрд┐рд▓реНрд▓реЛ рджрд╛рджрд▓реЛред рд╡реЗрд▓, рд╡реЗрд▓ рдШрд╛рддрд┐рд▓реНрд▓реЛ рджрд╛рджрд▓реЛ
ЁЯС░тАНтЩА => ЁЯС░тАНтЩА, рд╡реЗрд▓ рдШрд╛рддрд┐рд▓реНрд▓реА рдмрд╛рдпрд▓, рд╡реЗрд▓ред рдмрд╛рдпрд▓ред рд╡реЗрд▓ рдШрд╛рддрд┐рд▓реНрд▓реА рдмрд╛рдпрд▓
ЁЯд░ => ЁЯд░, рдЧреБрд░рд╡рд╛рд░, рдмрд╛рдпрд▓
ЁЯд▒ => ЁЯд▒, рджреВрдж рджрд┐рд╡рдк, рд╢рд┐рд╢реВ, рд╕реНрддрди, рд╕реНрддрди-рдкрд╛рди
ЁЯСйтАНЁЯН╝ => ЁЯСйтАНЁЯН╝, рдмрд╛рдпрд▓ рдмрд╛рд│рдХрд╛рдХ рджреВрдж рдкрд╛рдЬрддрд╛, рдмрд╛рд│рдХред рджреВрдж рдкрд╛рдЬрдкред рдирд░реНрд╕рд┐рдВрдЧред рдмрд╛рдпрд▓
ЁЯСитАНЁЯН╝ => ЁЯСитАНЁЯН╝, рджрд╛рджрд▓реЛ рдмрд╛рд│рдХрд╛рдХ рджреВрдж рдкрд┐рд╡рдпрддрд╛, рдмрд╛рд│рдХред рджреВрдж рдкрд╛рдЬрдкред рджрд╛рджрд▓реЛред рдирд░реНрд╕рд┐рдВрдЧ
ЁЯзСтАНЁЯН╝ => ЁЯзСтАНЁЯН╝, рдирд░реНрд╕рд┐рдВрдЧ, рдмрд╛рд│рдХред рджреВрдж рдкрд╛рдЬрдк, рд╡реНрдпрдХреНрддреА рдмрд╛рд│рдХрд╛рдХ рджреВрдж рдкрд╛рдЬрддрд╛, рд╡реНрдпрдХреНрддреАред рд╡реНрдпрдХреНрддреА рдмрд╛рд│рдХрд╛рдХ рджреВрдж рдкрд╛рдЬрддрд╛
ЁЯС╝ => ЁЯС╝, рдЪреЗрд░реЛ, рдирд╡рд▓рдХрдерд╛, рдкрд░реА, рдкрд░реА рдХрдерд╛, рдмрд╛рд▓
ЁЯОЕ => ЁЯОЕ, рдХреНрд▓реЙрдЬ, рдЦреНрд░рд┐рд╕реНрддрдорд╕, рдмрд╛рдкреВрдп, рд╕рд╛рдВрддрд╛, рд╕реБрд╡рд╛рд│реЛ
ЁЯд╢ => ЁЯд╢, рдЖрд╡рдп, рдХреНрд▓реЙрдЬ, рдЦреНрд░рд┐рд╕реНрддрдорд╕, рд╢реНрд░реАрдорддреА, рд╕реБрд╡рд╛рд│реЛ
ЁЯзСтАНЁЯОД => ЁЯзСтАНЁЯОД, рдХреНрд▓реЙрд╕, рдирд╛рддрд▓рд╛рдВред рд╕рд╛рдВрддрд╛ рдХреНрд▓реЙрд╕, рд╕рд╛рдВрддрд╛ рдХреНрд▓реЙрд╕
ЁЯж╕ => ЁЯж╕, рдЙрддреНрддрдо, рд╕реБрдкрд░рдкрд╛рд╡рд░, рд╕реБрдкрд░рд╣рд┐рд░реЛ, рд╣рд┐рд░реЛ, рд╣рд┐рд░реЛрдИрди
ЁЯж╕тАНтЩВ => ЁЯж╕тАНтЩВ, рдЙрддреНрддрдо, рджрд╛рджрд▓реЛ, рджрд╛рджрд▓реЛ рд╕реБрдкрд░рд╣рд┐рд░реЛ, рд╕реБрдкрд░рдкрд╛рд╡рд░, рд╣рд┐рд░реЛ
ЁЯж╕тАНтЩА => ЁЯж╕тАНтЩА, рдЙрддреНрддрдо, рдмрд╛рдпрд▓, рдмрд╛рдпрд▓ рд╕реБрдкрд░рд╣рд┐рд░реЛ, рд╕реБрдкрд░рдкрд╛рд╡рд░, рд╣рд┐рд░реЛ, рд╣рд┐рд░реЛрдИрди
ЁЯж╣ => ЁЯж╣, рдЧреБрдиреНрдпрд╛рдВрд╡рдХрд╛рд░реА, рд╡рд╛рдпрдЯ, рд╡рд┐рд▓рди, рд╕реБрдкрд░рдкрд╛рд╡рд░, рд╕реБрдкрд░рд╡рд┐рд▓рди
ЁЯж╣тАНтЩВ => ЁЯж╣тАНтЩВ, рдЧреБрдиреНрдпрд╛рдВрд╡рдХрд╛рд░реА, рджрд╛рджрд▓реЛ, рджрд╛рджрд▓реЛ рд╕реБрдкрд░рд╡рд┐рд▓рди, рджрд╛рджрд▓реЛ рд╕реБрдкрд░рд╡рд┐рд▓реЗрди, рд╡рд╛рдпрдЯ, рд╡рд┐рд▓реЗрди, рд╕реБрдкрд░рдкрд╛рд╡рд░
ЁЯж╣тАНтЩА => ЁЯж╣тАНтЩА, рдЧреБрдиреНрдпрд╛рдВрд╡рдХрд╛рд░реА, рдмрд╛рдпрд▓, рдмрд╛рдпрд▓ рд╕реБрдкрд░рд╡рд┐рд▓реЗрди, рд╡рд╛рдпрдЯ, рд╡рд┐рд▓реЗрди, рд╕реБрдкрд░рдкрд╛рд╡рд░
ЁЯзЩ => ЁЯзЩ, рдЪреЗрдЯрдХреАрдг, рдЪреЗрдЯреВрдХ, рдорд╛рдЧреЗ, рд╕реЛрд░рд╕реЗрд░рд░, рд╕реЛрд░рд╕реЗрд░реЗрд╕
ЁЯзЩтАНтЩВ => ЁЯзЩтАНтЩВ, рджрд╛рджрд▓реЛ рдорд╛рдЧреЗ, рд╡реНрд╣рд┐рдЭрд╛рд░реНрдб, рд╕реЛрд░рд╕реЗрд░рд░
ЁЯзЩтАНтЩА => ЁЯзЩтАНтЩА, рдЪреЗрдЯрдХреАрдг, рдмрд╛рдпрд▓ рдорд╛рдЧреЗ, рд╕реЛрд░рд╕реЗрд░рд╕
ЁЯзЪ => ЁЯзЪ, рдУрдмреЗрд░реЙрди, рдЯрд┐рдЯрд╛рдиреАрдпрд╛, рдкрдХ, рдкрд░реА
ЁЯзЪтАНтЩВ => ЁЯзЪтАНтЩВ, рдСрдмреЗрд░реЙрди, рджрд╛рджрд▓реЛ рдкрд░реА, рдкрдХ
ЁЯзЪтАНтЩА => ЁЯзЪтАНтЩА, рдЯрд┐рдЯрд╛рдиреАрдпрд╛, рдмрд╛рдпрд▓ рдкрд░реА
ЁЯзЫ => ЁЯзЫ, рдбреНрд░реЕрдХреБрд▓рд╛, рдкрд┐рд╢рд╛рдЪреНрдЪ, рдорд░рдг рдпреЗрд╡рдВрдХ рдирд╛рд╢рд┐рд▓реНрд▓реЛ
ЁЯзЫтАНтЩВ => ЁЯзЫтАНтЩВ, рдбреНрд░реЕрдХреБрд▓рд╛, рджрд╛рджрд▓реЛ рдкрд┐рд╢рд╛рдЪреНрдЪ, рдорд░рдг рдпреЗрд╡рдВрдХ рдирд╛рд╢рд┐рд▓реНрд▓реЛ
ЁЯзЫтАНтЩА => ЁЯзЫтАНтЩА, рдмрд╛рдпрд▓ рдкрд┐рд╢рд╛рдЪреНрдЪ, рдорд░рдг рдпреЗрд╡рдВрдХ рдирд╛рд╢рд┐рд▓реНрд▓реА
ЁЯзЬ => ЁЯзЬ, рдЬрд▓рдкрд░рд╛, рдЬрд▓рдкрд░реА, рдЬрд▓рд╡реНрдпрдХреНрддреА, рдорддреНрд╕реНрдпрд╡реНрдпрдХреНрддреА
ЁЯзЬтАНтЩВ => ЁЯзЬтАНтЩВ, рдЯреНрд░рд╛рдпрдЯрди, рдорддреНрд╕реНрдпрджрд╛рджрд▓реЛ
ЁЯзЬтАНтЩА => ЁЯзЬтАНтЩА, рдорддреНрд╕реНрдпрдХрдиреНрдпрд╛, рдорддреНрд╕реНрдпрдмрд╛рдпрд▓
ЁЯзЭ => ЁЯзЭ, рдЬрд╛рджреБрдИ, рд╡рдирджреЗрд╡рддрд╛
ЁЯзЭтАНтЩВ => ЁЯзЭтАНтЩВ, рдЬрд╛рджреБрдИ, рд╡рдирджреЗрд╡
ЁЯзЭтАНтЩА => ЁЯзЭтАНтЩА, рдЬрд╛рджреБрдИ, рд╡рди рджреЗрд╡реА
ЁЯзЮ => ЁЯзЮ, рдЬрд┐рдиреА, рдЬреАрди
ЁЯзЮтАНтЩВ => ЁЯзЮтАНтЩВ, рдЬреАрди, рджрд╛рджрд▓реЛ рдЬрд┐рдиреА, рджрд╛рджрд▓реЛ рдЬреАрди
ЁЯзЮтАНтЩА => ЁЯзЮтАНтЩА, рдЬреАрди, рдмрд╛рдпрд▓ рдЬрд┐рдиреА
ЁЯзЯ => ЁЯзЯ, рдЭреЛрдореНрдмреА, рдорд░рдг рдпреЗрд╡рдВрдХ рдирд╛рд╢рд┐рд▓реНрд▓реЛ, рдореЗрд▓реНрд▓реЛ рдЪрд▓рддрд╛
ЁЯзЯтАНтЩВ => ЁЯзЯтАНтЩВ, рджрд╛рджрд▓реЛ рдЭреЛрдореНрдмреА, рдорд░рдг рдпреЗрд╡рдВрдХ рдирд╛рд╢рд┐рд▓реНрд▓реЛ, рдореЗрд▓реНрд▓реЛ рдЪрд▓рддрд╛
ЁЯзЯтАНтЩА => ЁЯзЯтАНтЩА, рдмрд╛рдпрд▓ рдЭреЛрдореНрдмреА, рдорд░рдг рдпреЗрд╡рдВрдХ рдирд╛рд╢рд┐рд▓реНрд▓реЛ, рдореЗрд▓реНрд▓реЛ рдЪрд▓рддрд╛
ЁЯТЖ => ЁЯТЖ, рдЪреЗрд░реЛ, рдорд╕рд╛рдЬ, рдорд╕рд╛рдЬ рдШреЗрд╡рдкреА рд╡реНрдпрдХреНрддреА, рд╕рд▓реЛрди
ЁЯТЖтАНтЩВ => ЁЯТЖтАНтЩВ, рдЪреЗрд░реЛ, рджрд╛рджрд▓реЛ, рдорд╕рд╛рдЬ, рдорд╕рд╛рдЬ рдШреЗрд╡рдкреА рджрд╛рджрд▓реЛ
ЁЯТЖтАНтЩА => ЁЯТЖтАНтЩА, рдЪреЗрд░реЛ, рдмрд╛рдпрд▓, рдорд╕рд╛рдЬ, рдорд╕рд╛рдЬ рдШреЗрд╡рдкреА рдмрд╛рдпрд▓
ЁЯТЗ => ЁЯТЗ, рдХреЗрдВрд╕ рдХрд╛рддрд░рдк, рдХреЗрдВрд╕ рдХрд╛рддрд░рдкреА рд╡реНрдпрдХреНрддреА, рдХреЗрдВрд╕ рдХрд╛рддрд░реВрди рдШреЗрд╡рдкреА рд╡реНрдпрдХреНрддреА, рдкрд╛рд░реНрд▓рд░, рдореНрд╣рд╛рд▓реЛ, рд╕реБрдВрджрд░рддрд╛рдп
ЁЯТЗтАНтЩВ => ЁЯТЗтАНтЩВ, рдХреЗрдВрд╕ рдХрд╛рддрд░рдк, рдХреЗрдВрд╕ рдХрд╛рддрд░реВрди рдШреЗрд╡рдкреА рджрд╛рджрд▓реЛ, рджрд╛рджрд▓реЛ
ЁЯТЗтАНтЩА => ЁЯТЗтАНтЩА, рдХреЗрдВрд╕ рдХрд╛рддрд░рдк, рдХреЗрдВрд╕ рдХрд╛рддрд░реВрди рдШреЗрд╡рдкреА рдмрд╛рдпрд▓, рдмрд╛рдпрд▓
ЁЯЪ╢ => ЁЯЪ╢, рдЪрдврдЯрд╛, рдЪрд▓рддрд╛, рдЪрд▓рдк, рд╡реНрдпрдХреНрддреА рдЪрд▓рддрд╛
ЁЯЪ╢тАНтЩВ => ЁЯЪ╢тАНтЩВ, рдЪрдврдЯрд╛, рдЪрд▓рддрд╛, рджрд╛рджрд▓реЛ
ЁЯЪ╢тАНтЩА => ЁЯЪ╢тАНтЩА, рдЪрдврдЯрд╛, рдЪрд▓рдк, рдмрд╛рдпрд▓, рдмрд╛рдпрд▓ рдЪрд▓рддрд╛
ЁЯзН => ЁЯзН, рдЙрдмреЛ, рдЙрдмреЛ рд░рд╛рд╡рдк, рд╡реНрдпрдХреНрддреА рдЙрдмреЛ рдЖрд╕рд╛
ЁЯзНтАНтЩВ => ЁЯзНтАНтЩВ, рдЙрдмреЛ рдЖрд╕рд╛, рджрд╛рджрд▓реЛ, рджрд╛рджрд▓реЛ рдЙрдмреЛ рдЖрд╕рд╛
ЁЯзНтАНтЩА => ЁЯзНтАНтЩА, рдЙрдмреА рдЖрд╕рд╛, рдмрд╛рдпрд▓, рдмрд╛рдпрд▓ рдЙрдмреА рдЖрд╕рд╛
ЁЯзО => ЁЯзО, рдзреЛрдВрдкрд░рд╛ рджреЛрдбреВрди, рдзреЛрдВрдкрд░рд╛рдВрдЪреЗрд░, рд╡реНрдпрдХреНрддреА рдзреЛрдВрдкрд░рд╛рдВ рджреЛрдбреВрди, рд╡реНрдпрдХреНрддреА рдзреЛрдВрдкрд░рд╛ рджреЛрдбреВрди рдмрд╕рд▓рд╛рдВ
ЁЯзОтАНтЩВ => ЁЯзОтАНтЩВ, рджрд╛рджрд▓реЛ, рджрд╛рджрд▓реЛ рдзреЛрдВрдкрд░рд╛ рджреЛрдбреВрди, рдзреЛрдВрдкрд░рд╛рдВ рджреЛрдбреВрди
ЁЯзОтАНтЩА => ЁЯзОтАНтЩА, рдзреЛрдВрдкрд░рд╛рдВ рджреЛрдбреВрди, рдмрд╛рдпрд▓, рдмрд╛рдпрд▓ рдзреЛрдВрдкрд░рд╛рдВ рджреЛрдбреВрди
ЁЯзСтАНЁЯжп => ЁЯзСтАНЁЯжп, рдЖрдзрд╛рд░рд╛рдЪреА рдмрдбреА рдШреЗрд╡рдВрди рд╡реНрдпрдХреНрддреА, рдНрдХреНрд╕реЕрд╕рд┐рдмрд┐рд▓рд┐рдЯреА, рдХреБрдбреНрдбреЗрдВ
ЁЯСитАНЁЯжп => ЁЯСитАНЁЯжп, рдЖрдзрд╛рд░рд╛рдЪреА рдмрдбреА рдШреЗрд╡рдВрди рджрд╛рджрд▓реЛ, рдНрдХреНрд╕реЕрд╕рд┐рдмрд┐рд▓рд┐рдЯреА, рдХреБрдбреНрдбреЛ, рджрд╛рджрд▓реЛ
ЁЯСйтАНЁЯжп => ЁЯСйтАНЁЯжп, рдЖрдзрд╛рд░рд╛рдЪреА рдмрдбреА рдШреЗрд╡рдВрди рдмрд╛рдпрд▓, рдНрдХреНрд╕реЕрд╕рд┐рдмрд┐рд▓рд┐рдЯреА, рдХреБрдбреНрдбреА, рдмрд╛рдпрд▓
ЁЯзСтАНЁЯж╝ => ЁЯзСтАНЁЯж╝, рдНрдХреНрд╕реЕрд╕рд┐рдмрд┐рд▓рд┐рдЯреА, рдореЛрдЯрд░ рдЖрд╕рдкреА рд╡реНрд╣рд┐рд▓рдЪреЕрд░рд╛рдЪреЗрд░ рд╡реНрдпрдХреНрддреА, рд╡реНрд╣рд┐рд▓рдЪреЕрд░
ЁЯСитАНЁЯж╝ => ЁЯСитАНЁЯж╝, рдНрдХреНрд╕реЕрд╕рд┐рдмрд┐рд▓рд┐рдЯреА, рджрд╛рджрд▓реЛ, рдореЛрдЯрд░ рдЖрд╕рдкреА рд╡реНрд╣рд┐рд▓рдЪреЕрд░рд╛рдЪреЗрд░ рджрд╛рджрд▓реЛ, рдореЛрдЯрд░ рдЖрд╕рдкреА рд╡реНрд╣реАрд▓рдЪреЕрд░рд╛рдЪреЗрд░ рджрд╛рджрд▓реЛ, рд╡реНрд╣реАрд▓рдЪреЕрд░
ЁЯСйтАНЁЯж╝ => ЁЯСйтАНЁЯж╝, рдНрдХреНрд╕реЕрд╕рд┐рдмрд┐рд▓рд┐рдЯреА, рдмрд╛рдпрд▓, рдореЛрдЯрд░ рдЖрд╕рдкреА рд╡реНрд╣рд┐рд▓рдЪреЕрд░рд╛рдЪреЗрд░ рдмрд╛рдпрд▓, рд╡реНрд╣рд┐рд▓рдЪреЕрд░
ЁЯзСтАНЁЯж╜ => ЁЯзСтАНЁЯж╜, рдНрдХреНрд╕реЕрд╕рд┐рдмрд┐рд▓рд┐рдЯреА, рдореЕрдиреНрдпреБрдЕрд▓ рд╡реНрд╣рд┐рд▓рдЪреЕрд░рд╛рдЪреЗрд░ рд╡реНрдпрдХреНрддреА, рд╡реНрд╣реАрд▓рдЪреЕрд░
ЁЯСитАНЁЯж╜ => ЁЯСитАНЁЯж╜, рдНрдХреНрд╕реЕрд╕рд┐рдмрд┐рд▓рд┐рдЯреА, рджрд╛рджрд▓реЛ, рдореЕрдиреНрдпреБрдЕрд▓ рд╡реНрд╣рд┐рд▓рдЪреЕрд░рд╛рдЪреЗрд░ рджрд╛рджрд▓реЛ, рд╡реНрд╣рд┐рд▓рдЪреЕрд░
ЁЯСйтАНЁЯж╜ => ЁЯСйтАНЁЯж╜, рдНрдХреНрд╕реЕрд╕рд┐рдмрд┐рд▓рд┐рдЯреА, рдмрд╛рдпрд▓, рдореЕрдиреНрдпреБрдЕрд▓ рд╡реНрд╣рд┐рд▓рдЪреЕрд░рд╛рдЪреЗрд░ рдмрд╛рдпрд▓, рд╡реНрд╣рд┐рд▓рдЪреЕрд░
ЁЯПГ => ЁЯПГ, рдзрд╛рдВрд╡рддрд╛, рдореЕрд░рд╛рдереЙрди, рд╡реНрдпрдХреНрддреА рдзрд╛рдВрд╡рддрд╛
ЁЯПГтАНтЩВ => ЁЯПГтАНтЩВ, рджрд╛рджрд▓реЛ, рдзрд╛рдВрд╡рддрд╛, рдореЕрд░рд╛рдереЙрди, рд╕реНрдкрд░реНрдзрд╛
ЁЯПГтАНтЩА => ЁЯПГтАНтЩА, рдзрд╛рдВрд╡рддрд╛, рдмрд╛рдпрд▓, рдореЕрд░рд╛рдереЙрди, рд╕реНрдкрд░реНрдзрд╛
ЁЯТГ => ЁЯТГ, рдирд╛рдЪрддрд╛, рдмрд╛рдпрд▓
ЁЯХ║ => ЁЯХ║, рджрд╛рджрд▓реЛ, рджрд╛рджрд▓реЛ рдирд╛рдЪрддрд╛, рдирд╛рдЪ
ЁЯХ┤ => ЁЯХ┤, рджрд╛рджрд▓реЛ, рд╡реЗрд╡рд╕рд╛рдп, рд╕реБрдЯрд╛рдВрддрд▓реЛ рджрд╛рджрд▓реЛ рдЙрдмреЛ рдЖрд╕рд╛, рд╕реБрдЯрд╛рдВрддрд▓реЛ рд╡реНрдпрдХреНрддреА рдЙрдмреЛ рдЖрд╕рд╛, рд╕реВрдЯ
ЁЯСп => ЁЯСп, рдирд╛рдЪрдкреА, рдкрд╛рд░реНрдЯреА рдХрд░рдкреА, рд╕рд╢рд╛ рдХрд╛рди, рд╕рд╢рд╛ рдХрд╛рдирд╛рдЪреЗ рд▓реЛрдХ, рд╕рд╢реНрдпрд╛ рдХрд╛рдирд╛рдЪреЗ рд▓реЛрдХ
ЁЯСптАНтЩВ => ЁЯСптАНтЩВ, рджрд╛рджрд▓реЛ, рдирд╛рдЪрдкреА, рдкрд╛рд░реНрдЯреА рдХрд░рддрд╛рдд, рд╕рд╢рд╛ рдХрд╛рди, рд╕рд╢реНрдпрд╛ рдХрд╛рдирд╛рдЪреЗ рджрд╛рджрд▓реЗ, рд╕рд╢реНрдпрд╛ рдХрд╛рдирд╛рдВрдЪреЗ рджрд╛рджрд▓реЗ
ЁЯСптАНтЩА => ЁЯСптАНтЩА, рдирд╛рдЪрдкреА, рдкрд╛рд░реНрдЯреА рдХрд░рддрд╛, рдмрд╛рдпрд▓, рд╕рд╢реНрдпрд╛ рдХрд╛рди, рд╕рд╢реНрдпрд╛ рдХрд╛рдирд╛рдЪреА рдмрд╛рдпрд▓, рд╕рд╢реНрдпрд╛ рдХрд╛рдирд╛рдВрдЪреНрдпреЛ рдмрд╛рдпрд▓реЛ
ЁЯзЦ => ЁЯзЦ, рд╡рд╛рдлреЗрдЪреА рдХреВрдб, рд╡рд╛рдлреЗрдЪреНрдпрд╛ рдХреБрдбреАрдд рд╡реНрдпрдХреНрддреА, рд╡рд╛рдлреЗрдЪреНрдпрд╛ рдХреБрдбреАрдВрдд рд╡реНрдпрдХреНрддреА, рд╕реМрдирд╛
ЁЯзЦтАНтЩВ => ЁЯзЦтАНтЩВ, рд╡рд╛рдлреЗрдЪреА рдХреВрдб, рд╡рд╛рдлреЗрдЪреНрдпрд╛ рдХреБрдбреАрддрд▓реЛ рджрд╛рджрд▓реЛ, рд╕реМрдирд╛
ЁЯзЦтАНтЩА => ЁЯзЦтАНтЩА, рд╡рд╛рдлреЗрдЪреА рдХреБрдб, рд╡рд╛рдлреЗрдЪреНрдпрд╛ рдХреБрдбреАрддрд▓реА рдмрд╛рдпрд▓, рд╕реМрдирд╛
ЁЯзЧ => ЁЯзЧ, рдЪрдврдкреА, рдЪрдврдкреА рд╡реНрдпрдХреНрддреА
ЁЯзЧтАНтЩВ => ЁЯзЧтАНтЩВ, рдЪрдврдкреА, рджрд╛рджрд▓реЛ рдЪрдврдЯрд╛
ЁЯзЧтАНтЩА => ЁЯзЧтАНтЩА, рдЪрдврдкреА, рдмрд╛рдпрд▓ рдЪрдврдЯрд╛
ЁЯд║ => ЁЯд║, рддрд▓рд╡рд╛рд░, рддрд▓рд╡рд╛рд░ рдЪрд▓рдпрддрд╛, рддрд▓рд╡рд╛рд░ рдЪрд▓реЛрд╡рдкреА, рд╡реНрдпрдХреНрддреА рддрд▓рд╡рд╛рд░ рдЪрд▓рдпрддрд╛
ЁЯПЗ => ЁЯПЗ, рдШреЛрдбреЛ, рдШреЛрдбреНрдпрд╛рдЪреА рд╕реНрдкрд░реНрдзрд╛, рдЬреЙрдХреА, рд╕реНрдкрд░реНрдзрд╛, рд╕реНрдкрд░реНрдзреЗрддрд▓реЛ рдШреЛрдбреЛ
тЫ╖ => тЫ╖, рдмрд░реНрдл, рд╕реНрдХрд╛, рд╕реНрдХрд╛рдпрд░
ЁЯПВ => ЁЯПВ, рдмрд░реНрдл, рд╕реНрдХрд╛, рд╕реНрдиреЛрдмреЙрд░реНрдбрд░, рд╕реНрдиреЛрдмреЛрд░реНрдб
ЁЯПМ => ЁЯПМ, рдЧреЛрд▓реНрдл, рдмреЙрд▓, рд╡реНрдпрдХреНрддреА рдЧреЛрд▓реНрдл рдЦреЗрд│рдЯрд╛
ЁЯПМтАНтЩВ => ЁЯПМтАНтЩВ, рдЧреЛрд▓реНрдл, рджрд╛рджрд▓реЛ, рджрд╛рджрд▓реЛ рдЧреЛрд▓реНрдл рдЦреЗрд│рдЯрд╛
ЁЯПМтАНтЩА => ЁЯПМтАНтЩА, рдЧреЛрд▓реНрдл, рдмрд╛рдпрд▓, рдмрд╛рдпрд▓ рдЧреЛрд▓реНрдл рдЦреЗрд│рдЯрд╛
ЁЯПД => ЁЯПД, рд╡реНрдпрдХреНрддреА рд╕рд░реНрдл рдХрд░рддрд╛, рд╕рд░реНрдл рдХрд░рддрд╛
ЁЯПДтАНтЩВ => ЁЯПДтАНтЩВ, рджрд╛рджрд▓реЛ, рджрд╛рджрд▓реЛ рд╕рд░реНрдл рдХрд░рддрд╛, рд╕рд░реНрдл рдХрд░рддрд╛
ЁЯПДтАНтЩА => ЁЯПДтАНтЩА, рдмрд╛рдпрд▓, рдмрд╛рдпрд▓ рд╕рд░реНрдл рдХрд░рддрд╛, рд╕рд░реНрдл рдХрд░рддрд╛
ЁЯЪг => ЁЯЪг, рдмреЛрдЯ, рдмреЛрдЯ рд╡реНрд╣рд▓реЛрд╡рдк, рдмреЛрдЯ рд╡реНрд╣рд▓реЛрд╡рдкреА рд╡реНрдпрдХреНрддреА, рд╡реНрдпрдХреНрддреА рдмреЛрдЯ рд╡реНрд╣рд▓рдпрддрд╛
ЁЯЪгтАНтЩВ => ЁЯЪгтАНтЩВ, рджрд╛рджрд▓реЛ, рджрд╛рджрд▓реЛ рдмреЛрдЯ рд╡реНрд╣рд▓рдпрддрд╛, рдмреЛрдЯ, рдмреЛрдЯ рд╡реНрд╣рд▓рдпрддрд╛
ЁЯЪгтАНтЩА => ЁЯЪгтАНтЩА, рдмрд╛рдпрд▓, рдмрд╛рдпрд▓ рдмреЛрдЯ рд╡реНрд╣рд▓рдпрддрд╛, рдмрд╛рдпрд▓реЛ рдмреЛрдЯ рд╡реНрд╣рд▓рдпрддрд╛, рдмреЛрдЯ, рдмреЛрдЯ рд╡реНрд╣рд▓рдпрддрд╛
ЁЯПК => ЁЯПК, рдкреЗрдВрд╡рдк, рд╡реНрдпрдХреНрддреА рдкреЗрдВрд╡рддрд╛
ЁЯПКтАНтЩВ => ЁЯПКтАНтЩВ, рджрд╛рджрд▓реЛ, рджрд╛рджрд▓реЛ рдкреЗрдВрд╡рддрд╛, рдкреЗрдВрд╡рдк
ЁЯПКтАНтЩА => ЁЯПКтАНтЩА, рдкреЗрдВрд╡рдк, рдмрд╛рдпрд▓, рдмрд╛рдпрд▓ рдкреЗрдВрд╡рддрд╛
тЫ╣ => тЫ╣, рдмреЙрд▓, рд╡реНрдпрдХреНрддреА рдмреЙрд▓ рдмрд╛рд╡рдВрд╕ рдХрд░рддрд╛, рд╡реНрдпрдХреНрддреА рдмреЙрд▓ рдмрд╛рд╡рд╕рд┐рдВрдЧ рдХрд░рддрд╛
тЫ╣тАНтЩВ => тЫ╣тАНтЩВ, рджрд╛рджрд▓реЛ, рджрд╛рджрд▓реЛ рдмреЙрд▓ рдмрд╛рд╡рдВрд╕ рдХрд░рддрд╛, рдмреЙрд▓
тЫ╣тАНтЩА => тЫ╣тАНтЩА, рдмрд╛рдпрд▓, рдмрд╛рдпрд▓ рдмреЙрд▓ рдмрд╛рд╡рдВрд╕ рдХрд░рддрд╛, рдмреЙрд▓
ЁЯПЛ => ЁЯПЛ, рдЙрдЦрд▓рдкреА, рд╡рдЬрди, рд╡реНрдпрдХреНрддреА рд╡рдЬрди рдЙрдЦрд▓рддрд╛, рд╡реНрдпрдХреНрддреА рд╡рдЬрдирд╛рдВ рдЙрдЦрд▓рддрд╛
ЁЯПЛтАНтЩВ => ЁЯПЛтАНтЩВ, рджрд╛рджрд▓реЛ, рджрд╛рджрд▓реЛ рд╡рдЬрдирд╛ рдЙрдЦрд▓рддрд╛, рджрд╛рджрд▓реЛ рд╡рдЬрдирд╛рдВ рдЙрдЦрд▓рддрд╛, рд╡рдЬрди рдЙрдЦрд▓рдкреА
ЁЯПЛтАНтЩА => ЁЯПЛтАНтЩА, рдмрд╛рдпрд▓, рдмрд╛рдпрд▓ рд╡рдЬрди рдЙрдЦрд▓рддрд╛, рдмрд╛рдпрд▓ рд╡рдЬрдирд╛рдВ рдЙрдЦрд▓рддрд╛, рд╡рдЬрди рдЙрдЦрд▓рдкреА
ЁЯЪ┤ => ЁЯЪ┤, рдмрд╛рдпрдХ рдЪрд▓рдпрддрд╛, рдмрд╛рдпрд╕рд┐рдХрд▓, рд╡реНрдпрдХреНрддреА рдмрд╛рдпрдХ рдЪрд▓рдпрддрд╛, рд╕рд╛рдпрдХрд▓ рдЪрд▓рдпрддрд╛
ЁЯЪ┤тАНтЩВ => ЁЯЪ┤тАНтЩВ, рджрд╛рджрд▓реЛ, рджрд╛рджрд▓реЛ рдмрд╛рдпрдХ рдЪрд▓рдпрддрд╛, рдмрд╛рдпрдХ рдЪрд▓рдпрддрд╛, рдмрд╛рдпрд╕рд┐рдХрд▓
ЁЯЪ┤тАНтЩА => ЁЯЪ┤тАНтЩА, рдмрд╛рдпрдХ рдЪрд▓рдпрддрд╛, рдмрд╛рдпрд▓, рдмрд╛рдпрд▓ рдмрд╛рдпрдХ рдЪрд▓рдпрддрд╛, рдмрд╛рдпрд╕рд┐рдХрд▓, рд╕рд╛рдпрдХрд▓ рдЪрд▓рдпрддрд╛
ЁЯЪ╡ => ЁЯЪ╡, рдкрд░реНрд╡рдд, рдмрд╛рдпрдХ, рдмрд╛рдпрд╕рд┐рдХрд▓, рдмрд╛рдпрд╕рд┐рдХрд▓ рдЪрд▓реЛрд╡рдкреА, рд╡реНрдпрдХреНрддреА рдкрд░реНрд╡рддрд╛рдЪреЗрд░ рдмрд╛рдпрдХ рдЪрд▓рдпрддрд╛, рд╕рд╛рдпрдХрд▓рд╕реНрд╡рд╛рд░
ЁЯЪ╡тАНтЩВ => ЁЯЪ╡тАНтЩВ, рджрд╛рджрд▓реЛ, рджрд╛рджрд▓реЛ рдкрд░реНрд╡рддрд╛рдЪреЗрд░ рдмрд╛рдпрдХ рдЪрд▓рдпрддрд╛, рдкрд░реНрд╡рдд, рдмрд╛рдпрдХ, рдмрд╛рдпрд╕рд┐рдХрд▓, рд╕рд╛рдпрдХрд▓рд╕реНрд╡рд╛рд░
ЁЯЪ╡тАНтЩА => ЁЯЪ╡тАНтЩА, рдкрд░реНрд╡рдд, рдмрд╛рдпрдХ, рдмрд╛рдпрдХ рдЪрд▓реЛрд╡рдк, рдмрд╛рдпрд▓, рдмрд╛рдпрд▓ рдкрд░реНрд╡рддрд╛рдЪреЗрд░ рдмрд╛рдпрдХ рдЪрд▓рдпрддрд╛, рдмрд╛рдпрд╕рд┐рдХрд▓, рд╕рд╛рдпрдХрд▓рд╕реНрд╡рд╛рд░
ЁЯд╕ => ЁЯд╕, рдЬрд┐рдореНрдиреЗрд╕реНрдЯрд┐рдХреНрд╕, рдмреИрд▓рдЧрд╛рдбрдпреЗрдЪреЗрдВ рдЪрд╛рдХ, рд╡реНрдпрдХреНрддреА рдЪрд╛рдХрд╛ рднрд╢реЗрди рдШреБрдВрд╡рддрд╛, рд╡реНрдпрдХреНрддреА рдмреИрд▓рдЧрд╛рдбрдпреЗрдЪреНрдпрд╛ рдЪрд╛рдХрд╛рднрд╢реЗрди рдШреБрдВрд╡рддрд╛
ЁЯд╕тАНтЩВ => ЁЯд╕тАНтЩВ, рдЬрд┐рдореНрдиреЗрд╕реНрдЯрд┐рдХреНрд╕, рджрд╛рджрд▓реЛ, рджрд╛рджрд▓реЛ рдмреИрд▓рдЧрд╛рдбрдпреЗрдЪреНрдпрд╛ рдЪрд╛рдХрд╛рднрд╢реЗрди рдШреБрдВрд╡рддрд╛, рдмреИрд▓рдЧрд╛рдбрдпреЗрдЪреЗрдВ рдЪрд╛рдХ
ЁЯд╕тАНтЩА => ЁЯд╕тАНтЩА, рдЬрд┐рдореНрдиреЗрд╕реНрдЯрд┐рдХреНрд╕, рдмрд╛рдпрд▓, рдмрд╛рдпрд▓ рдмреИрд▓рдЧрд╛рдбрдпреЗрдЪреНрдпрд╛ рдЪрд╛рдХрд╛рднрд╢реЗрди рдШреБрдВрд╡рддрд╛, рдмреИрд▓рдЧрд╛рдбрдпреЗрдЪреЗрдВ рдЪрд╛рдХ
ЁЯд╝ => ЁЯд╝, рдорд▓реНрд▓, рдорд▓реНрд▓рдпреБрдзреНрдж, рд▓реЛрдХ рдорд▓реНрд▓рдпреБрдзреНрдж рдХрд░рддрд╛рдд
ЁЯд╝тАНтЩВ => ЁЯд╝тАНтЩВ, рджрд╛рджрд▓реЛ, рджрд╛рджрд▓реЛ рдорд▓реНрд▓рдпреБрдзреНрдж, рджрд╛рджрд▓реНрдпрд╛рдВрдЪреЗрдВ рд░реЗрд╕рд▓рд┐рдВрдЧ, рдорд▓реНрд▓
ЁЯд╝тАНтЩА => ЁЯд╝тАНтЩА, рдмрд╛рдпрд▓, рдмрд╛рдпрд▓ рдорд▓реНрд▓рдпреБрдзреНрдж, рдорд▓реНрд▓
ЁЯд╜ => ЁЯд╜, рдЙрджрдХ, рдкреЛрд▓реЛ, рд╡реНрдпрдХреНрддреА рдЙрджрдХрд╛рдд рдкреЛрд▓реЛ рдЦреЗрд│рдЯрд╛, рд╡реНрдпрдХреНрддреА рдЙрджрдХрд╛рдВрдд рдкреЛрд▓реЛ рдЦреЗрд│рдЯрд╛
ЁЯд╜тАНтЩВ => ЁЯд╜тАНтЩВ, рдЙрджрдХ рдкреЛрд▓реЛ, рджрд╛рджрд▓реЛ, рджрд╛рджрд▓реЛ рдЙрджрдХрд╛рдд рдкреЛрд▓реЛ рдЦреЗрд│рдЯрд╛
ЁЯд╜тАНтЩА => ЁЯд╜тАНтЩА, рдЙрджрдХ рдкреЛрд▓реЛ, рдмрд╛рдпрд▓, рдмрд╛рдпрд▓ рдЙрджрдХ рдкреЛрд▓реЛ рдЦреЗрд│рдЯрд╛, рдмрд╛рдпрд▓ рдЙрджрдХрд╛рдд рдкреЛрд▓реЛ рдЦреЗрд│рдЯрд╛
ЁЯд╛ => ЁЯд╛, рдмреЙрд▓, рд╡реНрдпрдХреНрддреА рд╣рдБрдбрдмреЙрд▓ рдЦреЗрд│рдЯрд╛, рд╣рдБрдбрдмреЙрд▓, рд╣рдБрдбрдмреЙрд▓ рдЦреЗрд│рдкреА рд╡реНрдпрдХреНрддреА
ЁЯд╛тАНтЩВ => ЁЯд╛тАНтЩВ, рджрд╛рджрд▓реЛ, рджрд╛рджрд▓реЛ рд╣рдБрдбрдмреЙрд▓ рдЦреЗрд│рдЯрд╛, рд╣рдБрдбрдмреЙрд▓
ЁЯд╛тАНтЩА => ЁЯд╛тАНтЩА, рдмрд╛рдпрд▓, рдмрд╛рдпрд▓ рд╣рдБрдбрдмреЙрд▓ рдЦреЗрд│рдЯрд╛, рд╣рдБрдбрдмреЙрд▓
ЁЯд╣ => ЁЯд╣, рдХреМрд╢рд▓реНрдп, рдЬрдЧрд▓, рднреЛрд╡рдХрд╛рд░реНрдпрд╛рдВ, рд╡реНрдпрдХреНрддреА рдЬрдЧрд▓рд┐рдВрдЧ рдХрд░рддрд╛, рд╕рдорддреЛрд▓
ЁЯд╣тАНтЩВ => ЁЯд╣тАНтЩВ, рдЬрдЧрд▓рд┐рдВрдЧ, рджрд╛рджрд▓реЛ, рджрд╛рджрд▓реЛ рдЬрдЧрд▓рд┐рдВрдЧ рдХрд░рддрд╛, рднреЛрд╡рдХрд╛рд░реНрдп
ЁЯд╣тАНтЩА => ЁЯд╣тАНтЩА, рдЬрдЧрд▓рд┐рдВрдЧ, рдмрд╛рдпрд▓, рднреЛрд╡рдХрд╛рд░реНрдп
ЁЯзШ => ЁЯзШ, рдХрдорд│рд╛рдЪреНрдпрд╛ рд╕реНрдерд┐рддреАрдВрдд рдмрд╢рд┐рд▓реНрд▓реЛ рд╡реНрдпрдХреНрддреА, рдпреЛрдЧрд╛, рд╕рд╛рдзрдирд╛
ЁЯзШтАНтЩВ => ЁЯзШтАНтЩВ, рдХрдорд│рд╛рдЪреНрдпрд╛ рд╕реНрдерд┐рддреАрдВрдд рдмрд╢рд┐рд▓реНрд▓реЛ рджрд╛рджрд▓реЛ, рдпреЛрдЧрд╛, рд╕рд╛рдзрдирд╛
ЁЯзШтАНтЩА => ЁЯзШтАНтЩА, рдХрдорд│рд╛рдЪреНрдпрд╛ рд╕реНрдерд┐рддреАрдВрдд рдмрд╢рд┐рд▓реНрд▓реА рдмрд╛рдпрд▓, рдпреЛрдЧрд╛, рд╕рд╛рдзрдирд╛
ЁЯЫА => ЁЯЫА, рдиреНрд╣рд╛рдг, рдиреНрд╣рд╛рдг рдШреЗрд╡рдкреА рд╡реНрдпрдХреНрддреА, рдиреНрд╣рд╛рдгреАрдЪреЗрдВрдЯрдм, рдиреНрд╣рд╛рд╡рдкреА рд╡реНрдпрдХреНрддреА
ЁЯЫМ => ЁЯЫМ, рдЦрд╛рдЯреАрдЪреЗрд░ рдиреНрд╣рд┐рджрд┐рд▓реНрд▓реЛ рд╡реНрдпрдХреНрддреА, рдиреНрд╣реАрдж, рд╣реЙрдЯреЗрд▓
ЁЯзСтАНЁЯдЭтАНЁЯзС => ЁЯзСтАНЁЯдЭтАНЁЯзС, рдПрдХрдореЗрдХрд╛рдВрдЪреЗ рд╣рд╛рдд рдзрд░рд┐рд▓реНрд▓реЗ рд▓реЛрдХ, рдЬреЛрдбрдкреЗрдВ, рдзрд░рдк, рд╡реНрдпрдХреНрддреА, рд╣рд╛рдд
ЁЯСн => ЁЯСн, рдПрдХрдореЗрдХрд╛рдВрдЪреЗрдВ рд╣рд╛рдд рдзрд░рдк, рдПрдХрдореЗрдХрд╛рдВрдЪреЗ рд╣рд╛рдд рдзрд░рд┐рд▓реНрд▓реНрдпреЛ рдмрд╛рдпрд▓реЛ, рдПрдХрдореЗрдХрд╛рдВрдЪреЛ рд╣рд╛рдд рдзрд░рд┐рд▓реНрд▓реНрдпреЛ рдмрд╛рдпрд▓реЛ, рдЬреЛрдбрдкреЗрдВ, рдмрд╛рдпрд▓реЛ, рд╣рд╛рдд
ЁЯСл => ЁЯСл, рдЬреЛрдбрдкреЗрдВ, рджрд╛рджрд▓реЛ, рдзрд░рдк, рдмрд╛рдпрд▓, рдмрд╛рдпрд▓ рдЖрдиреА рджрд╛рджрд▓реЛ рдПрдХрдореЗрдХрд╛рдВрдЪреЗ рд╣рд╛рдд рдзрд░реВрди, рдмрд╛рдпрд▓реЛ рдЖрдиреА рджрд╛рджрд▓реЗ рд╣рд╛рдд рдзрд░реВрди, рд╣рд╛рдд
ЁЯСм => ЁЯСм, рдЬреБрд╡рд│реАрдВ, рдЬреЛрдбрдкреЗрдВред рдорд┐рдереБрдиред рдПрдХрдореЗрдХрд╛рдВрдЪреЗ рд╣рд╛рдд рдзрд░рд▓реНрдпрд╛рддред рджрд╛рджрд▓реЛ, рджрд╛рджрд▓реЗ, рджрд╛рджрд▓реЗ рдПрдХрдореЗрдХрд╛рдВрдЪреЗ рд╣рд╛рдд рдзрд░реВрди, рджрд╛рджрд▓реНрдпрд╛рдВрдиреА рдПрдХрдореЗрдХрд╛рдВрдЪреЗ рд╣рд╛рдд рдзрд░рд▓реНрдпрд╛рдд, рд░рд╛рд╕
ЁЯТП => ЁЯТП, рдЙрдореЛ, рдЬреЛрдбрдкреЗрдВ
ЁЯТС => ЁЯТС, рдХрд╛рд│реАрдЬ рдЖрд╕рдкреА рдЬреЛрдбрдкреЗрдВ, рдЬреЛрдбрдкреЗрдВ, рдореЛрдЧ
ЁЯСк => ЁЯСк, рдХреБрдЯреБрдВрдм
ЁЯЧг => ЁЯЧг, рдЙрд▓рдпрддрд╛, рдЙрд▓реЛрд╡рдЪреЗрдВ, рдЙрд▓реЛрд╡рдкреА рддрдХрд▓реА, рдХрд╛рд│реА рдЖрдХреГрддреА, рдЪреЗрд░реЛ, рддрдХрд▓реА
ЁЯСд => ЁЯСд, рдЖрдХреГрддреА, рдХрд╛рд│реА
ЁЯСе => ЁЯСе, рдЖрдХреГрддреА, рдХрд╛рд│реА, рдХрд╛рд│реА рдЖрдХреГрддреА реи
ЁЯлВ => ЁЯлВ, рдЧреВрдбрдмрд╛рдп, рджреЗрд╡ рдмрд░реЗрдВ рдХрд░реВрдВ, рд▓реЛрдХ рд╡реЗрдВрдЧ рдорд╛рд░рддрд╛рдд, рд╡реЗрдВрдЧ рдорд╛рд░рдк, рд╣реЕрд▓реЛ
ЁЯСг => ЁЯСг, рдХрдкрдбреЗ, рдард╕реЛ, рдкрд╛рдВрдпрд╛рдЪреЗ рдЫрд╛рдк, рдкрд╛рдпрд╛рдЪреЗрдард╢реЗ, рдкрд╛рдпрд╛рдЪреЛрдард╕реЛ
ЁЯж░ => ЁЯж░, рдЖрд▓реЗрдВ, рддрд╛рдВрдмрдбреАрддрдХрд▓реА, рддрд╛рдВрдмрдбреЗ рдХреЗрд╕
ЁЯж▒ => ЁЯж▒, рдЖрдлреНрд░реЛ, рдХреБрд░рд│реЗ, рдХреБрд░рд│реЗ рдХреЗрд╕, рдХреБрд░рд│реЗ рдХреЗрдВрд╕, рд░рд┐рдВрдЧрд▓реЗрдЯреНрд╕
ЁЯж│ => ЁЯж│, рдХреЗрдВрд╕, рдЬрд╛рдгреНрдЯреЗрдВ, рдзрд╡реЗрдВ, рдзрд╡реЗ рдХреЗрдВрд╕, рдкрд┐рдВрдЧрдЯ
ЁЯж▓ => ЁЯж▓, рдХреЕрдореЛрдереЕрд░реЕрдкреА, рдХреЗрдВрд╕ рдирд╛, рдХреЗрдВрд╕рдирд╛рд╢рд┐рд▓реНрд▓реЛ, рддрдХрд▓реЛ, рддреБрд│рддреБрд│реАрдд
ЁЯР╡ => ЁЯР╡, рдЪреЗрд░реЛ, рдорд╛рдХрдбрд╛рдЪреЛ рдЪреЗрд░реЛ, рдорд╛рдХреЛрдб
ЁЯРТ => ЁЯРТ, рдорд╛рдХреЛрдб
ЁЯжН => ЁЯжН, рдЧреЛрд░рд┐рд▓рд╛
ЁЯжз => ЁЯжз, рдРрдк, рдУрд░рдВрдЧреБрдЯрди
ЁЯР╢ => ЁЯР╢, рдХреБрддреНрд░реЛ, рдХреБрддреНрд░реНрдпрд╛рдЪреЛ рдЪреЗрд░реЛ, рдЪреЗрд░реЛ, рдкрд╛рд│реАрд╡
ЁЯРХ => ЁЯРХ, рдХреБрддреНрд░реЛ, рдкрд╛рд│реАрд╡
ЁЯжо => ЁЯжо, рдНрдХреНрд╕реЕрд╕рд┐рдмрд┐рд▓рд┐рдЯреА, рдХреБрдбреНрдбреЗрдкрдг, рдХреБрддреНрд░реНрдпрд╛рдХ рдорд╛рд░реНрдЧрджрд░реНрд╢рди, рдорд╛рд░реНрдЧрджрд░реНрд╢рди, рдорд╛рд░реНрдЧрджрд░реНрд╢рди рдХреБрддреНрд░реЛ
ЁЯРХтАНЁЯж║ => ЁЯРХтАНЁЯж║, рдНрдХреНрд╕реЕрд╕рд┐рдмрд┐рд▓рд┐рдЯреА, рдХреБрддреНрд░реЛ, рд╕рд╣рд╛рдпреНрдп, рд╕реЗрд╡рд╛
ЁЯРй => ЁЯРй, рдХреБрддреНрд░реЛ, рдкреБрдбрд▓
ЁЯР║ => ЁЯР║, рдЪреЗрд░реЛ, рд▓рд╛рдВрдбрдЧреЛ
ЁЯжК => ЁЯжК, рдХреЛрд▓реЛ, рдЪреЗрд░реЛ
ЁЯжЭ => ЁЯжЭ, рдЙрддреНрд╕реБрдХ, рдХрд╛рд╡реЗрдмрд╛рдЬ, рд░реЕрдХреВрди
ЁЯР▒ => ЁЯР▒, рдЪреЗрд░реЛ, рдкрд╛рд│реАрд╡, рдорд╛рдЬрд░, рдорд╛рдЬрд░рд╛ рдЪреЗрд░реЛ
ЁЯРИ => ЁЯРИ, рдкрд╛рд│реАрд╡, рдорд╛рдЬрд░
ЁЯРИтАНтмЫ => ЁЯРИтАНтмЫ, рдХрд╛рд│реЗрдВ ред рдорд╛рдЬрд░ред рджреБрд░реНрджреИрд╡реА, рдХрд╛рд│реЗрдВ рдорд╛рдЬрд░
ЁЯжБ => ЁЯжБ, рдЪреЗрд░реЛ, рд░рд╛рд╕, рд╢рд┐рдВрд╡, рд╢реАрдВрд╡
ЁЯРп => ЁЯРп, рдЪреЗрд░реЛ, рд╡рд╛рдШ, рд╡рд╛рдШрд╛рдЪреЛ рдЪреЗрд░реЛ
ЁЯРЕ => ЁЯРЕ, рд╡рд╛рдШ
ЁЯРЖ => ЁЯРЖ, рдмрд┐рдмрдЯреЛ
ЁЯР┤ => ЁЯР┤, рдШреЛрдбреЛ, рдШреЛрдбреНрдпрд╛ рдЪреЗрд░реЛ, рдЪреЗрд░реЛ
ЁЯРО => ЁЯРО, рдШреЛрдбреЛ, рдШреЛрдбреНрдпрд╛рд░ рдмрд╕рдк, рд╢рд░реНрдпрдд, рд╢рд░реНрдпрддреАрдЪреЛрдШреЛрдбреЛ
ЁЯжД => ЁЯжД, рдПрдХрд╢рд┐рдВрдЧреА, рдЪреЗрд░реЛ
ЁЯжУ => ЁЯжУ, рдЭреЗрдмреНрд░рд╛, рдкрдЯреНрдЯреЗ
ЁЯжМ => ЁЯжМ, рд╣рд░рдг
ЁЯжм => ЁЯжм, рдЧрд╡реЛ рд░реЗрдбреЛ, рдЧрд╡реЛ рд░реЗрдбреЛред рдореНрд╣рд╕ред рд░рд╛рдЦрдгреЛред рдЧрд╡реЛ
ЁЯРо => ЁЯРо, рдЧрд╛рдп, рдЧрд╛рдпреЗ рдЪреЗрд░реЛ, рдЪреЗрд░реЛ
ЁЯРВ => ЁЯРВ, рдкрд╛рдбреЛ, рдмреИрд▓, рд░рд╛рд╕, рд╡реГрд╖рдн
ЁЯРГ => ЁЯРГ, рдЙрджрдХ, рдореНрд╣рд╕
ЁЯРД => ЁЯРД, рдЧрд╛рдп
ЁЯР╖ => ЁЯР╖, рдЪреЗрд░реЛ, рджреБрдХрд░, рджреБрдХрд░рд╛ рдЪреЗрд░реЛ
ЁЯРЦ => ЁЯРЦ, рджреБрдХрд░, рджреБрдХрд░реАрдг
ЁЯРЧ => ЁЯРЧ, рдШрд░рджреБрдХрд░, рд░рд╛рдирджреБрдХрд░
ЁЯР╜ => ЁЯР╜, рдЪреЗрд░реЛ, рджреБрдХрд░, рджреБрдХрд░рд╛ рдирд╛рдХ, рдирд╛рдХ
ЁЯРП => ЁЯРП, рджрд╛рджрд▓реЛ, рдореЗрдВрдвреА, рдореЗрдВрдвреЛ, рдореЗрд╖, рд░рд╛рд╕
ЁЯРС => ЁЯРС, рдмрд╛рдпрд▓, рдореЗрдВрдврд░реБрдВ, рдореЗрдВрдвреА
ЁЯРР => ЁЯРР, рдмреЛрдХрдбреА, рдордХрд░, рд░рд╛рд╕
ЁЯРк => ЁЯРк, рдЙрдВрдЯ, рдбреНрд░реЛрдордбреЗрд░реА, рдорджрд╛рд░
ЁЯРл => ЁЯРл, рдЙрдВрдЯ, рджреЛрди рдорджрд╛рд░реАрдВрдЪреЛ рдЙрдВрдЯ, рдмреЕрдХреНрдЯреЗрд░рд┐рдпрди, рдорджрд╛рд░
ЁЯжЩ => ЁЯжЩ, рдЕрд▓реНрдкрд╛рдХрд╛, рдЧреБрдЖрдирд╛рдХреЛ, рд░реЗрд╢реАрдо, рд▓рд╛рдорд╛, рд╡рд┐рдХреБрдирд╛
ЁЯжТ => ЁЯжТ, рдЬрд┐рд░рд╛рдл, рдерд┐рдкрдХреЗ
ЁЯРШ => ЁЯРШ, рд╣рддреНрддреА
ЁЯжг => ЁЯжг, рдХреЗрдВрд╕рд╛рд│, рдирд╢реНрдЯ рдЬрд╛рд╡рдк, рднреАрдордЧрдЬ, рд▓реЛрдХрд░, рд╡реНрд╣рдб, рд╕реЛрдВрдб
ЁЯжП => ЁЯжП, рдЧрд╡реЛ
ЁЯжЫ => ЁЯжЫ, рд╣рд┐рдкреЛ, рд╣рд┐рдкреЛрдкреЛрдЯрд╛рдорд╕
ЁЯРн => ЁЯРн, рдЙрдВрджрд░рд╛рдЪреЗрдВ рддреЛрдВрдб, рдЙрдВрджреАрд░, рдЪреЗрд░реЛ
ЁЯРБ => ЁЯРБ, рдЙрдВрджреАрд░
ЁЯРА => ЁЯРА, рдЗрдВрджреВрд░
ЁЯР╣ => ЁЯР╣, рдЪреЗрд░реЛ, рдкрд╛рд│реАрд╡, рд╣реЕрдорд╕реНрдЯрд░
ЁЯР░ => ЁЯР░, рдЪреЗрд░реЛ, рдкрд╛рд│реАрд╡, рд╕рд╢рд╛рдЪреЛ рдЪреЗрд░реЛ, рд╕рд╕реЛ, рд╕реЛрдВрд╕реЛ
ЁЯРЗ => ЁЯРЗ, рдкрд╛рд│реАрд╡, рд╕рд╕реЛ, рд╕реЛрдВрд╕реЛ
ЁЯР┐ => ЁЯР┐, рдЪрд╛рдиреА, рдЪрд╛рдиреЛ
ЁЯжл => ЁЯжл, рдзрд░рдг, рдмреЗрд╡реЗрд░
ЁЯжФ => ЁЯжФ, рдХрд╛рдЯреЗ, рд╕рд╛рд│реАрдВрджрд░
ЁЯжЗ => ЁЯжЗ, рдкрд┐рд╢рд╛рдЪреНрдЪ, рд╡рд╛рдЧреЛрд│реЗрдВ
ЁЯР╗ => ЁЯР╗, рдЪреЗрд░реЛ, рд╡рд╛рд╕реНрд╡реЗрд▓
ЁЯР╗тАНтЭД => ЁЯР╗тАНтЭД, рдЖрд░реНрдЯрд┐рдХред рд╡рд╛рдВрд╕реНрд╡реЗрд▓ред рдзреНрд░реБрд╡реАрдп рд╡рд╛рдВрд╕реНрд╡реЗрд▓ред рдзрд╡реЗрдВ, рдзреНрд░реБрд╡реАрдп рд╡рд╛рдВрд╕реНрд╡реЗрд▓
ЁЯРи => ЁЯРи, рдХреЛрдпрд▓рд╛, рд╡рд╛рд╕реНрд╡реЗрд▓
ЁЯР╝ => ЁЯР╝, рдЪреЗрд░реЛ, рдкрд╛рдВрдбрд╛
ЁЯже => ЁЯже, рдЖрд│рд╢реА, рдмрд░реНрдл, рд╕реНрд▓реЛрде
ЁЯжж => ЁЯжж, рдЙрдореЗрджреА, рдУрдЯреНрдЯрд░, рдиреБрд╕реНрддреНрдпреЗрдВ
ЁЯжи => ЁЯжи, рдШрд╛рдг, рд╕реНрдХреБрдВрдХ
ЁЯжШ => ЁЯжШ, рдЖрдирдВрдж, рдЙрдбреА рдорд╛рд░рдк, рдСрд╕реНрдЯреНрд░реЗрд▓рд┐рдпрд╛, рдХрд╛рдВрдЧрд╛рд░реВ, рд╢рд┐рд╢реВрдзрд╛рди
ЁЯжб => ЁЯжб, рдкреЗрд╕реНрдЯрд░, рдмреЕрдЬрд░, рдореНрд╣реЛрдВрд╡ рдЦрд╛рд╡рдкреА рдмреЕрдЬрд░
ЁЯР╛ => ЁЯР╛, рдард╢реЗ, рдкрдВрдЬрд╛рдЪреЗ рдард╢реЗ, рдкрдВрдЬреЛ, рдкрд╛рд╡рд▓рд╛рдВ
ЁЯжГ => ЁЯжГ, рдЯрд░реНрдХреА, рд╕реБрдХрдгреЗрдВ
ЁЯРФ => ЁЯРФ, рдХреЛрдореА, рд╕реБрдХрдгреЗрдВ
ЁЯРУ => ЁЯРУ, рдХреЛрдореЛ, рд╕реБрдХрдгреЗрдВ
ЁЯРг => ЁЯРг, рдЙрдмреЛрд╡рдк, рдХреЛрдордпреЗрдкрд┐рд▓, рд▓реНрд╣рд╛рди рдХреЛрдордпреЗрдкрд┐рд▓рд╛рдВ, рд╢рд┐рд╢реВ, рд╕реБрдХрдгреЗрдВ
ЁЯРд => ЁЯРд, рдХреЛрдордпреЗ рдкрд┐рд▓, рдХреЛрдордпреЗрдкрд┐рд▓, рд╢рд┐рд╢реВ, рд╕реБрдХрдгреЗрдВ
ЁЯРе => ЁЯРе, рдХреЛрдордпреЗрдкрд┐рд▓, рдореБрдЦрд╛рд░ рдкрд│реЛрд╡рдкреА рдХреЛрдордпреЗ рдкрд┐рд▓, рдореБрдЦрд╛рд░ рдкрд│реЛрд╡рдкреА рд╢рд┐рд╢реВ рдХреЛрдордпреЗрдкрд┐рд▓, рд╢рд┐рд╢реВ, рд╕реБрдХрдгреЗрдВ
ЁЯРж => ЁЯРж, рд╕реБрдХрдгреЗрдВ
ЁЯРз => ЁЯРз, рдкреЗрдЧреНрд╡реАрди, рд╕реБрдХрдгреЗрдВ
ЁЯХК => ЁЯХК, рдЙрдбрдк, рдХрд╡рдбреЛ, рд╢рд╛рдВрддреА, рд╕реБрдХрдгреЗрдВ
ЁЯжЕ => ЁЯжЕ, рдЧрд░реБрдб, рд╕реБрдХрдгреЗрдВ
ЁЯжЖ => ЁЯжЖ, рдмрдХреЗрдВ, рд╕реБрдХрдгреЗрдВ
ЁЯжв => ЁЯжв, рдХреБрд░реБрдк рдмрдХреЗрдВ, рд╕рд┐рдЧреНрдиреЗрдЯ, рд╕реБрдХрдгреЗ, рд╕реНрд╡рд╛рди
ЁЯжЙ => ЁЯжЙ, рдШреБрдмрдб, рд╕реБрдХрдгреЗ, рд╣реБрд╢рд╛рд░
ЁЯжд => ЁЯжд, рдбреЛрдбреЛ, рдирд╢реНрдЯ рдЬрд╛рддрд╛рдд, рдореЙрд░рд┐рд╢рд╕, рд╡реНрд╣рдб
ЁЯк╢ => ЁЯк╢, рдЙрдбреНрдбрд╛рдг, рдкрд╛рдЦрд╛рдВ, рдкреНрд░рдХрд╛рд╢, рдкреНрд▓рдореЗрдЬ, рд╕реБрдХрдгреЗрдВ
ЁЯжй => ЁЯжй, рдЙрд╖реНрдгрдХрдЯрд┐рдмрдВрдзреАрдп, рдлреНрд▓реЗрдордмреЛрдпрд╛рдВрдЯ, рдлреНрд▓реЗрдорд┐рдВрдЧреЛ
ЁЯжЪ => ЁЯжЪ, рдЕрджреНрднреВрдд, рдЧрд░реНрд╡, рдореЛрд░, рдореЛрд╣рд░, рд╕реБрдХрдгреЗрдВ
ЁЯжЬ => ЁЯжЬ, рдЙрд▓реЛрд╡рдк, рдЪрд╛рдЪреНрдпреЗ, рдкреЛрдкрдЯ, рд╕реБрдХрдгреЗрдВ
ЁЯР╕ => ЁЯР╕, рдЪреЗрд░реЛ, рдмреЗрдмреБрдХ
ЁЯРК => ЁЯРК, рдорд╛рдирдЧреЗрдВ
ЁЯРв => ЁЯРв, рдХрд╛рд╕рдп, рдХрд╛рд╕рд╡, рдЯреЗрд░рд╛рдкреАрди
ЁЯжО => ЁЯжО, рдкрд╛рд▓, рд╕рд░рдкрдЯрдкреА
ЁЯРН => ЁЯРН, рдЬрд┐рд╡рд╛рдгреЗрдВ, рдлрдгреЛ рдЖрд╕рдкреА, рд░рд╛рд╕, рд╡рд╛рд╣рдХ, рд╕рдкрд░рдЯрдкреА
ЁЯР▓ => ЁЯР▓, рдЪреЗрд░реЛ, рдбреНрд░реЕрдЧреЛрди, рдкрд░реА рдХрдерд╛
ЁЯРЙ => ЁЯРЙ, рдбреНрд░реЕрдЧреЛрди, рдкрд░реАрдХрдерд╛
ЁЯжХ => ЁЯжХ, рдбрд┐рдкреНрд▓реЛрдбреЛрдХрд╕, рдмреНрд░рд╛рдЪреАрд╕реМрд░реНрд╕, рдмреНрд░реЛрдиреНрдЯреЛрд╕реМрд░реНрд╕, рд╕реМрд░реЛрдкреЛрдб
ЁЯжЦ => ЁЯжЦ, рдЯрд╛рдпрд░реЕрдиреЛрд╕реМрд░реНрд╕ рд░реЕрдХреНрд╕, рдЯреА-рд░реЕрдХреНрд╕
ЁЯР│ => ЁЯР│, рдЪреЗрд░реЛ, рджреЗрд╡рдорд╛рд╕реЛ, рдкреЗрд╡рдд рдордЬрд╛ рдХрд░рдкреА, рдкреЗрдВрд╡рдд рдордЬрд╛ рдХрд░рдкреА рджреЗрд╡рдорд╛рд╕реЛ
ЁЯРЛ => ЁЯРЛ, рджреЗрд╡рдорд╛рд╕реЛ
ЁЯРм => ЁЯРм, рдбреЛрд▓реНрдлреАрди, рдлреНрд▓рд┐рдкрд░
ЁЯжн => ЁЯжн, рд╕реАрд▓, рд╕реАрд▓ рд╢реАрдВрд╡
ЁЯРЯ => ЁЯРЯ, рдиреБрд╕реНрддреНрдпреЗрдВ, рдореАрди, рд░рд╛рд╕
ЁЯРа => ЁЯРа, рдЙрд╖реНрдгрдХрдЯреАрдмрдВрдзрд╛рддрд▓реЗрдВ рдиреБрд╕реНрддреНрдпреЗрдВ, рдЙрд╖реНрдгрдХрдЯреАрдмрдВрдзреАрдп, рдиреБрд╕реНрддреНрдпреЗрдВ
ЁЯРб => ЁЯРб, рдиреБрд╕реНрддреНрдпреЗрдВ, рдмреНрд▓реЛрдлреАрд╢
ЁЯжИ => ЁЯжИ, рдиреБрд╕реНрддреНрдпреЗрдВ, рдореЛрд░реА
ЁЯРЩ => ЁЯРЩ, рдСрдХреНрдЯреЛрдкрд╕
ЁЯРЪ => ЁЯРЪ, рддрд┐рд╕рд░реА, рд╢рдВрдЦ
ЁЯРМ => ЁЯРМ, рдЧреЛрдЧрд▓рдЧрд╛рдп
ЁЯжЛ => ЁЯжЛ, рдХрд┐рдЯрдХ, рдлреБрд▓рдкрд╛рдЦрд░реБрдВ, рд╕реБрдВрджрд░
ЁЯРЫ => ЁЯРЫ, рдХрд┐рдЯрдХ, рднрд┐рдХреВрдг
ЁЯРЬ => ЁЯРЬ, рдХрд┐рдЯрдХ, рдореВрдп
ЁЯРЭ => ЁЯРЭ, рдХрд┐рдЯрдХ, рдореВрд╕, рдореНрд╣реЛрдВрд╡рд╛рдореВрд╕
ЁЯк▓ => ЁЯк▓, рдХрд┐рдЯрдХ, рднрд┐рдХреВрдг, рднреБрдВрдЧреЛ
ЁЯРЮ => ЁЯРЮ, рдХрд┐рдЯрдХ, рдмрд╛рдпрд▓ рднреБрдВрдЧреЛ, рдмрд╛рдпрд▓рднрд┐рдХреВрдг, рдмрд╛рдпрд▓рд╕реБрдХрдгреЗрдВ, рднреБрдВрдЧреЛ
ЁЯжЧ => ЁЯжЧ, рдХреНрд░рд┐рдХреЗрдЯ, рдЯреЛрд│
ЁЯк│ => ЁЯк│, рдХрд┐рдЯрдХ, рдХрд┐рдЯрд╛рдгреВ, рдЬрд▓реНрд▓реЛ, рд╕рд╛рд╡реЗрдВ рдиреБрд╕реНрддреНрдпреЗрдВ
ЁЯХ╖ => ЁЯХ╖, рдХрд┐рдЯрдХ, рдорд╛рд╡рд▓реА
ЁЯХ╕ => ЁЯХ╕, рдорд╛рд╡рд▓реА, рдорд╛рд╡рд▓реАрдЪреЗрдВ рдЬрд╛рд│реЗрдВ, рд╡реЕрдм
ЁЯжВ => ЁЯжВ, рд░рд╛рд╕, рд╡рд┐рдЪреВ, рд╡реГрд╢реНрдЪреАрдХ
ЁЯжЯ => ЁЯжЯ, рдХрд┐рдбреЗ, рдЬрд│рд╛рд░, рдЬреЛрд░, рдорд▓реЗрд░рд┐рдпрд╛, рд░реЛрдЧ, рд╡рд╛рдпрд░рд╕
ЁЯк░ => ЁЯк░, рдХрд┐рдбреЗ, рдХреБрд╕рдк, рдореВрд╕, рд░реЛрдЧ, рд╡рд╛рд│рдЯреА
ЁЯк▒ => ЁЯк▒, рдЕрдиреЗрд▓рд┐рдб, рдХрд┐рдбреЛ, рдЧрд╛рдпрдбреЛрдВрд│, рдкреЕрд░реИрд╕рд╛рдпрдЯ
ЁЯжа => ЁЯжа, рдЕрдорд┐рдмрд╛, рдмреЕрдХреНрдЯреЗрд░рд┐рдпрд╛, рдорд╛рдпрдХреНрд░реЛрдм, рд╡рд╛рдпрд░рд╕
ЁЯТР => ЁЯТР, рдЧреБрдЪреНрдЫ, рдлреВрд▓
ЁЯМ╕ => ЁЯМ╕, рдХрд│реА, рдЬрд╛рд╕реНрд╡рдВрдж, рдлреВрд▓
ЁЯТо => ЁЯТо, рдзрд╡реЗрдВ рдлреВрд▓, рдлреВрд▓
ЁЯП╡ => ЁЯП╡, рдЧреБрдЪреНрдЫ, рдлреВрд▓, рд░реЛрдк
ЁЯМ╣ => ЁЯМ╣, рдЧреБрд▓рд╛рдм, рдлреВрд▓
ЁЯеА => ЁЯеА, рдлреВрд▓, рдмрд╛рд╡рд┐рд▓реНрд▓реЗрдВ
ЁЯМ║ => ЁЯМ║, рджрд╢реАрдг, рджрд╕рдгреАрдлреВрд▓, рдлреВрд▓
ЁЯМ╗ => ЁЯМ╗, рдлреВрд▓, рд╕реБрд░реНрдп, рд╕реБрд░реНрдпрдлреВрд▓
ЁЯМ╝ => ЁЯМ╝, рдлреБрд▓рдк, рдлреВрд▓
ЁЯМ╖ => ЁЯМ╖, рдЯреБрд▓рд┐рдк, рдлреВрд▓
ЁЯМ▒ => ЁЯМ▒, рдмрд┐рдпреЛ, рд╕рд╛рди
ЁЯк┤ => ЁЯк┤, рдХреБрдВрдбреАрддрд▓реЗрдВ рд░реЛрдк, рдШрд░, рдкреЛрд░, рдкреЛрд╢рдг, рдмреЗрдЬрд╛рд░, рд╡рд╛рдб, рд╡рд╛рдкрд░рдирд╛рд╢рд┐рд▓реНрд▓реЗрдВ
ЁЯМ▓ => ЁЯМ▓, рдЭрд╛рдб, рд╕рджрд╛рдмрд╣рд╛рд░ рдЭрд╛рдб
ЁЯМ│ => ЁЯМ│, рдЭрд╛рдб, рдкрд╛рдирдЭрдбреА, рдкрд╛рдирд╛рдВ рдкрдбрдк
ЁЯМ┤ => ЁЯМ┤, рдЭрд╛рдб, рднрд┐рд▓реНрд▓, рднрд┐рд▓реНрд▓рд╛рдЪреЗрдВ рдЭрд╛рдб
ЁЯМ╡ => ЁЯМ╡, рдирд┐рд╡рд▓рдХрд╛рдгреА, рд╡рдирд╕реНрдкрдд
ЁЯМ╛ => ЁЯМ╛, рдХрд╛рди, рддрд╛рдВрджреБрд│, рдзрд╛рдиреНрдп, рднрд╛рддрд╛рдЪреЗрдВ рдХрдгрд╕
ЁЯМ┐ => ЁЯМ┐, рдкрд╛рди, рд░реЛрдк
тШШ => тШШ, рд╡рдирд╕реНрдкрдд, рд╢реЕрдорд░реЙрдХ
ЁЯНА => ЁЯНА, 4, рдЪрд╛рд░, рдЪрд╛рд░ рдкрд╛рдирд╛рдЪреЛ рдкрд░реНрдг, рдЪрд╛рд░-рдкрд╛рдирд╛рдВрдЪреЛ рдкрд░реНрдг, рдкрд░реНрдг, рдкрд╛рди
ЁЯНБ => ЁЯНБ, рдЧрд│рдк, рдкрд╛рди, рдореЕрдкрд▓
ЁЯНВ => ЁЯНВ, рдЧрд│реБрди рдкрдбрдкреА рдкрд╛рди, рдкрдбрдЯрд╛, рдкрд╛рди
ЁЯНГ => ЁЯНГ, рдкрд╛рди, рдкрд╛рди рд╡рд╛-рдпрд╛рд░ рд╣рд╛рд▓рддрд╛, рд╡рд╛рд░реЗрдВ, рд╡реНрд╣рд╛рдВрд╡рддрд╛, рд╣рд╛рд▓рддрд╛
ЁЯНЗ => ЁЯНЗ, рджреНрд░рд╛рдХреНрд╖, рджреНрд░рд╛рдХреНрд╖рд╛рдВ, рдлрд│
ЁЯНИ => ЁЯНИ, рдХрд╛рд│реАрдВрдЧ, рдлрд│
ЁЯНЙ => ЁЯНЙ, рдХрд╛рд│реАрдВрдЧ, рдХрд╛рд│реАрдВрдЧ рдлреВрд▓, рдлрд│
ЁЯНК => ЁЯНК, рдирд╛рд░рдВрдЧреА, рдлрд│, рд╕рдВрддреНрд░
ЁЯНЛ => ЁЯНЛ, рдЖрдВрдмрдЯ, рдлрд│, рд▓рд┐рдВрдмреВ
ЁЯНМ => ЁЯНМ, рдХреЗрд│реЗ, рдлрд│
ЁЯНН => ЁЯНН, рдЕрдирд╕, рдлрд│
ЁЯен => ЁЯен, рдЖрдВрдмреЛ, рдЙрд╖реНрдгрдХрдЯреАрдмрдВрдз, рдлрд│
ЁЯНО => ЁЯНО, рддрд╛рдВрдмрдбреЗрдВ, рдлрд│, рд╕рдлрд░рдЪрдВрдж
ЁЯНП => ЁЯНП, рдкрд╛рдЪрд╡реЗрдВ, рдлрд│, рд╕рдлрд░рдЪрдВрдж
ЁЯНР => ЁЯНР, рдкрд┐рдпрд░, рдлрд│
ЁЯНС => ЁЯНС, рдкрд┐рдЪ, рдлрд│
ЁЯНТ => ЁЯНТ, рдЪреЗрд░реА, рдЪреЗрд░реАрд╕, рддрд╛рдВрдмрдбреЗрдВ, рдлрд│
ЁЯНУ => ЁЯНУ, рдлрд│, рдмреЗрд░реА, рд╕реНрдЯреНрд░реЙрдмреЗрд░реА
ЁЯлР => ЁЯлР, рдирд┐рд│реЗрдВ, рдмрд┐рд▓рдмреЗрд░реА, рдмреЗрд░реА, рдмреНрд▓реВрдмреЗрд░реА
ЁЯеЭ => ЁЯеЭ, рдЕрдиреНрди, рдХрд┐рд╡реА, рдлрд│
ЁЯНЕ => ЁЯНЕ, рддреЛрдорд╛рдЯ, рдлрд│, рдлрд│рднрд╛рдЬреА
ЁЯлТ => ЁЯлТ, рдУрд▓рд┐рд╡реНрд╣, рдлрд│
ЁЯее => ЁЯее, рдирд╛рд▓реНрд▓, рдкрд┐рдирд╛ рдХреЛрд▓рд╛рдбрд╛, рдорд╛рдб
ЁЯеС => ЁЯеС, рдЕрдиреНрди, рдЕрд╡реЛрдХрд╛рдбреЛ, рдлрд│
ЁЯНЖ => ЁЯНЖ, рднрд╛рдЬреА, рд╡рд╛рдпрдВрдЧрдг, рд╡рд╛рдпрдВрдЧреЗрдВ
ЁЯеФ => ЁЯеФ, рдЕрдиреНрди, рдмрдЯрд╛рдЯ, рднрд╛рдЬреА
ЁЯеХ => ЁЯеХ, рдЕрдиреНрди, рдЧрд╛рдЬрд░, рднрд╛рдЬреА
ЁЯМ╜ => ЁЯМ╜, рдХрдгрд╕, рдордХреЗ, рдордХреЛ, рдордХреНрдпрд╛рдЪреЗрдВ рдХрдгрд╕
ЁЯМ╢ => ЁЯМ╢, рддрд╛рд░рд╡рдЯреА, рдорд┐рд░рд╕рд╛рдВрдЧ
ЁЯлС => ЁЯлС, рдХрд╛рд╢реНрдорд┐рд░реА рдорд┐рд░рд╕рд╛рдВрдЧ, рдврдмреНрдмреВ, рдврдмреНрдмреВ рдорд┐рд░рд╕рд╛рдВрдЧ, рднрд╛рдЬреА
ЁЯеТ => ЁЯеТ, рдЕрдиреНрди, рддрд╡рд╢реЗрдВ, рднрд╛рдЬреА, рд▓реЛрдгрдЪреЗрдВ
ЁЯем => ЁЯем, рдХрд╛рд▓реЗ, рдХреЛрдмреА, рдкрд╛рдЪрд╡реА рднрд╛рдЬреА, рдкрд╛рд▓реЗ рднрд╛рдЬреА, рдмреЙрдХ рдЫреЛрдп, рд▓реЗрдЯреНрдпреБрд╕
ЁЯеж => ЁЯеж, рдмреНрд░реЛрдХреЛрд▓реА, рд░рд╛рдирдЯреА рдХреЛрдмреА
ЁЯзД => ЁЯзД, рд▓рд╕реВрдг, рд╕реНрд╡рд╛рдж
ЁЯзЕ => ЁЯзЕ, рдХрд╛рдВрджреЛ, рд╕реНрд╡рд╛рдж
ЁЯНД => ЁЯНД, рдЕрд│рдореА, рдЕрд│рдореЗрдВ, рдЯреЛрдбрд╕реНрдЯреВрд▓
ЁЯеЬ => ЁЯеЬ, рдЕрдиреНрди, рдмрд┐рдпреЛ, рднрд╛рдЬреА, рднрд┐рдХрдгрд╛рдВ
ЁЯМ░ => ЁЯМ░, рд░реЛрдк, рд╢реЗрдВрдЧрд╛рдмрд┐рдпреЛ, рд╢реЗрдВрдЧрд╛рдВрдмрд┐рдпреЛ
ЁЯНЮ => ЁЯНЮ, рдкрд╛рд╡, рд▓реЛрд│реА
ЁЯеР => ЁЯеР, рдЕрдиреНрди, рдХреНрд░рд┐рд╕реЗрдВрдЯ рд░реЛрд▓, рдХреНрд░реЛрдпрд╕рд╛рдВрдЯ, рдкрд╛рд╡, рдлреНрд░реЗрдВрдЪ
ЁЯеЦ => ЁЯеЦ, рдЕрдиреНрди, рдкрд╛рд╡, рдлреНрд░реЗрдВрдЪ, рдмрдЧреЗрдЯреА
ЁЯлУ => ЁЯлУ, рдЕрд░реЗрдкрд╛, рдирд╛рди, рдкрд┐рдЯрд╛, рд▓рд╛рд╡рд╛рд╢, рд╕рдкрд╛рдЯрдкрд╛рд╡
ЁЯеи => ЁЯеи, рдШреБрд╕реНрдкрд▓реНрд▓реЗрдВ, рдкреНрд░рд┐рдЯреНрдЭреЗрд▓
ЁЯеп => ЁЯеп, рдмрд╛рдЧреЗрд▓, рдмреЗрдХрд░реА, рд╕реНрдорд┐рдЕрд░
ЁЯеЮ => ЁЯеЮ, рдЕрдиреНрди, рдХреНрд░реЗрдкреЗ, рдкреЕрдирдХреЗрдХ, рдкреЕрдирдХреЗрдХреНрд╕, рд╣реЙрдЯрдХреЗрдХ
ЁЯзЗ => ЁЯзЗ, рдЕрдирд┐рд╢реНрдЪреАрдд, рд▓реЛрдЦрдВрдб, рд╡реЕрдлрд▓
ЁЯзА => ЁЯзА, рдЪрд┐рдЬ, рдЪрд┐рдЬ рд╡реЗрдЬ
ЁЯНЦ => ЁЯНЦ, рдорд╛рд╕, рд╣рд╛рдб, рд╣рд╛рдбрд╛рдЪреЗрд░ рдорд╛рд╕
ЁЯНЧ => ЁЯНЧ, рдХреЛрдордпреЗрдЪреЗрдВ, рдХреЛрдордпреЗрдЪреЛ рдкрд╛рдп, рдХреЛрдореА, рдкрд╛рдп, рдорд╕рдЧрд╛рдЪреА рд╕рд╛рдВрдЧ, рд╣рд╛рдб
ЁЯей => ЁЯей, рдХрд╛рддрд░рдк, рдкреЙрд░реНрдХрдЪреЙрдк, рдорд╛рд╕рд╛рдЪреЛ рдХреБрдбрдХреЛ, рд▓рдБрдмрдЪреЛрдк, рд╕реНрдЯрд┐рдХ
ЁЯеУ => ЁЯеУ, рдЕрдиреНрди, рдмреЗрдХрди, рдорд╛рд╕
ЁЯНФ => ЁЯНФ, рдмрд░реНрдЧрд░, рд╣реЕрдордмрд░реНрдЧрд░
ЁЯНЯ => ЁЯНЯ, рдлреНрд░рд╛рдп, рдлреНрд░реЗрдВрдЪ
ЁЯНХ => ЁЯНХ, рдЪрд┐рдЬ, рдкрд┐рдЭреНрдЭрд╛, рд╕реНрд▓рд╛рдпрд╕
ЁЯМн => ЁЯМн, рдлреНрд░рдБрдХрдлрд░реНрдЪрд░, рд╕реЛрд╕реЗрдЬ, рд╣реЙрдЯ рдбреЙрдЧ, рд╣реЙрдЯрдбреЙрдЧ
ЁЯек => ЁЯек, рдкрд╛рд╡, рд╕рдБрдбрд╡рд┐рдЪ
ЁЯМо => ЁЯМо, рдЯрд╛рдХреЛ, рдореЕрдХреНрд╕рд┐рдХрди
ЁЯМп => ЁЯМп, рдЧреБрдард▓реА, рдмреБрд░рд┐рдЯреЛ, рдореЕрдХреНрд╕рд┐рдХрди
ЁЯлФ => ЁЯлФ, рдЧреБрдард▓рд╛рдпрд┐рд▓реНрд▓реЗрдВ, рдЯрдорд╛рд▓реЗ, рдореЕрдХреНрд╕рд┐рдХрди
ЁЯеЩ => ЁЯеЩ, рдЕрдиреНрди, рдХрдмрд╛рдм, рдЧрд╛рдпрд░реЛ, рдлрд╛рд▓рд╛рдлреЗрд▓, рднрд░рд┐рд▓реНрд▓реЛ, рд╕рдкрд╛рдЯрдкрд╛рд╡
ЁЯзЖ => ЁЯзЖ, рдЪрд┐рдХрдкреА, рдлрд╛рд▓рд╛рдлреЗрд▓, рдореАрдЯрдмреЙрд▓
ЁЯеЪ => ЁЯеЪ, рдЕрдиреНрди, рддрд╛рддреАрдВ
ЁЯН│ => ЁЯН│, рддрд│рддрд╛, рддрд╛рддреАрдВ, рдкреЕрди, рд░рд╛рдВрджрддрд╛
ЁЯеШ => ЁЯеШ, рдЕрдиреНрди, рдЕрдиреНрдирд╛рдЪреЗрдВ рд╢реЕрд▓реЛ рдкреЕрди, рдЕрдиреНрдирд╛рдЪреЛ рд╢реЕрд▓реЛ рдкреЕрди, рдХреЕрд╕рд░реЛрд▓, рдкрд╛рдпрд▓рд╛, рдкреЕрди, рд╢реЕрд▓реЛ
ЁЯН▓ => ЁЯН▓, рдЕрдиреНрдирд╛рдЪреА рдХрд╛рдпрд▓, рдХрд╛рдпрд▓, рд╕реНрдЯрд┐рд╡
ЁЯлХ => ЁЯлХ, рдХрд╛рдпрд▓, рдЪреАрдЬ, рдЪреЙрдХрд▓реЗрдЯ, рдлрд╛рдБрдбреНрдпреБ, рд╡рд┐рддрд│рд┐рд▓реНрд▓реА, рд╕реНрд╡рд┐рдЬ
ЁЯег => ЁЯег, рдХрдбрдзрд╛рдиреНрдп, рдХрд╛рдБрдЧреА, рдХреБрд▓реЗрд░ рдЖрдиреА рд╡рд╛рдЯреА, рдирд╛рд╢реНрддреЛ
ЁЯеЧ => ЁЯеЧ, рдЕрдиреНрди, рдкрд╛рдЪрд╡реЛ, рд╕рд▓рд╛рдж
ЁЯН┐ => ЁЯН┐, рдкреЙрдкрдХреЙрд░реНрди
ЁЯзИ => ЁЯзИ, рдбреЗрдЕрд░реА, рдмрдЯрд░, рд▓реЛрдгреА
ЁЯзВ => ЁЯзВ, рдорд╕рд╛рд▓реЛ, рдореАрда, рд╢реЗрдХрд░
ЁЯел => ЁЯел, рдХреЕрди, рдХреЕрдирд╛рддрд▓реЗрдВ рдЕрдиреНрди
ЁЯН▒ => ЁЯН▒, рдмрдБрдЯреЛ, рдмреЙрдХреНрд╕
ЁЯНШ => ЁЯНШ, рддрд╛рдВрджрд│, рддрд╛рдВрджрд│рд╛рдЪреЛ рд╡рдбреЛ, рд╡рдбреЛ
ЁЯНЩ => ЁЯНЩ, рдЙрдВрдбреА, рдЬрдкрд╛рдиреА, рддрд╛рдВрджреБрд│, рд╢рд┐рддрд╛рдЪреА рдЙрдВрдбреА
ЁЯНЪ => ЁЯНЪ, рддрд╛рдВрджреБрд│, рд╢рд┐рдЬрдпрд▓реНрд▓реЗ, рд╢реАрдд
ЁЯНЫ => ЁЯНЫ, рд╢реАрдд, рд╣реБрдордг
ЁЯНЬ => ЁЯНЬ, рд░рд╛рдореЗрди, рд╡рд╛рдЯреЛ, рд╡рд╛рдлрд╛рдпрд┐рд▓реНрд▓реЗрдВ рд╢реАрдд, рд╡рд╛рдлрд╛рдпрд┐рд▓реНрд▓реЛ, рд╢реЗрд╡рдпреЛ
ЁЯНЭ => ЁЯНЭ, рдкрд╛рд╕реНрддрд╛, рд╕реНрдкрд╛рдЧреЗрдЯреА
ЁЯНа => ЁЯНа, рдЧреЛрдб, рддрд│рд┐рд▓реНрд▓реЗрдВ, рддрд│рд┐рд▓реНрд▓реЗрдВ рдХрдгрдВрдЧ, рдмрдЯрд╛рдЯ
ЁЯНв => ЁЯНв, рдУрдбреЗрди, рдХрдмрд╛рдм, рдиреБрд╕реНрддреНрдпреЗрдВ, рд╕реНрдХрд┐рд╡реЗрд░, рд╕реНрдЯрд┐рдХ
ЁЯНг => ЁЯНг, рд╕реБрд╢реА
ЁЯНд => ЁЯНд, рдЯреЕрдореНрдкреБрд░рд╛, рддрд│рд┐рд▓реНрд▓реЗрдВ, рддрд│рд┐рд▓реНрд▓реЗ рд╕реБрдВрдЧрдЯ, рд╕рд╛рдВрдЧрдЯ, рд╕реБрдВрдЧрдЯ
ЁЯНе => ЁЯНе, рдХреЗрдХ, рдиреБрд╕реНрддреНрдпреЗрдВ, рдорджреАрдВ рд╡рд░реНрддреБрд│рд╛рдЪреА рд╕рдЬрд╛рд╡рдЯ рдЖрд╕рдкреА рдиреБрд╕реНрддреНрдпрд╛рдЪреЛ рдХреЗрдХ, рд╡рд░реНрддреБрд│
ЁЯео => ЁЯео, рдЙрддреНрд╕рд╡, рдЪрдВрджреНрд░рдХрд╛рд░ рдХреЗрдХ, рдЪрдВрджреНрд░рд╛рдХрд╛рд░ рдХреЗрдХ, рдпреБрдмрд┐рдВрдЧ, рд╡рд╕рдВрдд
ЁЯНб => ЁЯНб, рдЧреЛрдб, рдЬрдкрд╛рдиреА, рдбрд╛рдВрдЧреЛ, рдбреЗрдЭрд░реНрдЯ, рд╕реНрдХрд┐рд╡реЗрд░, рд╕реНрдЯрд┐рдХ
ЁЯеЯ => ЁЯеЯ, рдПрдордкрд╛рдирд╛рдбрд╛, рдЧреНрдпреЛрдЭрд╛, рдЬрд┐рдУрдЭреА, рдбрдореНрдкрд▓рд┐рдВрдЧ, рдкрд╛рдпрд░реЛрдЧреА, рдкреЛрдЯрд╕реНрдЯрд┐рдХрд░
ЁЯеа => ЁЯеа, рдкреНрд░реЛрдлреЗрд╕реА, рдлреЙрд░реНрдЪреНрдпреБрди рдХреБрдХреА
ЁЯеб => ЁЯеб, рдЯреЗрдХрдЖрд╡рдЯ рдмреЙрдХреНрд╕, рд╢рд┐рдирд╛рдгреНрдпрд╛рдЪреА рдмрд╛рджрд▓реА
ЁЯжА => ЁЯжА, рдХрд░реНрдХ, рдХреБрд▓реНрд▓реА, рд░рд╛рд╕
ЁЯжЮ => ЁЯжЮ, рдиреБрд╕реНрддреНрдпреЗрдВ, рдкрдВрдЬреЗ, рдмрд┐рд╕реНрдХ, рд╕рд╛рдВрдЧрдЯ
ЁЯжР => ЁЯжР, рдЕрдиреНрди, рдХрд╡рдЪ рдЖрд╕рдкреА рдиреБрд╕реНрддреНрдпреЗрдВ, рд▓реНрд╣рд╛рди, рд╕реБрдВрдЧрдЯ
ЁЯжС => ЁЯжС, рдЕрдиреНрди, рдорд╛рдгрдХреА, рдорд╛рдгрдХреНрдпреЛ
ЁЯжк => ЁЯжк, рдЪрдХрдЪрдХреАрдд, рдореЛрддреА, рд╢рд┐рдирд╛рдгреАрдВ, рд╢рд┐рдирд╛рдгреЗрдВ
ЁЯНж => ЁЯНж, рдЖрдпрд╕, рдЖрдпрд╕рдХреНрд░реАрдо, рдХреНрд░реАрдо, рдЧреЛрдб, рдбреЗрдЭрд░реНрдЯ, рд╕реЙрдлреНрдЯ
ЁЯНз => ЁЯНз, рдЖрдпрд╕, рдЧреЛрдб, рдбреЗрдЭрд░реНрдЯ, рд╢реЗрд╡реНрдб
ЁЯНи => ЁЯНи, рдЖрдпрд╕, рдХреНрд░реАрдо, рдЧреЛрдб, рдбреЗрдЭрд░реНрдЯ
ЁЯНй => ЁЯНй, рдЧреЛрдб, рдбреЗрдЭрд░реНрдЯ, рдбреЛрдирдЯ, рдбреЛрд╡рдирдЯ
ЁЯНк => ЁЯНк, рдХреБрдХреА, рдЧреЛрдб, рдбреЗрдЭрд░реНрдЯ
ЁЯОВ => ЁЯОВ, рдХреЗрдХ, рдЧреЛрдб, рдбреЗрдЭрд░реНрдЯ, рдкреЕрд╕реНрдЯреНрд░реА, рд╡рд╛рдбрджрд┐рд╕рд╛рдЪреЛ рдХреЗрдХ, рд╡рд╛рдбрджреАрд╕, рд╕реБрд╡рд╛рд│реЛ
ЁЯН░ => ЁЯН░, рдХреБрдбрдХреЛ, рдХреЗрдХ, рдЧреЛрдб, рдбреЗрдЭрд░реНрдЯ, рдкреЕрд╕реНрдЯреНрд░реА, рд▓реНрд╣рд╛рди рдХреЗрдХ, рд▓реНрд╣рд╛рдирдХреЗрдХ
ЁЯзБ => ЁЯзБ, рдХрдкрдХреЗрдХ, рдЧреЛрдб, рдмреЗрдХрд░реА
ЁЯез => ЁЯез, рдкрд╛рдп, рдкреЕрд╕реНрдЯреНрд░реА, рднрд░рдг
ЁЯНл => ЁЯНл, рдЧреЛрдб, рдЪреЙрдХрд▓реЗрдЯ, рдбреЗрдЭрд░реНрдЯ, рдмрд╛рд░
ЁЯНм => ЁЯНм, рдХрдБрдбреА, рдЧреЛрдб, рдбреЗрдЭрд░реНрдЯ
ЁЯНн => ЁЯНн, рдХрдБрдбреА, рдЧреЛрдб, рдбреЗрдЭрд░реНрдЯ, рд▓реЙрд▓рд┐рдкреЙрдк
ЁЯНо => ЁЯНо, рдХрд╕реНрдЯрд░реНрдб, рдЧреЛрдб, рдбреЗрдЭрд░реНрдЯ, рдкреБрдбреАрдВрдЧ
ЁЯНп => ЁЯНп, рдЖрдпрджрди, рдЧреЛрдб, рдореНрд╣реЛрдВрд╡, рдореНрд╣реЛрдВрд╡рд╛рдЪреЗрдВ рдЖрдпрджрди
ЁЯН╝ => ЁЯН╝, рджреВрдж, рдкрд┐рдгреЗрдВ, рдмрд╛рдЯрд▓реА, рд╢рд┐рд╢реВ, рд╢рд┐рд╢реВрдЪреА рдмрд╛рдЯрд▓реА
ЁЯеЫ => ЁЯеЫ, рдЧреНрд▓рд╛рд╕, рджреБрджрд╛рдЪреЛ рдЧреНрд▓рд╛рд╕, рджреВрдж, рдкрд┐рдгреЗрдВ
тШХ => тШХ, рдЙрд╖реНрдг, рдХреЙрдлреА, рдЪреНрдпрд╛, рдкрд┐рдгреЗрдВ, рдкреЗрдпрд╛рдВ, рдорд╛рджрдХ рдкреЗрдпрд╛рдВ, рд╡рд╛рдлрд╛рд│
ЁЯлЦ => ЁЯлЦ, рдЖрдпрджрди, рдЪреНрдпрд╛, рдЪреНрдпрд╛рдЪреЗрдВ рдЖрдпрджрди, рдкрд┐рдгреЗрдВ
ЁЯН╡ => ЁЯН╡, рдХрдк, рдЪреНрдпрд╛, рдЪреНрдпрд╛рдЪреЗрдВ рдХрдк, рдкрд┐рдгреЗрдВ, рдкреЗрдп, рд╣рдБрдбрд▓ рдирд╛рд╢рд┐рд▓реНрд▓реЗрдВ рдЪреНрдпрд╛рдЪреЗрдВ рдХрдк, рд╣рдВрдБрдбрд▓ рдирд╛рд╢рд┐рд▓реНрд▓реЗрдВрдВ рдЪреНрдпрд╛рдЪреЗрдВ рдХрдк
ЁЯН╢ => ЁЯН╢, рдХрдк, рдкрд┐рдгреЗрдВ, рдкреЗрдпрд╛рдВ, рдмрд╛рдЯрд▓реА, рдмрд╛рд░, рднрд░рдгреА
ЁЯН╛ => ЁЯН╛, рдХреЙрд░реНрдХ, рдкрд┐рдгреЗрдВ, рдкреЛрдкрд┐рдВрдЧ, рдкреЛрдкрд┐рдВрдЧ рдХреЙрд░реНрдХ рдЖрд╕рдкреА рдмрд╛рдЯрд▓реА, рдмрд╛рдЯрд▓реА, рдмрд╛рд░
ЁЯН╖ => ЁЯН╖, рдЧреНрд▓рд╛рд╕, рдкрд┐рдгреЗрдВ, рдкреЗрдпрд╛рдВ, рдмрд╛рд░, рд╡рд╛рдпрди, рд╡рд╛рдпрдирд╛рдЪреЛ рдЧреНрд▓рд╛рд╕
ЁЯН╕ => ЁЯН╕, рдХреЙрдХрдЯреЗрд▓, рдЧреНрд▓рд╛рд╕, рдкрд┐рдгреЗрдВ, рдмрд╛рд░
ЁЯН╣ => ЁЯН╣, рдЙрд╖реНрдгрдХрдЯреАрдмрдВрдзреАрдп, рдкрд┐рдгреЗрдВ, рдмрд╛рд░
ЁЯН║ => ЁЯН║, рдкрд┐рдгреЗрдВ, рдмрд╛рд░, рдмрд┐рдпрд░, рдмреАрдпрд░рд╛рдЪреЗрдВ рдордЧ, рдордЧ
ЁЯН╗ => ЁЯН╗, рдЪрд┐рдпрд░реНрд╕, рдЪрд┐рдпрд░реНрд╕ рдХрд░рдкреА рдмрд┐рдпрд░рд╛рдЪреАрдВ рдордЧрд╛рдВ, рдкрд┐рдгреЗрдВ, рдмрд╛рд░, рдмрд┐рдпрд░, рдордЧ
ЁЯеВ => ЁЯеВ, рдЧреНрд▓рд╛рд╕, рдЪрд┐рдпрд░реНрд╕, рдЪрд┐рдпрд░реНрд╕рд╛рдЪреЗ рдЧреНрд▓рд╛рд╕, рдкрд┐рдгреЗрдВ, рдордирдпрддрд╛рдд
ЁЯеГ => ЁЯеГ, рдЧреНрд▓рд╛рд╕, рдЯрдВрдмреНрд▓рд░, рд╡рд┐рд╕реНрдХреА, рд╢реЙрдЯ, рд╕реЛрд░реЛ
ЁЯед => ЁЯед, рдЬреНрдпреБрд╕, рд╕реЛрдбрд╛, рд╕реНрдЯреНрд░реЙ рдЖрд╕рдкреА рдХрдк
ЁЯзЛ => ЁЯзЛ, рдЪреНрдпрд╛, рджреВрдж, рдореЛрддреА, рд╡рд╛рдл, рд╡рд╛рдл рдпреЗрд╡рдкреА рдЪреНрдпрд╛
ЁЯзГ => ЁЯзГ, рдЬреНрдпреБрд╕ рдмреЙрдХреНрд╕, рдкреЗрдп рдмреЙрдХреНрд╕
ЁЯзЙ => ЁЯзЙ, рдкрд┐рдгреЗрдВ, рдорд╛рддрдпреЗрдЪреА рд╣рд╛рдВрдбреА
ЁЯзК => ЁЯзК, рдердВрдб, рдмрд░реНрдл, рдмрд░реНрдлрд╛рдЪреЛ рдХреНрдпреБрдм, рдмрд░реНрдлрд╛рдЪреЛрдХреБрдбрдХреЛ
ЁЯев => ЁЯев, рдЪреЙрдкрд╕реНрдЯрд┐рдХреНрд╕, рд╣рд╛рд╢реА
ЁЯН╜ => ЁЯН╜, рдХрд╛рдЯреЛ, рдмрд╢реА, рдмрд╢реНрд╢реЗ рд╕рдпрдд рдХрд╛рдЯреЛ рдЖрдиреА рд╕реБрд░реА, рд░рд╛рдВрджрдк, рд╕реБрд░реА
ЁЯН┤ => ЁЯН┤, рдХрдЯрд▓рд░реА, рдХрд╛рдЯреЛ, рдХрд╛рдЯреЛ рдЖрдиреА рд╕реБрд░реА, рд░рд╛рдВрджрдк, рд╕реБрд░реА
ЁЯеД => ЁЯеД, рдХреБрд▓реЗрд░, рдореЗрдЬрд╛рд╡рдпрд▓реНрдпреЛ рд╡рд╕реНрддреВ
ЁЯФк => ЁЯФк, рдЕрд╡рдЬрд╛рд░рд╛рдВ, рд░рд╛рдВрджрдЪреА рд╕реБрд░реА, рд░рд╛рдВрджрдк, рд░рд╛рдВрджрдкрд╛рдЪреА рд╕реБрд░реА, рд╕реБрд░реА, рд╣рддреНрдпрд╛рд░, рд╣реЛрдЪреЛ
ЁЯП║ => ЁЯП║, рдПрдореНрдлреЛрд░рд╛, рдХреБрдВрдн, рдЬрдЧ, рдкрд┐рдгреЗрдВ, рд░рд╛рдВрджрдк, рд░рд╛рд╕
ЁЯМН => ЁЯМН, рдЖрдлреНрд░рд┐рдХрд╛, рдЬрдЧ, рдкреГрдереНрд╡реА, рдпреБрд░реЛрдк, рдпреБрд░реЛрдк-рдЖрдлреНрд░рд┐рдХрд╛ рджрд╛рдЦреЛрд╡рдкреА рд╡рд┐рд╢реНрд╡рдЧреЛрд▓
ЁЯМО => ЁЯМО, рдЕрдореЗрд░рд┐рдХрд╛, рдЕрдореЗрд░рд┐рдХрд╛ рджрд╛рдЦреЛрд╡рдкреА рд╡рд┐рд╢реНрд╡рдЧреЛрд▓, рдЕрдореЗрд░реАрдХрд╛ рджрд╛рдЦреЛрд╡рдкреА рд╡рд┐рд╢реНрд╡рдЧреЛрд▓, рдЬрдЧ, рдкреГрдереНрд╡реА, рд╡рд┐рд╢реНрд╡рдЧреЛрд▓
ЁЯМП => ЁЯМП, рдЖрд╢рд┐рдпрд╛, рдЖрд╢рд┐рдпрд╛-рдСрд╕реНрдЯреНрд░реЗрд▓рд┐рдпрд╛ рджрд╛рдЦреЛрд╡рдкреА рд╡рд┐рд╢реНрд╡рдЧреЛрд▓, рдСрд╕реНрдЯреНрд░реЗрд▓рд┐рдпрд╛, рдЬрдЧ, рдкреГрдереНрд╡реА, рд╡рд┐рд╢реНрд╡рдЧреЛрд▓
ЁЯМР => ЁЯМР, рдЬрдЧ, рдкреГрдереНрд╡реА, рдпрд╛рдореЗрдпрд╛рддрд░ рд╡реГрддреНрдд, рдпрд╛рдореЗрдпрд╛рддрд░ рд╡реГрддреНрдд рджрд╛рдЦреЛрд╡рдкреА рд╡рд┐рд╢реНрд╡рдЧреЛрд▓, рд╡рд┐рд╢реНрд╡рдЧреЛрд▓
ЁЯЧ║ => ЁЯЧ║, рдЬрдЧ, рдЬрдЧрд╛рддрд▓реЛ рдирдХрд╛рд╕реЛ, рдирдХрд╛рд╕реЛ
ЁЯЧ╛ => ЁЯЧ╛, рдЬрдкрд╛рди, рдЬрдкрд╛рдирдЪреЛ рдирдХрд╕реЛ, рдирдХрд╕реЛ
ЁЯзн => ЁЯзн, рдУрд░реЗрдВрдЯрд┐рдпрд░реАрдВрдЧ, рдХрдореНрдкрд╛рд╕, рдЪреБрдВрдмрдХреАрдп, рдкреНрд░рд╡рд╛рд╕
ЁЯПФ => ЁЯПФ, рдердВрдб, рдкрд░реНрд╡рдд, рдмрд░реНрдл, рдмрд░реНрдлрд╛-рдЪреНрдЫрд╛рджреАрдд рдкрд░реНрд╡рдд
тЫ░ => тЫ░, рдкрд░реНрд╡рдд
ЁЯМЛ => ЁЯМЛ, рдЬреНрд╡рд╛рд▓рд╛рдореБрдЦреА, рдЬреНрд╡рд╛рд▓рд╛рд╕реНрдлреЛрдЯ, рдкрд░реНрд╡рдд
ЁЯЧ╗ => ЁЯЧ╗, рдкрд░реНрд╡рдд, рдлреБрдЬреА, рдорд╛рд╡рдВрдЯ рдлреБрдЬреА
ЁЯПХ => ЁЯПХ, рдЫрд╛рд╡рдгреА
ЁЯПЦ => ЁЯПЦ, рдмрд┐рдЪрд╛рдЪреЗрд░ рд╕рддреНрд░реА рдЖрд╕рд╛, рдмреАрдЪ, рд╕рддреНрд░реА
ЁЯПЬ => ЁЯПЬ, рд╡рд╛рд│рд╡рдВрдЯ
ЁЯПЭ => ЁЯПЭ, рдЬреБрд╡реЗрдВ, рд╡рд╛рд│рд╡рдВрдЯ, рд╡рд╛рд│рд╡рдВрдЯреАрдп рдЬреБрд╡реЗрдВ
ЁЯПЮ => ЁЯПЮ, рдЙрджреНрдпрд╛рди, рд░рд╛рд╖реНрдЯреНрд░реАрдп рдЙрджреНрдпрд╛рди
ЁЯПЯ => ЁЯПЯ, рд╕реНрдЯреЗрдбрд┐рдпрдо
ЁЯПЫ => ЁЯПЫ, рдХреНрд▓рд╛рд╕рд┐рдХрд▓ рдИрдорд╛рд░рдд, рдХреНрд▓рд╛рд╕реАрдХрд▓, рдХреНрд▓рд╛рд╕реАрдХрд▓ рдИрдорд╛рд░рдд
ЁЯПЧ => ЁЯПЧ, рдИрдорд╛рд░рдд рдмрд╛рдВрдзрдХрд╛рдо, рдмрд╛рдВрдзрдХрд╛рдо
ЁЯз▒ => ЁЯз▒, рдЪрд┐рд░реЗ, рдЪрд┐рд░реЛ, рдлрд╛рддрд░, рдорд╛рддреА, рдореЛрд░реНрдЯрд╛рд░, рд╡рдгрдЯ
ЁЯки => ЁЯки, рдЧреБрдВрдбреЗ, рдШрди, рдЬрдб, рдлрд╛рддреЛрд░, рдмреЛрд▓реНрдбрд░
ЁЯк╡ => ЁЯк╡, рдорджреЗрд░, рд▓рдВрдмрд░, рд▓рд╛рдХреВрдб, рд▓реЙрдЧ
ЁЯЫЦ => ЁЯЫЦ, рдЦреЛрдк, рдШрд░, рд╡рд╛рдВрдЯрдХреБрд│реЗрдВ рдШрд░
ЁЯПШ => ЁЯПШ, рдШрд░рд╛рдВ
ЁЯПЪ => ЁЯПЪ, рдШрд░, рдмреЗрдврд╡
ЁЯПа => ЁЯПа, рдШрд░, рдирд┐рд╡рд╛рд╕
ЁЯПб => ЁЯПб, рдШрд░, рдкреЛрд░рд╕реВрдВ, рдкреЛрд░рд╕реВрдВ рдЖрд╢рд┐рд▓реНрд▓реЗрдВ рдШрд░
ЁЯПв => ЁЯПв, рдИрдорд╛рд░рдд, рдХрдЪреЗрд░реЗрдЪреА рдИрдорд╛рд░рдд
ЁЯПг => ЁЯПг, рдЬрдкрд╛рдиреА, рдЬрдкрд╛рдиреА рдЯрдкрд╛рд▓ рдХрдЪреЗрд░реА, рдЯрдкрд╛рд▓
ЁЯПд => ЁЯПд, рдЯрдкрд╛рд▓, рдЯрдкрд╛рд▓ рдХрдЪреЗрд░реА, рдпреБрд░реЛрдкрд┐рдпрди
ЁЯПе => ЁЯПе, рдСрд╢реНрдкрд┐рддрд╛рд▓, рджреЛрддреЛрд░, рд╡рдЦрджрд╛рдВ
ЁЯПж => ЁЯПж, рдИрдорд╛рд░рдд, рдмрдБрдХ
ЁЯПи => ЁЯПи, рдИрдорд╛рд░рдд, рд╣реЙрдЯреЗрд▓
ЁЯПй => ЁЯПй, рдореЛрдЧ, рдореЛрдЧрд╛рд│ рд╣реЙрдЯреЗрд▓, рд╣реЙрдЯреЗрд▓
ЁЯПк => ЁЯПк, рджреБрдХрд╛рди, рд╕реЛрдпреАрдЪреЗрдВ
ЁЯПл => ЁЯПл, рдИрдорд╛рд░рдд, рд╢рд╛рд│рд╛
ЁЯПм => ЁЯПм, рдкрд╕рд░реЛ, рд╡рд┐рднрд╛рдЧ, рд╡рд┐рднрд╛рдЧреАрдп рдкрд╕рд░реЛ
ЁЯПн => ЁЯПн, рдИрдорд╛рд░рдд, рдХрд╛рд░рдЦрд╛рдиреЛ, рдлреЕрдХреНрдЯрд░реА
ЁЯПп => ЁЯПп, рдШрд░, рдЬрдкрд╛рдиреА
ЁЯП░ => ЁЯП░, рдШрд░, рдпреБрд░реЛрдкрд┐рдпрди
ЁЯТТ => ЁЯТТ, рдЪреЕрдкреЗрд▓, рд░реЛрдорд╛рдиреНрд╕, рд▓рдЧреНрди
ЁЯЧ╝ => ЁЯЧ╝, рдЯреЙрд╡рд░, рдЯреЛрдХрдпреЛ
ЁЯЧ╜ => ЁЯЧ╜, рдкреБрддрд│реЛ, рд╕реНрд╡рддрдВрддреНрд░, рд╕реНрд╡рддрдВрддреНрд░рджреЗрд╡рддреЗрдЪреЛ рдкреБрддрд│реЛ
тЫк => тЫк, рдХрд┐рд░рд┐рд╕реНрддрд╛рдВрд╡, рдХреНрд░реЙрд╕, рдЪрд░реНрдЪ, рдзрд░реНрдо
ЁЯХМ => ЁЯХМ, рдИрд╕реНрд▓рд╛рдо, рдзрд░реНрдо, рдорд╢реНрдЬреАрдж, рдореБрд╕рд▓рдорд╛рди
ЁЯЫХ => ЁЯЫХ, рджреЗрд╡реБрд│, рд╣рд┐рдВрджреБ
ЁЯХН => ЁЯХН, рдЬреНрдпреБ рд▓реЛрдХ, рдЬреНрдпреВ, рджреЗрд╡реБрд│, рдзрд░реНрдо, рд╕рд┐рдиреЗрдЧреЛрдЧ
тЫй => тЫй, рдзрд░реНрдо, рдордВрджреАрд░, рд╢рд┐рдВрддреЛ
ЁЯХЛ => ЁЯХЛ, рдИрд╕реНрд▓рд╛рдо, рдХрд╛рдмрд╛, рдзрд░реНрдо, рдореБрд╕рд▓рдорд╛рди
тЫ▓ => тЫ▓, рдЭрд░реЛ
тЫ║ => тЫ║, рдЫрд╛рд╡рдгреА, рддрдВрдмреВ
ЁЯМБ => ЁЯМБ, рдзреБрдХрд╛рд│, рдзреБрдХреЗрдВ
ЁЯМГ => ЁЯМГ, рдирдЦреЗрддреНрд░, рдирдЦреЗрддреНрд░рд╛рдВрдЪреА рд░рд╛рдд, рд░рд╛рдд
ЁЯПЩ => ЁЯПЩ, рд╢рд╛рд░, рд╢рд╛рд░реАрд╡рд╛рдард╛рд░
ЁЯМД => ЁЯМД, рдкрд░реНрд╡рдд, рдкрд░реНрд╡рддрд╛ рдлрд╛рдЯрд▓реЛ рд╕реБрд░реНрдпреЛрджрдп, рдкрд░реНрд╡рддрд╛ рдлрд╛рдЯрд▓реНрдпрд╛рди рдЬрд╛рд╡рдкреА рд╕реБрд░реНрдпреЛрджрдп, рд╕рдХрд╛рд│, рд╕реБрд░реНрдп, рд╕реБрд░реНрдпреЛрджрдп
ЁЯМЕ => ЁЯМЕ, рд╕рдХрд╛рд│, рд╕реБрд░реНрдп, рд╕реБрд░реНрдпреЛрджрдп
ЁЯМЖ => ЁЯМЖ, рдлрд╛рддреЛрдбреНрдбреЗрд╡рдпрд▓реЛ рд╢рд╛рд░реАрд╡рд╛рдард╛рд░, рдлреЛрддреЛрдбреНрдб, рднреВрдВрдп, рд╢рд╛рд░, рд╕рд╛рдВрдЬ, рд╕реБрд░реНрдпрд╛рд╕реНрдд
ЁЯМЗ => ЁЯМЗ, рдлрд╛рддреЛрдбреНрдб, рд╕реБрд░реНрдп, рд╕реБрд░реНрдпрд╛рд╕реНрдд
ЁЯМЙ => ЁЯМЙ, рдкреБрд▓, рд░рд╛рдд, рд░рд╛рддрдЪреЛ рдкреБрд▓
тЩи => тЩи, рдЙрд╖реНрдг, рдЙрд╖реНрдгрдЧреАрдо, рдЧреАрдо, рд╡рд╛рдл
ЁЯОа => ЁЯОа, рдШреЛрдбреЛ, рд╢рд░реНрдпрдд, рд╢рд░реНрдпрддреАрдЪреЛ рдШреЛрдбреЛ
ЁЯОб => ЁЯОб, рдЪрд╛рдХ, рдЬрд╛рддреНрд░рд╛, рдЬрд╛рддреНрд░реЗрддрд▓реЗрдВ рдЪрд╛рдХ, рдордирд░рд┐рдЬрд╡рдг рдЙрджреНрдпрд╛рди
ЁЯОв => ЁЯОв, рдХреЛрд╕реНрдЯрд░, рдордирд░рд┐рдЬрд╡рдг рдЙрджреНрдпрд╛рди, рд░реЛрд▓рд░
ЁЯТИ => ЁЯТИ, рдХреЗрдВрд╕рдХрд╛рддрд░рдк, рдЦрд╛рдВрдмреЛ, рдореНрд╣рд╛рд▓рд╛ рдЦрд╛рдВрдмреЛ, рдореНрд╣рд╛рд▓реЛ
ЁЯОк => ЁЯОк, рддрдВрдмреВ, рд╕рд░реНрдХрд╕, рд╕рд░реНрдХрд╕реАрдЪреЛ рддрдВрдмреВ
ЁЯЪВ => ЁЯЪВ, рдЗрдВрдЬреАрди, рдЯреНрд░реЗрди, рд░реЗрд▓реНрд╡реЗ, рд▓реЛрдХреЛрдореЛрдЯреАрд╡, рд╡рд╛рдл
ЁЯЪГ => ЁЯЪГ, рдХрд╛рд░, рдЯреНрд░реЗрди, рдЯреНрд░реЙрдо, рдЯреНрд░реЛрд▓реАрдмрд╕, рд░реЗрд▓реНрд╡реЗ, рд╡рд┐рдЬ
ЁЯЪД => ЁЯЪД, рдЙрдЪреНрдЪ рд╡реЗрдЧрд╛рдЪреА рдЯреНрд░реЗрди, рдЙрдЪреНрдЪ-рд╡реЗрдЧрд╛рдЪреА рдЯреНрд░реЗрди, рдЯреНрд░реЗрди, рд░реЗрд▓реНрд╡реЗ, рд╡реЗрдЧ, рд╢рд┐рдВрдХрд╛рдирд╕реЗрди
ЁЯЪЕ => ЁЯЪЕ, рдЯреНрд░реЗрди, рдмреБрд▓реЗрдЯ, рд░реЗрд▓реНрд╡реЗ, рд╡реЗрдЧ, рд╢рд┐рдВрдХрд╛рдирд╕реЗрди
ЁЯЪЖ => ЁЯЪЖ, рдЯреНрд░реЗрди, рд░реЗрд▓реНрд╡реЗ
ЁЯЪЗ => ЁЯЪЗ, рдореЕрдЯреНрд░реЛ, рд╕рдмрд╡реЗ
ЁЯЪИ => ЁЯЪИ, рд░реЗрд▓реНрд╡реЗ, рд▓рд╛рдпрдЯ рд░реЗрд▓
ЁЯЪЙ => ЁЯЪЙ, рдЯреНрд░реЗрди, рд░реЗрд▓реНрд╡реЗ, рд╕реНрдЯреЗрд╢рди
ЁЯЪК => ЁЯЪК, рдЯреНрд░рд╛рдо, рдЯреНрд░реЙрд▓рд┐рдмрд╕
ЁЯЪЭ => ЁЯЪЭ, рдореЛрдиреЛрд░реЗрд▓, рд╡рд╛рд╣рди
ЁЯЪЮ => ЁЯЪЮ, рдХрд╛рд░, рдкрд░реНрд╡рдд, рдкрд░реНрд╡рддреАрдп рд░реЗрд▓реНрд╡реЗ, рд░реЗрд▓реНрд╡реЗ
ЁЯЪЛ => ЁЯЪЛ, рдХрд╛рд░, рдЯреНрд░реЙрдо, рдЯреНрд░реЙрд▓рд┐рдмрд╕
ЁЯЪМ => ЁЯЪМ, рдмрд╕, рд╡рд╛рд╣рди
ЁЯЪН => ЁЯЪН, рдмрд╕, рдпреЗрд╡рдкреА
ЁЯЪО => ЁЯЪО, рдЯреНрд░рд╛рдо, рдЯреНрд░реЙрд▓реА, рдЯреНрд░реЙрд▓реАрдмрд╕, рдмрд╕
ЁЯЪР => ЁЯЪР, рдмрд╕, рдорд┐рдиреАрдмрд╕
ЁЯЪС => ЁЯЪС, рдНрдореНрдмреНрдпреБрд▓рдиреНрд╕, рд╡рд╛рд╣рди
ЁЯЪТ => ЁЯЪТ, рдЗрдВрдЬрд┐рди, рдЙрдЬреЛ, рдЙрдЬреНрдпрд╛ рдЗрдВрдЬрд┐рди, рдЯреНрд░рдХ
ЁЯЪУ => ЁЯЪУ, рдХрд╛рд░, рдЧрд╕реНрдд, рдкреЛрд▓рд┐рд╕ рдХрд╛рд░, рдкреЛрд▓реАрд╕
ЁЯЪФ => ЁЯЪФ, рдХрд╛рд░, рдкреЙрд▓рд┐рд╕, рдпреЗрд╡рдкреА, рдпреЗрд╡рдкреА рдкреЙрд▓рд┐рд╕рд╛рдВрдЪреА рдХрд╛рд░
ЁЯЪХ => ЁЯЪХ, рдЯреЕрдХреНрд╕реА, рд╡рд╛рд╣рди
ЁЯЪЦ => ЁЯЪЦ, рдЯреЕрдХреНрд╕реА, рдпреЗрд╡рдкреА
ЁЯЪЧ => ЁЯЪЧ, рдСрдЯреЛрдореЛрдмрд╛рдпрд▓, рдХрд╛рд░
ЁЯЪШ => ЁЯЪШ, рдСрдЯреЛрдореЛрдмрд╛рдпрд▓, рдХрд╛рд░, рдпреЗрд╡рдкреА
ЁЯЪЩ => ЁЯЪЩ, рдХреНрд░реАрдбрд╛ рдЙрдкреЗрдЧрд╛рдЪреЗрдВ, рдХреНрд░реАрдбрд╛ рдЙрдкреЗрдЧрд╛рдЪреЗрдВ рд╡рд╛рд╣рди, рдордирд░рд┐рдЬрд╡рдг
ЁЯЫ╗ => ЁЯЫ╗, рдЯреНрд░рдХ, рдкрд┐рдХ-рдЕрдк, рдкрд┐рдХрдЕрдк
ЁЯЪЪ => ЁЯЪЪ, рдЯреНрд░рдХ, рдбрд┐рд▓рд┐рд╡рд░реА
ЁЯЪЫ => ЁЯЪЫ, рдЖрд░реНрдЯрд┐рдХреБрд▓реЗрдЯреЗрдб рд▓реЙрд░реА, рдЯреНрд░рдХ, рд▓реЙрд░реА, рд╕реЕрдореА
ЁЯЪЬ => ЁЯЪЬ, рдЯреНрд░реЕрдХреНрдЯрд░, рд╡рд╛рд╣рди
ЁЯПО => ЁЯПО, рдХрд╛рд░, рд╢рд░реНрдпрдд, рд╢рд░реНрдпрддреАрдЪреА рдХрд╛рд░
ЁЯПН => ЁЯПН, рдореЛрдЯрд░рд╕рд╛рдпрдХрд▓, рд╕реНрдкрд░реНрдзрд╛
ЁЯЫ╡ => ЁЯЫ╡, рдореЛрдЯрд░, рд╕реНрдХреБрдЯрд░
ЁЯж╜ => ЁЯж╜, рдНрдХреНрд╕реЕрд╕рд┐рдмрд┐рд▓рд┐рдЯреА, рдореЕрдиреНрдпреБрдЕрд▓ рд╡реНрд╣реАрд▓рдЪреЕрд░
ЁЯж╝ => ЁЯж╝, рдНрдХреНрд╕реЕрд╕рд┐рдмрд┐рд▓рд┐рдЯреА, рдореЛрдЯрд░ рдЖрд╕рдкреА рд╡реНрд╣реАрд▓рдЪреЕрд░, рдореЛрдЯреЛрд░рд╛рдпрдЭреНрдб рд╡реНрд╣реАрд▓рдЪреЕрд░
ЁЯЫ║ => ЁЯЫ║, рдСрдЯреЛ рд░рд┐рдХреНрд╖рд╛, рдЯреБрдХ рдЯреБрдХ
ЁЯЪ▓ => ЁЯЪ▓, рдмрд╛рдпрдХ, рдмрд╛рдпрд╕рд┐рдХрд▓
ЁЯЫ┤ => ЁЯЫ┤, рдХрд┐рдХ, рд╕реНрдХреБрдЯрд░
ЁЯЫ╣ => ЁЯЫ╣, рдмреЛрд░реНрдб, рд╕реНрдХреЗрдЯрдмреЛрд░реНрдб
ЁЯЫ╝ => ЁЯЫ╝, рд░реЛрд▓рд░, рд╕реНрдХреЗрдЯ
ЁЯЪП => ЁЯЪП, рдмрд╕, рдмрд╕рд╕реНрдерд╛рдирдХ, рд╕реНрдерд╛рдирдХ
ЁЯЫг => ЁЯЫг, рдореЛрдЯреЛрд░рд╡реЗ, рдореНрд╣рд╛рдорд╛рд░реНрдЧ, рд░рд╕реНрддреЛ
ЁЯЫд => ЁЯЫд, рдЯреНрд░реЗрди, рд░реЗрд▓реНрд╡реЗ, рд░реЗрд▓реНрд╡реЗ рдЯреНрд░реЕрдХ
ЁЯЫв => ЁЯЫв, рддреЗрд▓, рддреЗрд▓рд╛рдЪреЗрдВ рдкрд┐рдВрдк, рдкрд┐рдВрдк
тЫ╜ => тЫ╜, рдЗрдВрдзрди, рдЗрдВрдзрдирд╛рдЪреЛ рдкрдВрдк, рдЧреЕрд╕, рдбрд┐рдЭрд▓, рдкрдВрдк, рд╕реНрдЯреЗрд╢рди
ЁЯЪи => ЁЯЪи, рдХрд╛рд░, рджрд┐рд╡реЛ, рдкреЙрд▓рд┐рд╕, рдмрд┐рдХрди, рд░рд┐рд╡реЛрд▓реНрд╡реАрдВрдЧ
ЁЯЪе => ЁЯЪе, рдЖрдбрд╡реЛ рдпреЗрд░рд╛рджрд╛рд░реА рджрд┐рд╡реЛ, рдЖрдбрд╡реЛ рдпреЗрд░рд╛рджрд╛рд░реАрдЪреЛ рджрд┐рд╡реЛ, рджрд┐рд╡реЛ, рдпреЗрд░рд╛рджрд╛рд░реА, рд╕рд┐рдЧреНрдирд▓
ЁЯЪж => ЁЯЪж, рдЙрдмреЛ рдпреЗрд░рд╛рджрд╛рд░реА рджрд┐рд╡реЛ, рдЙрдмреЛ рдпреЗрд░рд╛рджрд╛рд░реАрдЪреЛ рджрд┐рд╡реЛ, рджрд┐рд╡реЛ, рдпреЗрд░рд╛рджрд╛рд░реА, рд╕рд┐рдЧреНрдирд▓
ЁЯЫС => ЁЯЫС, рдСрдХреНрдЯреЛрдЧреЛрдирд╛рд▓, рдЪрд┐рдиреНрди, рдерд╛рдВрдмрдк, рдерд╛рдВрдмрдкрд╛рдЪреЗрдВ рдЪрд┐рдиреНрди
ЁЯЪз => ЁЯЪз, рдмрд╛рдВрдзрдХрд╛рдо, рдмреЗрд░рд┐рдпрд░
тЪУ => тЪУ, рдЬрд╣рд╛рдЬ, рдирд╛рдВрдЧрд░, рд╕рд╛рдзрди
тЫ╡ => тЫ╡, рджрд░реНрдпрд╛, рдкрдиреЗрд│, рдмреЛрдЯ, рд░реЗрдЭреЙрд░реНрдЯ, рд╕рдлрд░рдЬрд╣рд╛рдЬ
ЁЯЫ╢ => ЁЯЫ╢, рдмреЛрдЯ, рд╡реНрд╣рдбреЗрдВ
ЁЯЪд => ЁЯЪд, рдмреЛрдЯ, рд╡реЗрдЧрдмреЛрдЯ
ЁЯЫ│ => ЁЯЫ│, рдЬрд╣рд╛рдЬ, рдкреНрд░рд╡рд╛рд╕, рдкреНрд░рд╡рд╛рд╕реА рдЬрд╣рд╛рдЬ
тЫ┤ => тЫ┤, рдкреНрд░рд╡рд╛рд╕, рдлреЗрд░реА, рдмреЛрдЯ
ЁЯЫе => ЁЯЫе, рдмреЛрдЯ, рдореЛрдЯреЛрд░ рдмреЛрдЯ, рдореЛрдЯреЛрд░рдмреЛрдЯ
ЁЯЪв => ЁЯЪв, рдЬрд╣рд╛рдЬ, рдкреНрд░рд╡рд╛рд╕реА, рдмреЛрдЯ
тЬИ => тЬИ, рд╡рд┐рдорд╛рди, рд╡рд┐рдорд╛рдирд╛рдВ
ЁЯЫй => ЁЯЫй, рд▓реНрд╣рд╛рди рд╡рд┐рдорд╛рди, рд╡рд┐рдорд╛рди
ЁЯЫл => ЁЯЫл, рдЪреЗрдХ-рдЗрди, рдирд┐рдЧрд░реНрдорди, рдирд┐рдЧрд░реНрдордирд╛рдВ, рд╡рд┐рдорд╛рди, рд╣рд╡рд╛рдИ рд╡рд┐рднрд╛рдЧ
ЁЯЫм => ЁЯЫм, рдЖрдЧрдорди рдЬрд╛рддрд╛, рдЖрдЧрдордирд╛рдВ, рджреЗрдВрд╡рддрд╛, рд╡рд┐рдорд╛рди, рд╡рд┐рдорд╛рди рдЖрдЧрдорди, рд╡рд┐рдорд╛рдирд╛рдЪреЗрдВ рдЖрдЧрдорди
ЁЯкВ => ЁЯкВ, рдкреЕрд░рд╛рд╢реБрдЯ, рдкреЕрд░рд╛рд╕реЗрд▓, рд╕реНрдХрд╛рдпрдбрд╛рдпрд╡, рд╣рдБрдЧ рдЧреНрд▓рд╛рдпрдб
ЁЯТ║ => ЁЯТ║, рдХрджреЗрд▓, рд╕реАрдЯ
ЁЯЪБ => ЁЯЪБ, рд╡рд╛рд╣рди, рд╣реЕрд▓рд┐рдХреЙрдкреНрдЯрд░
ЁЯЪЯ => ЁЯЪЯ, рд░реЗрд▓реНрд╡реЗ, рд╣реБрдордХрд│рдк, рд╣реБрдордХрд│рдкреА рд░реЗрд▓реНрд╡реЗ
ЁЯЪа => ЁЯЪа, рдХреЗрдмрд▓, рдЧреЛрдВрдбреЛрд▓рд╛, рдкрд░реНрд╡рдд, рдкрд░реНрд╡рдд рдХреЗрдмрд▓рд╡реЗ
ЁЯЪб => ЁЯЪб, рдПрд░рд┐рдпрд▓, рдХрд╛рд░, рдХреЗрдмрд▓, рдЧреЛрдВрдбреЛрд▓рд╛, рдЯреНрд░реЙрдорд╡реЗ
ЁЯЫ░ => ЁЯЫ░, рдЕрдВрддрд░рд╛рд│, рдЙрдкрдЧреНрд░рд╣
ЁЯЪА => ЁЯЪА, рдЕрдВрддрд░рд╛рд│, рд░реЙрдХреЗрдЯ
ЁЯЫ╕ => ЁЯЫ╕, рдЙрдбрдг рддрд╢реНрдХрд░реА, рдпреБрдПрдлрдУ
ЁЯЫО => ЁЯЫО, рдмреЕрд▓, рдмреЕрд▓рд╣реЛрдк, рдмреЕрд▓рд╣реЛрдк рдмреЗрд▓, рд╣реЙрдЯреЗрд▓
ЁЯз│ => ЁЯз│, рдкреЕрдХреАрдВрдЧ, рднреЛрдВрд╡рдбреА, рд╕рд╛рдорд╛рдпрди
тМЫ => тМЫ, рдЖрд╡рд░рдЧреНрд▓рд╛рд╕ рдЬрд╛рд▓реЗрдВ, рд░реЗрдВрд╡, рд╡реЗрд│
тП│ => тП│, рдЖрд╡рд░рдЧреНрд▓рд╛рд╕, рдЖрд╡рд░рдЧреНрд▓рд╛рд╕ рдЬрд╛рд╡рдВрдХ рдирд╛, рд░реЗрдВрд╡, рд╡реЗрд│
тМЪ => тМЪ, рдШрдбреА, рдШрдбреНрдпрд╛рд│
тП░ => тП░, рдЗрд╢рд╛рд░рдд, рдЗрд╢рд╛рд░рддреАрдЪреЗрдВ рдШрдбреНрдпрд╛рд│, рдШрдбреНрдпрд╛рд│
тП▒ => тП▒, рдШрдбреНрдпрд╛рд│, рд╕реНрдЯреЙрдкрд╡реЙрдЪ
тП▓ => тП▓, рдШрдбреНрдпрд╛рд│, рд╡реЗрд│
ЁЯХ░ => ЁЯХ░, рдШрдбреНрдпрд╛рд│, рдордБрдЯреЗрд▓рдкреАрд╕ рдШрдбреНрдпрд╛рд│
ЁЯХЫ => ЁЯХЫ, 00, 12, 12:00, рдШрдбреНрдпрд╛рд│, рдмрд╛рд░рд╛, рд╡рд░рд╛рдВ
ЁЯХз => ЁЯХз, 12, 12:30, рдШрдбреНрдпрд╛рд│, рддреАрд╕, рдмрд╛рд░рд╛, рд╕рд╛рдбреЗ-рдмрд╛рд░рд╛
ЁЯХР => ЁЯХР, 00, 1, 1:00, рдПрдХ, рдПрдХ рд╡рд░, рдШрдбреНрдпрд╛рд│, рд╡рд░рд╛рдВ
ЁЯХЬ => ЁЯХЬ, 1, 1:30, рдПрдХ, рдШрдбреНрдпрд╛рд│, рддреАрд╕, рджреЗрдб
ЁЯХС => ЁЯХС, 00, 2, 2:00, рдШрдбреНрдпрд╛рд│, рджреЛрди, рд╡рд░рд╛рдВ
ЁЯХЭ => ЁЯХЭ, 2, 2:30, рдЕрдбреЗрдЬ, рдШрдбреНрдпрд╛рд│, рддреАрд╕, рджреЛрди
ЁЯХТ => ЁЯХТ, 00, 3, 3:00, рдШрдбреНрдпрд╛рд│, рддреАрди, рд╡рд░рд╛рдВ
ЁЯХЮ => ЁЯХЮ, 3, 3:30, рдШрдбреНрдпрд╛рд│, рддреАрди, рддреАрд╕, рд╕рд╛рдбреЗ-рддреАрди
ЁЯХУ => ЁЯХУ, 00, 4, 4:00, рдШрдбреНрдпрд╛рд│, рдЪрд╛рд░, рд╡рд░рд╛рдВ
ЁЯХЯ => ЁЯХЯ, 4, 4:30, рдШрдбреНрдпрд╛рд│, рдЪрд╛рд░, рддреАрд╕, рд╕рд╛рдбреЗ-рдЪрд╛рд░
ЁЯХФ => ЁЯХФ, 00, 5, 5:00, рдШрдбреНрдпрд╛рд│, рдкрд╛рдЪ, рдкрд╛рдВрдЪ рд╡рд░рд╛рдВ, рд╡рд░рд╛рдВ
ЁЯХа => ЁЯХа, 5, 5:30, рдШрдбреНрдпрд╛рд│, рддреАрд╕, рдкрд╛рдВрдЪ, рд╕рд╛рдбреЗ-рдкрд╛рдЪ, рд╕рд╛рдбреЗ-рдкрд╛рдВрдЪ
ЁЯХХ => ЁЯХХ, 00, 6, 6:00, рдШрдбреНрдпрд╛рд│, рд╡рд░рд╛рдВ, рд╕
ЁЯХб => ЁЯХб, 6, 6:30, рдШрдбреНрдпрд╛рд│, рддреАрд╕, рд╕, рд╕рд╛рдбреЗ  рд╕, рд╕рд╛рдбреЗ-рд╕
ЁЯХЦ => ЁЯХЦ, 00, 7, 7:00, рдШрдбреНрдпрд╛рд│, рд╡рд░рд╛рдВ, рд╕рд╛рдд
ЁЯХв => ЁЯХв, 7, 7:30, рдШрдбреНрдпрд╛рд│, рддреАрд╕, рд╕рд╛рдбреЗ-рд╕рд╛рдд, рд╕рд╛рдд
ЁЯХЧ => ЁЯХЧ, 00, 8, 8:00, рдЖрда, рдШрдбреНрдпрд╛рд│, рд╡рд░рд╛рдВ
ЁЯХг => ЁЯХг, 8, 8:30, рдШрдбреНрдпрд╛рд│, рддреАрд╕, рд╕рд╛рдбреЗ-рдЖрда
ЁЯХШ => ЁЯХШ, 00, 9, 9:00, рдШрдбреНрдпрд╛рд│, рдгрд╡, рд╡рд░рд╛рдВ
ЁЯХд => ЁЯХд, 9, 9:30, рдШрдбреНрдпрд╛рд│, рдгрд╡, рддреАрд╕, рд╕рд╛рдбреЗ-рдгрд╡
ЁЯХЩ => ЁЯХЩ, 00, 10, 10:00, рдШрдбреНрдпрд╛рд│, рдзрд╛, рд╡рд░рд╛рдВ
ЁЯХе => ЁЯХе, 10, 10:30, рдШрдбреНрдпрд╛рд│, рддреАрд╕, рдзрд╛, рд╕рд╛рдбреЗ-рдзрд╛
ЁЯХЪ => ЁЯХЪ, 00, 11, 11:00, рдЗрдХрд░рд╛, рдШрдбреНрдпрд╛рд│, рд╡рд░рд╛рдВ
ЁЯХж => ЁЯХж, 11, 11:30, рдЗрдХрд░рд╛, рдШрдбреНрдпрд╛рд│, рддреАрд╕, рд╕рд╛рдбреЗ-рдЗрдХрд░рд╛
ЁЯМС => ЁЯМС, рдЕрдорд╛рд╕, рдХрд╛рд│реЛрдЦ, рдЪрдВрджреНрд░
ЁЯМТ => ЁЯМТ, рдЕрд░реНрдж, рдХреЛрд░, рдЪрдВрджреНрд░
ЁЯМУ => ЁЯМУ, рдЪрдВрджреНрд░, рдкрдВрджрд░рд╕, рдкрдпрд▓реА рдкрдВрджрд░рд╕, рдкрдпрд▓реНрдпрд╛ рдкрдВрджрд░рд╢реАрдЪреЛ рдЪрдВрджреНрд░
ЁЯМФ => ЁЯМФ, рдЪрдВрджреНрд░, рд╡рдЪрдкреА, рд╡рд╛рдбрдд
ЁЯМХ => ЁЯМХ, рдЪрдВрджреНрд░, рдкреБрдирд╡реЗрдЪреЛ
ЁЯМЦ => ЁЯМЦ, рдЪрддреБ, рдЪрддреБрд░реНрджрд╢реАрдЪреЛ рдЪрдВрджреНрд░, рдЪрдВрджреНрд░, рд░реНрджрд╢реАрдЪреЛ
ЁЯМЧ => ЁЯМЧ, рдЪрдВрджреНрд░, рдирд┐рдорд╛рдгреНрдпрд╛ рдкрдВрджрд░рд╢реАрдЪреЛ рдЪрдВрджреНрд░, рдкрдВрджрд░рд╕
ЁЯМШ => ЁЯМШ, рдХреНрд╖рдп, рдЪрдВрджреНрд░, рдЬрд╛рд╡рдкреА
ЁЯМЩ => ЁЯМЩ, рдХреНрд╖рдп, рдЪрдВрджреНрд░
ЁЯМЪ => ЁЯМЪ, рдЕрдорд╛рд╢реЗрдЪреНрдпрд╛ рдЪрдВрджреНрд░рд╛рдЪреЛ рдЪреЗрд░реЛ, рдЪрдВрджреНрд░, рдЪреЗрд░реЛ
ЁЯМЫ => ЁЯМЫ, рдЪрдВрджреНрд░, рдЪреЗрд░реЛ, рдкрдВрджрд░рд╕, рдкрдпрд▓реНрдпрд╛ рдкрдВрджрд░рд╢реАрдЪреНрдпрд╛ рдЪрдВрджреНрд░рд╛рдЪреЛ рдЪреЗрд░реЛ
ЁЯМЬ => ЁЯМЬ, рдЪрдВрджреНрд░, рдЪреЗрд░реЛ, рдирд┐рдорд╛рдгреНрдпрд╛ рдкрдВрджрд░рд╢реАрдЪреНрдпрд╛ рдЪрдВрджреНрд░рд╛рдЪреЛ рдЪреЗрд░реЛ, рдкрдВрджрд░рд╕
ЁЯМб => ЁЯМб, рдерд░реНрдореЛрдореАрдЯрд░, рд╣рд╡рд╛рдорд╛рди
тША => тША, рдХрд┐рд░рдгрд╛рдВ, рдкреНрд░рдХрд╛рд╢, рд╡рдд, рд╕реБрд░реНрдп
ЁЯМЭ => ЁЯМЭ, рдЪрдВрджреНрд░, рдЪреЗрд░реЛ, рдкреБрдирд╡, рдкреБрдирд╡реЗрдЪреНрдпрд╛ рдЪрдВрджреНрд░рд╛рдЪреЛ рдЪреЗрд░реЛ, рдкреНрд░рдХрд╛рд╢
ЁЯМЮ => ЁЯМЮ, рдЪреЗрд░реЛ, рдкреНрд░рдХрд╛рд╢, рд╕реБрд░реНрдп, рд╕реБрд░реНрдпрд╛рдЪреЛ рдЪреЗрд░реЛ
ЁЯкР => ЁЯкР, рд╡рдпрд▓ рдЖрд╕рдкреА рдЧрд┐рд░реЛ, рд╡рд▓рдп рдЖрд╕рдкреА рдЧрд┐рд░реЛ, рд╢рдиреА, рд╢рдиреАрд╡рд▓рдп
тнР => тнР, рдирдЦреЗрддреНрд░
ЁЯМЯ => ЁЯМЯ, рдЪрдХрдЪрдХ, рдЪрдХрдЪрдХреАрдд, рдЭрдЧрдордЧ, рдЭрдЧрдордЧрддрд╛, рдЭрдЧрдордЧрдкреА рдирдЦреЗрддреНрд░, рдирдЦреЗрддреНрд░, рдорд┐рдгрдорд┐рдгрдкреА рдирдЦреЗрддреНрд░
ЁЯМа => ЁЯМа, рдирдЦреЗрддреНрд░, рдкрдбрдкреА, рд╢реБрдЯреАрдВрдЧ
ЁЯММ => ЁЯММ, рдЕрдВрддрд░рд╛рд│, рджреВрдж рдЧрдВрдЧрд╛
тШБ => тШБ, рдврдЧ, рд╣рд╡рд╛рдорд╛рди
тЫЕ => тЫЕ, рдврдЧ, рдврдЧрд╛ рдЖрдбрдЪреЛ рд╕реБрд░реНрдп, рд╕реБрд░реНрдп
тЫИ => тЫИ, рдЧрдбрдЧрдб рдЖрдиреА рдкрд╛рд╡рд╕рд╛рдЪреЗ рдврдЧ, рдврдЧ
ЁЯМд => ЁЯМд, рдврдЧ, рд▓реНрд╣рд╛рди рдврдЧрд╛ рдЖрдбрдЪреЛ рд╕реБрд░реНрдп, рд╕реБрд░реНрдп
ЁЯМе => ЁЯМе, рдврдЧ, рд╡реНрд╣рдбрд▓реНрдпрд╛ рдврдЧрд╛ рдЖрдбрдЪреЛ рд╕реБрд░реНрдп, рд╕реБрд░реНрдп
ЁЯМж => ЁЯМж, рдврдЧ, рдкрд╛рд╡рд╕, рдкрд╛рд╡рд╕рд╛рдЪреНрдпрд╛ рдврдЧрд╛ рдЖрдбрдЪреЛ рд╕реБрд░реНрдп, рд╕реБрд░реНрдп
ЁЯМз => ЁЯМз, рдврдЧ, рдкрд╛рд╡рд╕, рдкрд╛рд╡рд╕рд╛рдЪреЛ рдврдЧ
ЁЯМи => ЁЯМи, рдврдЧ, рдердВрдб, рдмрд░реНрдл, рд╣рд┐рдо рдврдЧ, рд╣реАрдо рдврдЧ
ЁЯМй => ЁЯМй, рдврдЧ, рд╡рд┐рдЬрд╛рдВрдЪреЛ рдврдЧ
ЁЯМк => ЁЯМк, рдЪрдХреНрд░реАрд╡рд╛рджрд│, рдЯреЛрд░реНрдирд╛рдбреЛ, рдврдЧ
ЁЯМл => ЁЯМл, рдврдЧ, рдзреБрдХреЗрдВ
ЁЯМм => ЁЯМм, рдЪреЗрд░реЛ, рдврдЧ, рд╡рд╛-рдпрд╛рдЪреЛ рдЪреЗрд░реЛ, рд╡рд╛рд░реЗрдВ, рд╡реНрд╣рд╛рдВрд╡рддрд╛
ЁЯМА => ЁЯМА, рдШреБрд╕реНрдкрд▓реНрд▓реЗрдВ, рдЪрдХреНрдХрд░, рдЪрдХреНрд░реАрд╡рд╛рджрд│, рдЯрд╛рдпрдлреВрди, рд╣реБрд░реАрдХреЗрди
ЁЯМИ => ЁЯМИ, рдЗрдВрджреНрд░рдзреЛрдгреВ, рдкрд╛рд╡рд╕
ЁЯМВ => ЁЯМВ, рдХрдкрдбреЗ, рдзрд╛рдВрдкрд┐рд▓реНрд▓реА рд╕рддреНрд░реА, рдкрд╛рд╡рд╕, рд╕рддреНрд░реА
тШВ => тШВ, рдХрдкрдбреЗ, рдкрд╛рд╡рд╕, рд╕рддреНрд░реА
тШФ => тШФ, рдХрдкрдбреЗ, рдереЗрдВрдмреЛ, рдкрд╛рд╡рд╕, рдкрд╛рд╡рд╕рд╛рдЪреЗ рдереЗрдВрдмреЗ рдЖрд╢рд┐рд▓реНрд▓реА рд╕рддреНрд░реА, рдкрд╛рд╡рд╕рд╛рдЪреЗ рдереЗрдВрдмреЗрдВ рдЖрд╕рдкреА рд╕рддреНрд░реА, рд╕рддреНрд░реА
тЫ▒ => тЫ▒, рдЬрдордиреАрдЪреЗрд░ рд╕рддреНрд░реА, рдкрд╛рд╡рд╕, рднреБрдВрдпреЗрдЪреЗрд░ рд╕рддреНрд░реА, рд╕рддреНрд░реА, рд╕реБрд░реНрдп
тЪб => тЪб, рдЙрдЪреНрдЪ рджрд╛рдм, рдШрд╛рддрдХ, рдЭреЕрдк, рджрд╛рдм, рд╡рд┐рдЬ, рд╡рд┐рдЬреЛ
тЭД => тЭД, рдердВрдб, рдмрд░реНрдл, рд╣рд┐рдо рдкрд╛рд╡рд╕
тШГ => тШГ, рдердВрдб, рд╣рд┐рдо, рд╣рд┐рдордорд╛рдирд╡
тЫД => тЫД, рдердВрдб, рд╣рд┐рдо, рд╣рд┐рдордорд╛рдирд╡, рд╣рд┐рдорд╛ рд╢рд┐рд╡рд╛рдп рд╣рд┐рдордорд╛рдирд╡
тШД => тШД, рдЕрдВрддрд░рд╛рд│, рдзреБрдордХреЗрддреВ
ЁЯФе => ЁЯФе, рдЙрдЬреЛ, рдЬреНрдпреЛрдд, рд╕рд╛рдзрди
ЁЯТз => ЁЯТз, рдШрд╛рдо, рдердВрдб, рдереЗрдВрдмреЗ, рдереЗрдВрдмреЛ, рд╡рд┐рдиреЛрджреА
ЁЯМК => ЁЯМК, рдЙрджрдХ, рдЙрджрдХрд╛рдЪреЛ рддрд░рдВрдЧ, рддрд░рдВрдЧ, рдореНрд╣рд╛рд╕рд╛рдЧрд░
ЁЯОГ => ЁЯОГ, рдЬреЕрдХ, рдЬреЕрдХ-рдУ-рд▓реЕрдиреНрдЯрд░реНрди, рд▓реЕрдиреНрдЯрд░реНрди, рд╕реБрд╡рд╛рд│реЛ, рд╣реЕрд▓реЛрд╡рд┐рди
ЁЯОД => ЁЯОД, рдЭрд╛рдб, рдирд╛рддрд╛рд│, рдирд╛рддрд╛рд│рд╛рдЪреЗрдВ рдЭрд╛рдб, рд╕реБрд╡рд╛рд│реЛ
ЁЯОЖ => ЁЯОЖ, рдлреЛрдЧ, рд╕реБрд╡рд╛рд│реЛ
ЁЯОЗ => ЁЯОЗ, рдард┐рдгрдЧреА, рдард┐рдгрдЧреНрдпреЛ, рдврд┐рдгрдЧреА рдХрд╛рдбрдкреА, рдлреЛрдЧ, рд╕реБрд╡рд╛рд│реЛ
ЁЯзи => ЁЯзи, рдбрд╛рдпрдирд╛рдорд╛рдпрдЯ, рдлреЛрдЧ, рдлреЛрдЧрд╛рдЪреЗрдВ, рд╕реНрдлреЛрдЯрдХ
тЬи => тЬи, рдард┐рдгрдЧреА, рдард┐рдгрдЧреА рдХрд╛рдбрдкреА, рдирдЦреЗрддреНрд░
ЁЯОИ => ЁЯОИ, рдмреЛрдорд╛рдбреЛ, рд╕реБрд╡рд╛рд│реЛ
ЁЯОЙ => ЁЯОЙ, рдЯрд╛рдбрд╛, рдкрд╛рд░реНрдЯреА, рдкреЛрдкрд░, рд╕реБрд╡рд╛рд│реЛ
ЁЯОК => ЁЯОК, рдХреЙрдиреНрдлреЗрдЯреА, рдмреЙрд▓, рд╕реБрд╡рд╛рд│реЛ
ЁЯОЛ => ЁЯОЛ, рдЬрдкрд╛рдиреА, рдЭрд╛рдб, рддрд╛рдирд╛рдмрд╛рдЯрд╛ рдЭрд╛рдб, рдкрддрд╛рдХрд╛, рд╕реБрд╡рд╛рд│реЛ
ЁЯОН => ЁЯОН, рдЬрдкрд╛рдиреА, рджреЗрд╡рджрд╛рд░, рджреЗрд╡рджрд╛рд░ рд╕рдЬрд╛рд╡рдЯ, рдмрд╛рдВрдмреВреВ, рд╕реБрд╡рд╛рд│реЛ
ЁЯОО => ЁЯОО, рдЙрддреНрд╕рд╡, рдЬрдкрд╛рдиреА, рдЬрдкрд╛рдиреА рдмрд╛рд╡рд▓реНрдпреЛ, рдмрд╛рд╡рд▓реА, рд╕реБрд╡рд╛рд│реЛ
ЁЯОП => ЁЯОП, рдХрд╛рд░реНрдк, рд╕реБрд╡рд╛рд│реЛ, рд╕реНрдЯреНрд░рд┐рдореЗрд░
ЁЯОР => ЁЯОР, рдЪрд╛рдпрдо, рдмреЕрд▓, рд╡рд┐рдВрдб, рд╕реБрд╡рд╛рд│реЛ
ЁЯОС => ЁЯОС, рдЪрдВрджреНрд░, рдЪрдВрджреНрд░ рдкрд│реЛрд╡рдкрд╛рдЪреЛ рд╕реБрд╡рд╛рд│реЛ, рджрдмрд╛рдЬреЛ, рд╕реБрд╡рд╛рд│реЛ
ЁЯзз => ЁЯзз, рддрд╛рдВрдмрдбреЗрдВ рдПрдиреНрд╡рд╛рд▓реЙрдк, рдкрдпрд╢реЗ, рднреЗрдЯ, рд▓рд╛рдп рд╕реА, рд╢реВрдн рд▓рд╛рдн, рд╣реЛрдВрдЧрдмрд╛рд╡
ЁЯОА => ЁЯОА, рд░рд┐рдмреАрди, рд╕реБрд╡рд╛рд│реЛ
ЁЯОБ => ЁЯОБ, рдЧреБрдард▓рд╛рдпрд┐рд▓реНрд▓реА рднреЗрдЯ, рдЧреБрдард▓рд╛рдпрд┐рд▓реНрд▓реЗрдВ, рдмреЙрдХреНрд╕, рднреЗрдЯ, рднреЗрдЯрд╡рд╕реНрддреВ, рд╕реБрд╡рд╛рд│реЛ
ЁЯОЧ => ЁЯОЧ, рд░рд┐рдмреАрди, рд╕реБрд╡рд╛рд│реЛ, рд╕реНрдорд░рдг
ЁЯОЯ => ЁЯОЯ, рддрд┐рдХреЗрдЯ, рдкреНрд░рд╡реЗрд╢, рдкреНрд░рд╡реЗрд╢ рддрд┐рдХреЗрдЯреА, рдкреНрд░рд╡реЗрд╢рд╛рдЪреНрдпреЛ рддрд┐рдХреЗрдЯреА
ЁЯОл => ЁЯОл, рддрд┐рдХреЗрдЯ, рдкреНрд░рд╡реЗрд╢
ЁЯОЦ => ЁЯОЦ, рдкрджрдХ, рд▓рд╕реНрдХрд░реА, рд╕реБрд╡рд╛рд│реЛ
ЁЯПЖ => ЁЯПЖ, рдХрд░рдВрдбрдХ, рдкреБрд░рд╕реНрдХрд╛рд░
ЁЯПЕ => ЁЯПЕ, рдХреНрд░реАрдбрд╛ рдкрджрдХрд╛рдВ, рдкрджрдХ
ЁЯеЗ => ЁЯеЗ, 1рд▓реНрдпрд╛ рд╕реБрд╡рд╛рддреЗрдЪреЗрдВ рдкрджрдХ, рдкрджрдХ, рдкрдпрд▓реЗрдВ, рднрд╛рдВрдЧрд░
ЁЯеИ => ЁЯеИ, 2-рдпрд╛ рд╕реБрд╡рд╛рддреЗрдЪреЗрдВ рдкрджрдХ, рджреБрд╕рд░реЗрдВ, рдкрджрдХ, рд░реБрдкреНрдпрд╛
ЁЯеЙ => ЁЯеЙ, 3-рдпрд╛ рд╕реБрд╡рд╛рддреЗрдЪреЗрдВ рдкрджрдХ, рдХрд╛рд╕реНрдп, рддрд┐рд╕рд░реЗрдВ, рдкрджрдХ
тЪ╜ => тЪ╜, рдлреБрдЯрдмреЙрд▓, рдмреЙрд▓, рд╕реЛрдХрд░
тЪ╛ => тЪ╛, рдмреЗрд╕рдмреЙрд▓, рдмреЙрд▓
ЁЯеО => ЁЯеО, рдЕрдВрдбрд░рдЖрд░реНрдо, рдмреЙрд▓, рдореЛрдЬреЗ, рд╕реЙрдлреНрдЯрдмреЙрд▓
ЁЯПА => ЁЯПА, рдмрд╛рд╕реНрдХреЗрдЯрдмреЙрд▓, рдмреЙрд▓, рд╣реВрдк
ЁЯПР => ЁЯПР, рдЧреЗрдо, рдмреЙрд▓, рд╡реЙрд▓рд┐рдмреЙрд▓
ЁЯПИ => ЁЯПИ, рдЕрдореЗрд░рд┐рдХрди, рдлреВрдЯрдмреЙрд▓, рдмреЙрд▓
ЁЯПЙ => ЁЯПЙ, рдлреВрдЯрдмреЙрд▓, рдмреЙрд▓, рд░реБрдЧреНрдмреА
ЁЯО╛ => ЁЯО╛, рдЯреЗрдирд┐рд╕, рдмреЙрд▓, рд░рд╛рдХреЗрдЯ
ЁЯеП => ЁЯеП, рдЕрд▓реНрдЯреАрдореЗрдЯ, рдЧреЛрд│рд╛ рдлреЗрдХ
ЁЯО│ => ЁЯО│, рдЦреЗрд│, рдмреЙрд▓, рдмреЙрд▓рд┐рдВрдЧ
ЁЯПП => ЁЯПП, рдХреНрд░рд┐рдХреЗрдЯ рдЦреЗрд│, рдЧреЗрдо, рдмреЕрдЯ, рдмреЙрд▓
ЁЯПС => ЁЯПС, рдЧреЗрдо, рдлрд┐рд▓реНрдб, рдмреЙрд▓, рд╕реНрдЯреАрдХ, рд╣реЙрдХреА
ЁЯПТ => ЁЯПТ, рдЖрдпрд╕ рд╣реЙрдХреА, рдЦреЗрд│, рдкрдХ, рдмрд░реНрдл, рд╕реНрдЯреАрдХ, рд╣реЙрдХреА
ЁЯеН => ЁЯеН, рдЧреЛрд▓, рдмреЙрд▓, рд▓реЕрдХреНрд░реЛрд╕реЗ, рд╕реНрдЯрд┐рдХ
ЁЯПУ => ЁЯПУ, рдЧреЗрдо, рдЯреЗрдмрд▓ рдЯреЗрдирд┐рд╕, рдкрд┐рдВрдЧ рдкреЛрдВрдЧ, рдкреЕрдбрд▓, рдмреЕрдЯ, рдмреЙрд▓
ЁЯП╕ => ЁЯП╕, рдЧреЗрдо, рдмрд┐рд░реНрдбреА, рдмреЕрдбрдорд┐рдВрдЯрди, рд░реЕрдХреЗрдЯ, рд╢рдЯрд▓рдХреЙрдХ
ЁЯеК => ЁЯеК, рдмреЙрдХреНрд╕реАрдВрдЧ, рдореЛрдЬреЗ
ЁЯеЛ => ЁЯеЛ, рдХрд░рд╛рдЯреЗ, рдЬреНрдпреБрдбреЛ, рддрд╛рдпрдХрд╛рдВрдбреЛ, рдорд╛рд░реНрд╢рд▓ рдЖрд░реНрдЯреНрд╕, рдорд╛рд░реНрд╢рд▓ рдЖрд░реНрдЯреНрд╕ рдпреБрдирд┐рдлреЙрд░реНрдо, рдпреБрдирд┐рдлреЙрд░реНрдо
ЁЯеЕ => ЁЯеЕ, рдЧреЛрд▓, рдЬрд╛рд│реА
тЫ│ => тЫ│, рдЧреЛрд▓реНрдл, рдмреБрд░рд╛рдХ, рдмреБрд░рд╛рдХрд╛рдВрдд рдмрд╛рд╡рдЯреЛ
тЫ╕ => тЫ╕, рдЖрдпрд╕, рд╕реНрдХреЗрдЯ
ЁЯОг => ЁЯОг, рдЧрд░реЛ, рдиреБрд╕реНрддреНрдпрд╛рдЪреЛ рдЧрд░реЛ, рдиреБрд╕реНрддреНрдпреЗрдВ
ЁЯд┐ => ЁЯд┐, рдбрд╛рдпрд╡рд┐рдВрдЧ, рдбрд╛рдпрд╡рд┐рдВрдЧ рдорд╛рд╕реНрдХ, рд╕реНрдХреБрдмрд╛, рд╕реНрдиреЛрд░рдХреЗрд▓рд┐рдВрдЧ
ЁЯО╜ => ЁЯО╜, рдЕрдерд▓реЗрдЯреАрдХреНрд╕, рдзрд╛рдВрд╡рдкреА, рд╢рд░реНрдЯ, рд╕реНрд▓реЕрд╢
ЁЯО┐ => ЁЯО┐, рдмрд░реНрдл, рд╕реНрдХрд╛рдп, рд╕реНрдХрд╛рдпреНрд╕
ЁЯЫ╖ => ЁЯЫ╖, рд╕реНрд▓реЗрдЬ, рд╕реНрд▓реЗрдЬреНрд╕, рд╕реНрд▓реЗрдб
ЁЯеМ => ЁЯеМ, рдХрд░реНрд▓рд┐рдВрдЧ рд╕реНрдЯреЛрди, рдЧреЗрдо, рдлрд╛рддреЛрд░
ЁЯОп => ЁЯОп, рдЧреЗрдо, рдбрд╛рд░реНрдЯ, рдереЗрдЯ рдЯрдкреНрдкреЛ, рдмреВрд▓реНрд╕рдЖрдп, рд▓рдХреНрд╖реНрдп, рд╣реАрдЯ
ЁЯкА => ЁЯкА, рдЙрдлреЗрд╡рдкреА, рдЦреЗрд│рдгреЗрдВ, рдпреЛ рдпреЛ, рдпреЛ-рдпреЛ
ЁЯкБ => ЁЯкБ, рдЙрдбрдк, рдзрд╛рдЧреЛ, рдкрддрдВрдЧ
ЁЯО▒ => ЁЯО▒, 8, рдЖрда, рдЧреЗрдо, рдкреВрд▓ 8 рдмреЙрд▓, рдмрд┐рд▓рд┐рдпрд╛рд░реНрдб, рдмреЙрд▓
ЁЯФо => ЁЯФо, рдХреНрд░рд┐рд╕реНрдЯрд▓, рдирд╡рд▓ рдХрдерд╛, рдкрд░реА рдХрдерд╛, рдмреЙрд▓, рд╕рднрд╛рдЧреНрдп, рд╕рд╛рдзрди
ЁЯкД => ЁЯкД, рдЪреЗрдЯрдХреАрдг, рдЬрд╛рджреБрдЧрд╛рд░, рдЬрд╛рджреБрдЪреА рдХрд╛рдбреА, рдЬрд╛рджреВ
ЁЯз┐ => ЁЯз┐, рдЖрдХрд░реНрд╢рдг, рдЬрд╛рджреБрдЧрд╛рд░ рдирдЬрд░, рдирдЬрд░ рддрд╛рдИрдд, рдордгреА, рд╡рд╛рдпрдЯ-рджреЛрд│реЛ
ЁЯОо => ЁЯОо, рдЧреЗрдо, рдирд┐рдпрдВрддреНрд░рдХ, рд╡реНрд╣рд┐рдбрд┐рдпреЛ рдЧреЗрдо
ЁЯХ╣ => ЁЯХ╣, рдЧреЗрдо, рдЬреЙрдпрд╕реНрдЯрд┐рдХ, рдЬреЙрдпрд╕реНрдЯрд┐рдХреНрд╕, рд╡реНрд╣рд┐рдбрд┐рдпреЛ рдЧреЗрдо
ЁЯО░ => ЁЯО░, рдЧреЗрдо, рд╕реНрд▓реЙрдЯ, рд╕реНрд▓реЙрдЯ рдорд╢реАрди
ЁЯО▓ => ЁЯО▓, рдЦреЗрд│, рдЦреЗрд│рд╛ рдЧрдбрдЧрдбреЛ, рдЧрдбрдЧрдбреЗ, рдЧрдбрдЧрдбреЛ
ЁЯзй => ЁЯзй, рдХреБрдбрдХреЛ, рдХреБрд╡рд╛рдбреЗрдВ, рдШреБрд╕рдкрдкреА, рдЬрд┐рдЧрд╕реЙ, рд╕рдВрдХреЗрдд
ЁЯз╕ => ЁЯз╕, рдЦреЗрд│рдгреАрдВ, рдЦреЗрд│рдгреЗрдВ, рдЯреЗрдбреА рдмрд┐рдпрд░, рдкреНрд▓рд╢, рднрд░рд┐рд▓реНрд▓реЗрдВ
ЁЯкЕ => ЁЯкЕ, рдкрд╛рд░реНрдЯреА, рдкрд┐рдирд╛рдЯрд╛, рд╕реБрд╡рд╛рд│реЛ
ЁЯкЖ => ЁЯкЖ, рдиреЗрд╕реНрдЯреАрдВрдЧ, рдиреЗрд╕реНрдЯреАрдВрдЧ рдбреЙрд▓реНрд╕, рдмрд╛рд╡рд▓реА, рд░реБрд╕
тЩа => тЩа, рдЦреЗрд│, рдкрддреНрддреЗ, рд╕реНрдкреЗрдб рд╕реВрдЯ
тЩе => тЩе, рдЦреЗрд│, рдкрддреНрддреЗ, рд╣рд╛рд░реНрдЯ рд╕реВрдЯ
тЩж => тЩж, рдЧреЗрдо, рдбрд╛рдпрдордВрдб рд╕реВрдЯ, рдкрддреНрддреЗ
тЩг => тЩг, рдХреНрд▓рдм рд╕реВрдЯ, рдЧреЗрдо, рдкрддреНрддреЗ
тЩЯ => тЩЯ, рдбреБрдк, рдмреБрдзреНрджреАрдмрд│, рдмреБрдзреНрджреАрдмрд│рд╛рдЪреЛ рдкрдЯ, рд╡рд┐рд╕реНрддрд╛рд░реАрдд
ЁЯГП => ЁЯГП, рдЧреЗрдо, рдЬреЛрдХрд░, рдкрддреНрддреЛ, рд╡рд╛рдпрд▓реНрдбрдХрд╛рд░реНрдб
ЁЯАД => ЁЯАД, рдЧреЗрдо, рддрд╛рдВрдмрдбреЛ, рдорд╣рдЬреЛрдВрдЧ, рдорд╣рдЬреЛрдВрдЧ рддрд╛рдВрдмрдбреЛ рдбреНрд░реЗрдЧреЙрди
ЁЯО┤ => ЁЯО┤, рдЦреЗрд│, рдЦреЗрд│рдЯрд╛, рдЬрдкрд╛рдиреА, рдкрддреНрддреЗ, рдлреБрд▓ рдЦреЗрд│рдкрд╛ рдкрддреНрддреЗ, рдлреВрд▓, рдлреВрд▓ рдЦреЗрд│рдкрд╛ рдкрддреНрддреЗ
ЁЯОн => ЁЯОн, рдХрд▓рд╛, рдерд┐рдпреЗрдЯрд░, рдорд╛рд╕реНрдХ, рд╕рд╛рджрд░реАрдХрд░рдг
ЁЯЦ╝ => ЁЯЦ╝, рдХрд▓рд╛, рдЪрд┐рддреНрд░, рдЪрд┐рддреНрд░рдХрд▓рд╛, рдЪреМрдХрдЯ, рдЪреМрдХрдЯреАрддрд▓реЗрдВ рдЪрд┐рддреНрд░, рдореНрдпреБрдЬрд┐рдпрдо
ЁЯОи => ЁЯОи, рдХрд▓рд╛, рдЪрд┐рддреНрд░рдХрд▓рд╛, рдлрд│реЛ, рдореНрдпреБрдЬрд┐рдпрдо
ЁЯз╡ => ЁЯз╡, рдзрд╛рдЧреЗ, рдзрд╛рдЧреЛ, рд╢рд┐рдВрд╡рдк, рд╕реБрдд, рд╕реБрдп
ЁЯкб => ЁЯкб, рдзрд╛рдЧреЗ, рдзрд╛рдЧреЛ, рднрд░рддрдХрд╛рдо, рд╢рд┐рд╡рдгрдХрд╛рдо, рд╢рд┐рдВрд╡рдк, рд╢рд┐рдВрд╡рдкрд╛рдЪреА рд╕реБрдп, рд╕реБрдп
ЁЯз╢ => ЁЯз╢, рджреЛрд░, рдмреЙрд▓, рд╡рд┐рдгрдХрд╛рдо, рд╡рд┐рдгрдк
ЁЯкв => ЁЯкв, рдЧрд╛рда, рдЧрд╛рдард╛рдпрд▓реНрд▓реЗрдВ, рдЯрд╛рдп, рдЯреНрд╡рд╛рдпрди, рджреЛрд░
ЁЯСУ => ЁЯСУ, рдУрдХреНрд▓, рдУрдХреНрд▓рд╛рдВ, рдХрдкрдбреЗ, рджреЛрд│реЛ, рджреЛрд│реНрдпрд╛рдУрдХреНрд▓, рджреЛрд│реНрдпрд╛рдВрдХ рдШрд╛рд▓рдкрд╛рдЪреЗрдВ
ЁЯХ╢ => ЁЯХ╢, рдУрдХреНрд▓, рдХрд╛рд│реЛ, рджреЛрд│реЛ, рджреЛрд│реНрдпрд╛рдВрдХ рдШрд╛рд▓рдкрд╛рдЪреЗрдВ, рд╕рдирдЧреНрд▓рд╛рд╕
ЁЯе╜ => ЁЯе╜, рдЧреЙрдЧрд▓реНрд╕, рдЧреЙрд╝рдЧрд▓реНрд╕, рджреЛрд│реНрдпрд╛рдЪреА рд░рд╛рдЦрдг, рдкреЗрдВрд╡рдк, рд╡реЗрд▓реНрдбреАрдВрдЧ
ЁЯе╝ => ЁЯе╝, рджреЛрддреЛрд░, рдкреНрд░рдпреЛрдЧ, рд▓реЕрдм рдХреЛрдЯ, рд╢рд╛рд╕реНрддреНрд░рдЬреНрдЮ
ЁЯж║ => ЁЯж║, рдЖрдкрд╛рддреНрдХрд╛рд│, рдХреЛрдЯ, рд╕реБрд░рдХреНрд╖рд╛, рд╕реБрд░рдХреНрд╖реЗрдЪреЛ рдХреЛрдЯ
ЁЯСФ => ЁЯСФ, рдХрдкрдбреЗ, рдЯрд╛рдп, рдиреЗрдХрдЯрд╛рдп
ЁЯСХ => ЁЯСХ, рдХрдкрдбреЗ, рдЯреА-рд╢рд░реНрдЯ, рдЯреАрд╢рд░реНрдЯ, рд╢рд░реНрдЯ
ЁЯСЦ => ЁЯСЦ, рдХрдкрдбреЗ, рдЬреАрдиреНрд╕, рдЯреНрд░рд╛рд╡рдЬрд░, рдкреЕрдгреНрдЯреНрд╕
ЁЯзг => ЁЯзг, рдорд╛рди, рд╕реНрдХрд╛рд░реНрдл
ЁЯзд => ЁЯзд, рд╣рд╛рдд, рд╣рд╛рддрдореЛрдЬреЗ
ЁЯзе => ЁЯзе, рдХреЛрдЯ, рдЬреЕрдХреЗрдЯ
ЁЯзж => ЁЯзж, рдореЗрдп, рд╕рд╛рдВрдареЛ
ЁЯСЧ => ЁЯСЧ, рдХрдкрдбреЗ, рдкреЛрд╢реЗрдЧ
ЁЯСШ => ЁЯСШ, рдХрдкрдбреЗ, рдХрд┐рдореЛрдиреЛ
ЁЯе╗ => ЁЯе╗, рдХрдкрдбреЗ, рдкреЛрд╢реЗрдЧ, рд╕рд╛рдбреА
ЁЯй▒ => ЁЯй▒, рдПрдХ-рдкреАрд╕ рд╕реНрд╡рд┐рдорд╕реБрдЯ, рдмрд╛рдереАрдВрдЧ рд╕реБрдЯ
ЁЯй▓ => ЁЯй▓, рдЕрдВрдбрд░рд╡рд┐рдпрд░, рдПрдХ-рдкреАрд╕, рдиреНрд╣рд╛рд╡рдкрд╛ рд╕реБрдЯ, рдкреЗрдВрд╡рдкрд╛рд╕реБрдЯ, рдмреНрд░рд┐рдлреНрд╕
ЁЯй│ => ЁЯй│, рдЕрдВрдбрд░рд╡рд┐рдпрд░, рдиреНрд╣рд╛рдВрд╡рдкрд╛ рд╕реБрдЯ, рдкреЕрдгреНрдЯреНрд╕, рд╢реЙрд░реНрдЯреНрд╕
ЁЯСЩ => ЁЯСЩ, рдХрдкрдбреЗ, рдкреЗрдВрд╡рдк, рдмрд┐рдХрд┐рдиреА
ЁЯСЪ => ЁЯСЪ, рдХрдкрдбреЗ, рдмрд╛рдпрд▓, рдмрд╛рдпрд▓рд╛рдВрдЪреЗ рдХрдкрдбреЗ
ЁЯСЫ => ЁЯСЫ, рдХрдкрдбреЗ, рдирд╛рдгреЗ, рдкрд░реНрд╕
ЁЯСЬ => ЁЯСЬ, рдХрдкрдбреЗ, рдкрд░реНрд╕, рдмреЕрдЧ, рд╣рдБрдбрдмреЕрдЧ
ЁЯСЭ => ЁЯСЭ, рдХрдкрдбреЗ, рдХреНрд▓рдЪ рдмреЕрдЧ, рдкрд╛рд╡рдЪ, рдмреЕрдЧ
ЁЯЫН => ЁЯЫН, рдмреЕрдЧ, рд╢реЙрдкрд┐рдВрдЧ, рд╢реЙрдкрд┐рдВрдЧ рдмреЕрдЧрд╛рдВ, рд╣реЙрдЯреЗрд▓
ЁЯОТ => ЁЯОТ, рдмреЕрдХрдкреЕрдХ, рдмреЕрдЧ, рд░рд╕реНрдХрд╕реЕрдХ, рд╢рд╛рд│рд╛, рд╕реЕрдЪреЗрд▓
ЁЯй┤ => ЁЯй┤, рдЭреЛрд░реА, рдЯреЛрдВрдЧ рд╕рдБрдбрд▓, рдЯреЛрдВрдЧреНрд╕, рдмреАрдЪ рд╕рдВрдБрдбрд▓, рд╕рдБрдбрд▓
ЁЯСЮ => ЁЯСЮ, рдХрдкрдбреЗ, рджрд╛рджрд▓реЛ, рджрд╛рджрд▓реНрдпрд╛рдЪреЗ рдореЛрдЬреЗ, рдореЛрдЬреЗ
ЁЯСЯ => ЁЯСЯ, рдПрдерд▓реЗрдЯрд┐рдХ, рдХрдкрдбреЗ, рдзрд╛рдВрд╡рдкрд╛рдЪреЗ рдореЛрдЬреЗ, рдореЛрдЬреЗ, рд╕реНрдирд┐рдХрд░
ЁЯе╛ => ЁЯе╛, рдмреВрдЯ, рдмреЕрдХрдкреЕрдХрд┐рдВрдЧ, рд╢рд┐рдмреАрд░, рд╣рд╛рдпрдХреАрдВрдЧ
ЁЯе┐ => ЁЯе┐, рдмреЕрд▓реЗрдЯ рд╕рдкрд╛рдЯ, рд╕рдкрд╛рдЯ рдореЛрдЬреЗ, рд╕реНрд▓рд┐рдкрд░, рд╕реНрд▓реАрдк-рдСрди
ЁЯСа => ЁЯСа, рдХрдкрдбреЗ, рдЪрдб рд╣рд┐рд▓рд╛рдЪреЗ рдореЛрдЬреЗ, рдмрд╛рдпрд▓, рдореЛрдЬреЗ, рд╣реАрд▓
ЁЯСб => ЁЯСб, рдХрдкрдбреЗ, рдмрд╛рдпрд▓, рдмрд╛рдпрд▓рд╛рдВрдЪреЗ рд╕рдБрдбрд▓, рдмрд╛рдпрд▓рд╛рдВрдЪреЗрдВ рд╕рдБрдбрд▓, рдореЛрдЬреЗ, рд╕рдВрдБрдбрд▓
ЁЯй░ => ЁЯй░, рдирд╛рдЪ, рдмреЕрд▓реЗрдЯ, рдмреЕрд▓реЗрдЯ рдореЛрдЬреЗ
ЁЯСв => ЁЯСв, рдХрдкрдбреЗ, рдмрд╛рдпрд▓, рдмрд╛рдпрд▓рд╛рдВрдЪреЗ рдмреВрдЯ, рдмреВрдЯ, рдореЛрдЬреЗ
ЁЯСС => ЁЯСС, рдХрдкрдбреЗ, рдореБрдХреБрдЯ, рд░рд╛рдЬрд╛, рд░рд╛рдгреА
ЁЯСТ => ЁЯСТ, рдХрдкрдбреЗ, рдмрд╛рдпрд▓, рдмрд╛рдпрд▓рд╛рдВрдЪреЗрдВ рд╣реЕрдЯ, рд╣реЕрдЯ
ЁЯОй => ЁЯОй, рдХрдкрдбреЗ, рдЯреЙрдк, рдЯреЙрдкрд╣реЕрдЯ, рд╣реЕрдЯ
ЁЯОУ => ЁЯОУ, рдХрдкрдбреЗ, рдХреЕрдк, рдкрджрд╡реА, рд╕реБрд╡рд╛рд│реЛ, рд╣реЕрдЯ
ЁЯзв => ЁЯзв, рдмрд┐рд▓реНрдб рдХреЕрдк, рдмреЗрд╕рдмреЙрд▓ рдХреЕрдк
ЁЯкЦ => ЁЯкЦ, рдЬрд╡рд╛рди, рдпреЛрдзреНрджреЛ, рд▓рд╢реНрдХрд░, рд▓рд╕реНрдХрд░, рд▓рд╕реНрдХрд░реА рд╣реЗрд▓реНрдореЗрдЯ, рд╣реЗрд▓реНрдореЗрдЯ
тЫС => тЫС, рдЖрджрд╛рд░, рдХреНрд░реЙрд╕, рдЪреЗрд░реЛ, рдмрдЪрд╛рд╡ рдХрд╛рдордЧрд╛рд░рд╛рдЪреЗрдВ рд╣реЗрд▓реНрдореЗрдЯ, рдмрдЪрд╛рд╡ рдХрд╛рдордЧрд╛рд░рд╛рдВрдЪреЗрдВ рд╣реЗрд▓реНрдореЗрдЯ, рд╣реЕрдЯ, рд╣реЗрд▓реНрдореЗрдЯ
ЁЯУ┐ => ЁЯУ┐, рдХрдкрдбреЗ, рдзрд░реНрдо, рдиреЕрдХрд▓реЗрд╕, рдкреНрд░рд╛рд░реНрдердирд╛, рдкреНрд░рд╛рд░реНрдердиреЗрдЪреЗ рдордгреА, рдордгреА
ЁЯТД => ЁЯТД, рдореЗрдХрдЕрдк, рд▓рд┐рдкрд╕реНрдЯрд┐рдХ, рд╕реМрдВрджрд░реНрдпрдкреНрд░рд╕рд╛рдзрди
ЁЯТН => ЁЯТН, рдореБрджреА, рд╣рд┐рд░реЛ
ЁЯТО => ЁЯТО, рдЬрд╡рд╛рд╣реАрд░, рдореЛрддреА, рд░рддреНрди, рд╣рд┐рд░реЛ
ЁЯФЗ => ЁЯФЗ, рдореЛрдиреЛ, рд╢рд╛рдВрдд, рд╢рд╛рдВрддрддрд╛рдп, рд╕реНрдкрд┐рдХрд░
ЁЯФИ => ЁЯФИ, рдХрдореА рдЖрд╡рд╛рдЬрд╛рдЪреЛ рд╕реНрдкрд┐рдХрд░, рдореЛрд╡
ЁЯФЙ => ЁЯФЙ, рдордзреНрдпрдо, рдордзреНрдпрдо рдЖрд╡рд╛рдЬрд╛рдЪреЛ рд╕реНрдкрд┐рдХрд░
ЁЯФК => ЁЯФК, рдЙрдЪреНрдЪ рдЖрдХрд╛рд░рд╛рдЪреЛ рд╕реНрдкрд┐рдХрд░, рдЙрдЪреНрдЪ рдЖрд╡рд╛рдЬрд╛рдЪреЛ рд╕реНрдкрд┐рдХрд░, рд╡реНрд╣рдб
ЁЯУв => ЁЯУв, рднреМрд╢реАрдХ рдирд╛рдореЛ, рд▓рд╛рдЙрдбрд╕реНрдкрд┐рдХрд░, рд╡реНрд╣рдб
ЁЯУг => ЁЯУг, рдЪрд┐рдпрд░реАрдВрдЧ, рдореЗрдЧрд╛рдлреЛрди
ЁЯУп => ЁЯУп, рдкреЛрд╕реНрдЯ, рдкреЛрд╕реНрдЯрд▓, рд╣реЙрд░реНрди
ЁЯФФ => ЁЯФФ, рдмреЗрд▓
ЁЯФХ => ЁЯФХ, рдирд┐рд╖рд┐рдзреНрдж, рдмреЗрд▓, рдореЛрдиреЛ, рд╢рд╛рдВрдд, рд╢рд╛рдВрддрддрд╛рдп, рд╕реНрд▓реЕрд╢ рдЖрд╕рдкреА рдмреЗрд▓, рд╕реНрд▓реЕрд╢ рд╕рдпрдд рдмреЗрд▓
ЁЯО╝ => ЁЯО╝, рд╕рдВрдЧрд╛рддрд╛рдЪреЛ рд╕реНрд╡рд░, рд╕рдВрдЧреАрдд, рд╕рдВрдЧреАрддрд╛рдЪреЛ рд╕реНрд╡рд░, рд╕реНрд╡рд░
ЁЯО╡ => ЁЯО╡, рд╕рдВрдЧреАрдд, рд╕рдВрдЧреАрддрд╛рдЪреЗ рд╕реНрд╡рд░, рд╕реНрд╡рд░
ЁЯО╢ => ЁЯО╢, рд╕рдВрдЧреАрдд, рд╕рдВрдЧреАрддрд╛рдЪреЗ рд╕реНрд╡рд░, рд╕рдВрдЧреАрддрд╛рдЪреЗ рд╕реНрд╡рд░ рей, рд╕реНрд╡рд░
ЁЯОЩ => ЁЯОЩ, рдорд╛рдпрдХ, рдорд╛рдпрдХреНрд░реЛрдлреЛрди, рд╕рдВрдЧреАрдд, рд╕реНрдЯреБрдбрд┐рдпреЛ
ЁЯОЪ => ЁЯОЪ, рдкрд╛рддрд│реА, рд╕рдВрдЧреАрдд, рд╕реНрд▓рд╛рдпрдбрд░
ЁЯОЫ => ЁЯОЫ, рдирд┐рдпрдВрддреНрд░рдг, рдмрдЯрдг, рд╕рдВрдЧреАрдд
ЁЯОд => ЁЯОд, рдХрд╛рд░рд╛рдУрдХреЗ, рдорд╛рдпрдХ, рдорд╛рдпрдХреНрд░реЛрдлреЛрди
ЁЯОз => ЁЯОз, рдЗрдпрд░рдмрдб, рд╣реЗрдбрдлреЛрди
ЁЯУ╗ => ЁЯУ╗, рд░реЗрдбрд┐рдпреЛ, рд╡реНрд╣рд┐рдбрд┐рдпреЛ
ЁЯО╖ => ЁЯО╖, рд╡рд╛рджреНрдп, рд╕рдВрдЧреАрдд, рд╕реЕрдХреНрд╕, рд╕реЕрдХреНрд╕реЛрдлреЛрди
ЁЯкЧ => ЁЯкЧ, рдЕрдХреЛрд░реНрдбрд┐рдпрди, рдХреЙрдиреНрд╕рд░реНрдЯрд┐рдирд╛, рд╕реНрдХреНрд╡рд┐рдЬ рдмреЙрдХреНрд╕
ЁЯО╕ => ЁЯО╕, рдЧрд┐рдЯрд╛рд░, рд╡рд╛рджреНрдп, рд╕рдВрдЧреАрдд
ЁЯО╣ => ЁЯО╣, рдХрд┐рдмреЛрд░реНрдб, рдкрд┐рдпрд╛рдиреЛ, рд╡рд╛рджреНрдп, рд╕рдВрдЧреАрдд, рд╕рдВрдЧреАрддрд╛рдЪреЛ рдХрд┐рдмреЛрд░реНрдб
ЁЯО║ => ЁЯО║, рдЯреНрд░рдореНрдкреЗрдЯ, рд╡рд╛рджреНрдп, рд╕рдВрдЧреАрдд
ЁЯО╗ => ЁЯО╗, рд╡рд╛рджреНрдп, рд╡рд╛рдпреЛрд▓рд┐рди, рд╕рдВрдЧреАрдд
ЁЯкХ => ЁЯкХ, рдзрд╛рдЧреЗ, рдмрдБрдЬреЛ, рд╕рдВрдЧреАрдд
ЁЯеБ => ЁЯеБ, рдзреЛрд▓, рдзреЛрд▓рд╛рдЪреА рдмрдбреА, рд╕рдВрдЧреАрдд
ЁЯкШ => ЁЯкШ, рдХрд╛рдБрдЧрд╛, рдареЛрдХреЛ, рдзреЛрд▓, рдирд╛рдж, рдореГрджрдВрдЧ
ЁЯУ▒ => ЁЯУ▒, рдЯреЗрд▓рд┐рдлреЛрди, рдлреЛрди, рдореЛрдмрд╛рдпрд▓, рд╕реЕрд▓
ЁЯУ▓ => ЁЯУ▓, рдлреЛрди, рдмрд╛рдг, рдмрд╛рдг рдЖрд╕рдкреА рдореЛрдмрд╛рдпрд▓ рдлреЛрди, рдореЗрд│реЛрд╡рдк, рдореЛрдмрд╛рдпрд▓, рд╕реЕрд▓
тШО => тШО, рдЯреЗрд▓рд┐рдлреЛрди, рдлреЛрди
ЁЯУЮ => ЁЯУЮ, рдЯреЗрд▓рд┐рдлреЛрди, рдлреЛрди, рд░рд┐рд╕рд┐рд╡реНрд╣рд░
ЁЯУЯ => ЁЯУЯ, рдкреЗрдЬрд░
ЁЯУа => ЁЯУа, рдлреЕрдХреНрд╕, рдлреЕрдХреНрд╕ рдорд╢реАрди
ЁЯФЛ => ЁЯФЛ, рдмреЕрдЯрд░реА
ЁЯФМ => ЁЯФМ, рдкреНрд▓рдЧ, рд╡рд┐рдЬ, рд╡рд┐рдЬреЗрдЪреЛ
ЁЯТ╗ => ЁЯТ╗, pc, рд▓реЕрдкрдЯреЙрдк, рд╡реНрдпрдХреНрддреАрдЧрдд, рд╕рдВрдЧрдгрдХ
ЁЯЦе => ЁЯЦе, рдбреЕрд╕реНрдХрдЯреЙрдк, рд╕рдВрдЧрдгрдХ
ЁЯЦи => ЁЯЦи, рдореБрджреНрд░рдХ, рд╕рдВрдЧрдгрдХ
тМи => тМи, рдХрд┐рдмреЛрд░реНрдб, рд╕рдВрдЧрдгрдХ
ЁЯЦ▒ => ЁЯЦ▒, рд╕рдВрдЧрдгрдХ, рд╕рдВрдЧрдгрдХ рдорд╛рд╡рд╕
ЁЯЦ▓ => ЁЯЦ▓, рдЯреНрд░реЕрдХрдмреЙрд▓, рд╕рдВрдЧрдгрдХ
ЁЯТ╜ => ЁЯТ╜, рдСрдкреНрдЯрд┐рдХрд▓, рдбрд┐рд╕реНрдХ, рдорд┐рдирд┐рдбрд┐рд╕реНрдХ, рд╕рдВрдЧрдгрдХ
ЁЯТ╛ => ЁЯТ╛, рдбрд┐рд╕реНрдХ, рдлреНрд▓реЙрдкреА, рд╕рдВрдЧрдгрдХ
ЁЯТ┐ => ЁЯТ┐, рдСрдкреНрдЯрд┐рдХрд▓ рдбрд┐рд╕реНрдХ, рдСрдкреНрдЯреАрдХрд▓, рдбрд┐рд╕реНрдХ, рд╕рдВрдЧрдгрдХ, рд╕реАрдбреА
ЁЯУА => ЁЯУА, рдСрдкреНрдЯреАрдХрд▓, рдбрд┐рд╕реНрдХ, рдбреАрд╡реАрдбреА, рдмреНрд▓реВ-рд░реЗ, рд╕рдВрдЧрдгрдХ
ЁЯзо => ЁЯзо, рдЕрдмрд╛рд╕реНрдХрд╕, рдореЗрдЬрдгреА
ЁЯОе => ЁЯОе, рдХреЕрдореЗрд░рд╛, рдореБрд╡реНрд╣реА, рд╕рд┐рдиреЗрдорд╛
ЁЯОЮ => ЁЯОЮ, рдЪреМрдХрдЯреА, рдлрд┐рд▓реНрдо, рдлрд┐рд▓реНрдо рдЪреМрдХрдЯ, рдореБрд╡реНрд╣реА, рд╕рд┐рдиреЗрдорд╛
ЁЯУ╜ => ЁЯУ╜, рдкреНрд░реЙрдЬреЕрдХреНрдЯрд░, рдлрд┐рд▓реНрдо, рдореБрд╡реНрд╣реА, рд╡реНрд╣рд┐рдбрд┐рдпреЛ, рд╕рд┐рдиреЗрдорд╛
ЁЯОм => ЁЯОм, рдХреНрд▓реЗрдкрд░, рдХреНрд▓реЗрдкрд░ рдмреЛрд░реНрдб, рдореБрд╡реНрд╣реА
ЁЯУ║ => ЁЯУ║, рдЯрд┐рд╡реА, рджреВрд░рджрд░реНрд╢рди, рд╡реНрд╣рд┐рдбрд┐рдпреЛ
ЁЯУ╖ => ЁЯУ╖, рдХреЕрдореЗрд░рд╛, рд╡реНрд╣рд┐рдбрд┐рдпреЛ
ЁЯУ╕ => ЁЯУ╕, рдХреЕрдореЗрд░рд╛, рдлреНрд▓реЕрд╢, рдлреНрд▓реЕрд╢ рдЖрд╕рдкреА рдХреЕрдореЗрд░рд╛, рд╡реНрд╣рд┐рдбрд┐рдпреЛ
ЁЯУ╣ => ЁЯУ╣, рдХреЕрдореЗрд░рд╛, рд╡реНрд╣рд┐рдбрд┐рдпреЛ
ЁЯУ╝ => ЁЯУ╝, рдЯреЗрдк, рд╡реНрд╣рд┐рдбрд┐рдпреЛ, рд╡реНрд╣рд┐рдбрд┐рдпреЛрдХреЕрд╕реЗрдЯ, рд╡реНрд╣реАрдПрдЪрдПрд╕
ЁЯФН => ЁЯФН, рдЧреНрд▓рд╛рд╕, рджрд╛рд╡реНрдпрд╛рди рдкрд│реЛрд╡рдкреА рдореЕрдЧреНрдиреАрдлрд╛рдИрдВрдЧ рдЧреНрд▓рд╛рд╕, рдореЕрдЧреНрдиреАрдлрд╛рдИрдВрдЧ, рд╕рд╛рдзрди, рд╕реЛрдж
ЁЯФО => ЁЯФО, рдЙрдЬрд╡реНрдпрд╛рди рдкрд│реЛрд╡рдкреА рдореЕрдЧреНрдиреАрдлрд╛рдИрдВрдЧ рдЧреНрд▓рд╛рд╕, рдЧреНрд▓рд╛рд╕, рдореЕрдЧреНрдиреАрдлрд╛рдИрдВрдЧ, рд╕реЛрдж рд╕рд╛рдзрди
ЁЯХп => ЁЯХп, рдЙрдЬрд╡рд╛рдб, рдореЗрдгрд╡рд╛рдХ, рдореЗрдгрд╡рд╛рдд
ЁЯТб => ЁЯТб, рдЙрдЬрд╡рд╛рдб, рдХрд▓реНрдкрдирд╛, рдмрд▓реНрдм, рд▓рд╛рдпрдЯреАрдЪреЛ рджрд┐рд╡реЛ, рд╡рд┐рджреНрдпреБрдд, рд╡рд┐рдиреЛрджреА
ЁЯФж => ЁЯФж, рдЯреЙрд░реНрдЪ, рдлреНрд▓реЕрд╢рд▓рд╛рдпрдЯ, рд▓рд╛рдпрдЯ, рд╡рд┐рджреНрдпреБрдд, рд╕рд╛рдзрди
ЁЯПо => ЁЯПо, рдЙрдЬрд╡рд╛рдб, рдХрдВрджреАрд▓, рддрд╛рдВрдмрдбреЛ, рддрд╛рдВрдмрдбреНрдпрд╛ рдкреЗрдкрд░рд╛рдЪреЛ рдХрдВрджреАрд▓, рдмрд╛рд░
ЁЯкФ => ЁЯкФ, рддреЗрд▓, рджрд┐рдпрд╛, рджрд┐рд╡реЛ
ЁЯУФ => ЁЯУФ, рдХрд╡рд░, рдЪреЛрдкрдбреА, рдкреБрд╕реНрддрдХ, рд╢реГрдВрдЧрд╛рд░ рдХреЗрд▓реНрд▓реЗрдВ, рд╢реГрдВрдЧрд╛рд░рдХ рдХрд╡рд░рд╛ рд╕рдпрдд рдЪреЛрдкрдбреА
ЁЯУХ => ЁЯУХ, рдзрд╛рдВрдкрд┐рд▓реНрд▓реЗрдВ, рдкреБрд╕реНрддрдХ
ЁЯУЦ => ЁЯУЦ, рдЙрдХрддреЗрдВ, рдкреБрд╕реНрддрдХ
ЁЯУЧ => ЁЯУЧ, рдкрд╛рдЪрд╡реЗрдВ, рдкреБрд╕реНрддрдХ
ЁЯУШ => ЁЯУШ, рдирд┐рд│реЗрдВ, рдкреБрд╕реНрддрдХ
ЁЯУЩ => ЁЯУЩ, рдкреБрд╕реНрддрдХ, рд▓рд╛рд░рд╛рдВрдЬреА
ЁЯУЪ => ЁЯУЪ, рдкреБрд╕реНрддрдХ, рдкреБрд╕реНрддрдХрд╛рдВ
ЁЯУУ => ЁЯУУ, рдЪреЛрдкрдбреА
ЁЯУТ => ЁЯУТ, рдЪреЛрдкрдбреА, рд▓реЗрдЬрд░
ЁЯУГ => ЁЯУГ, рджрд╕реНрддрд╛рд╡реЗрдЬ, рджреЛрдбрд┐рд▓реНрд▓реЗрдВ, рдкрд╛рди
ЁЯУЬ => ЁЯУЬ, рдкреЗрдкрд░, рд╕реНрдХреНрд░реЛрд▓
ЁЯУД => ЁЯУД, рджрд╕реНрддрд╛рд╡реЗрдЬ, рдкрд╛рди, рд╡рдпрд░ рдкрд│реЛрд╡рдкреА рдкрд╛рди
ЁЯУ░ => ЁЯУ░, рдЦрдмрд░рд╛рдкрддреНрд░, рдЦрдмрд░реЛ, рдкреЗрдкрд░
ЁЯЧЮ => ЁЯЧЮ, рдЦрдмрд░рд╛рдкрддреНрд░, рдЦрдмрд░реЛ, рдЧреБрдард▓рд╛рдпрд┐рд▓реНрд▓реЗрдВ, рдкреЗрдкрд░
ЁЯУС => ЁЯУС, рдЯреЕрдмреНрд╕, рдмреВрдХрдорд╛рд░реНрдХ, рдорд╛рд░реНрдХ, рдореЗрдХрд░
ЁЯФЦ => ЁЯФЦ, рдмреВрдХрдорд╛рд░реНрдХ, рдорд╛рд░реНрдХ
ЁЯП╖ => ЁЯП╖, рд▓реЗрдмрд▓
ЁЯТ░ => ЁЯТ░, рдбреЙрд▓рд░, рдкрдпрд╢рд╛рдВрдЪреА рдмреЕрдЧ, рдкрдпрд╢реЗ, рдмреЕрдЧ
ЁЯкЩ => ЁЯкЩ, рдЦрдЬрд┐рдиреЛ, рдзрд╛рддреВ, рдирд╛рдгреЗ, рдкрдпрд╢реЗ, рднрд╛рдВрдЧрд░, рд░реБрдкреЗрдВ
ЁЯТ┤ => ЁЯТ┤, рдЪрд▓рди, рдиреЛрдЯ, рдкрдпрд╢реЗ, рдмрдБрдХрдиреЛрдЯ, рдмреАрд▓, рдпреЗрди
ЁЯТ╡ => ЁЯТ╡, рдЪрд▓рди, рдбреЙрд▓рд░, рдиреЛрдЯ, рдкрдпрд╢реЗ, рдмрдБрдХрдиреЛрдЯ, рдмреАрд▓
ЁЯТ╢ => ЁЯТ╢, рдЪрд▓рди, рдиреЛрдЯ, рдкрдпрд╢реЗрдВ, рдмрдБрдХрдиреЛрдЯ, рдмреАрд▓, рдпреБрд░реЛ, рдпреБрд░реЛ рдмрдВрдБрдХрдиреЛрдЯ
ЁЯТ╖ => ЁЯТ╖, рдЪрд▓рди, рдиреЛрдЯ, рдкрдпрд╢реЗ, рдкрд╛рд╡рдВрдб, рдмрдБрдХрдиреЛрдЯ, рдмреАрд▓
ЁЯТ╕ => ЁЯТ╕, рдЙрдбрдк, рдкрдпрд╢реЗ, рдкрд╛рдЦрд╛рдВ, рдкрд╛рдЦрд╛рдВ рдЖрд╕рдкреА рдкрдпрд╢реЗ, рдмрдБрдХрдиреЛрдЯ, рдмреАрд▓
ЁЯТ│ => ЁЯТ│, рдХрд╛рд░реНрдб, рдХреНрд░реЗрдбрд┐рдЯ, рдкрдпрд╢реЗ
ЁЯз╛ => ЁЯз╛, рдЧрд╡рд╛рдп, рдкрд╛рд╡рддреА, рдкреБрд░рд╛рд╡реЛ, рд╣рд┐рд╢реЛрдм, рд╣рд┐рд╢реЛрдм рдмрд░реЛрд╡рдк
ЁЯТ╣ => ЁЯТ╣, рдЧреНрд░рд╛рдл, рддрдХрдЯреЛ, рдкрдпрд╢реЗ, рдпреЗрди, рдпреЗрди рд╕рдпрдд рд╡рд╛рдбрдкреА рддрдХрдЯреЛ, рд╡рд╛рдб
тЬЙ => тЬЙ, рдИрдореЗрд▓, рдПрдиреНрд╡рд╛рд▓реЙрдк, рдЪрд┐рдЯреА
ЁЯУз => ЁЯУз, рдИ-рдореЗрд▓, рдИрдореЗрд▓, рдкрддреНрд░, рдореЗрд▓
ЁЯУи => ЁЯУи, рдИ-рдореЗрд▓, рдИрдореЗрд▓, рдПрдиреНрд╡рд╛рд▓реЙрдк рдпреЗрд╡рдкреА, рдкрддреНрд░, рдореЗрд│рдк, рдпреЗрд╡рдкреА рдПрдиреНрд╡рд╛рд▓реЙрдк
ЁЯУй => ЁЯУй, рдЖрд╡рдЯрдЧреЛрдИрдВрдЧ, рдИ-рдореЗрд▓, рдИрдореЗрд▓, рдПрдиреНрд╡рд╛рд▓реЙрдк, рдмрд╛рдг, рдмрд╛рдг рдЖрд╕рдкреА рдПрдиреНрд╡рд╛рд▓реЙрдк
ЁЯУд => ЁЯУд, рдЖрд╡рдЯрдмреЙрдХреНрд╕, рдЪрд┐рдЯреА, рдЯреНрд░реЗ, рдзрд╛рдбрд┐рд▓реНрд▓реЗрдВ, рдмреЙрдХреНрд╕, рдореЗрд▓
ЁЯУе => ЁЯУе, рдЗрдирдмреЙрдХреНрд╕, рдЪрд┐рдЯреА, рдЯреНрд░реЗ, рдмреЙрдХреНрд╕, рдореЗрд▓, рдореЗрд│реЛрд╡рдЪреЗрдВ
ЁЯУж => ЁЯУж, рдкрд╛рд░реНрд╕рд▓, рдкреЕрдХреЗрдЬ, рдмреЙрдХреНрд╕
ЁЯУл => ЁЯУл, рдЙрдмрд╛рд░рд┐рд▓реНрд▓реНрдпрд╛ рдмрд╛рд╡рдЯреНрдпрд╛ рд╕рдпрдд рдзрд╛рдВрдкрд┐рд▓реНрд▓реЗрдВ рдореЗрд▓рдмреЙрдХреНрд╕, рдзрд╛рдВрдкрд┐рд▓реНрд▓реЗрдВ, рдкреЛрд╕реНрдЯрдмреЙрдХреНрд╕, рдореЗрд▓, рдореЗрд▓рдмреЙрдХреНрд╕
ЁЯУк => ЁЯУк, рджреЗрдВрд╡рдпрд▓реНрд▓реЗрдВ, рджреЗрдВрд╡рдпрд▓реНрд▓реНрдпрд╛ рдмрд╛рд╡рдЯреНрдпрд╛ рд╕рдпрдд рдзрд╛рдВрдкрд┐рд▓реНрд▓реЗрдВ рдореЗрд▓рдмреЙрдХреНрд╕, рдзрд╛рдВрдкрд┐рд▓реНрд▓реЗрдВ, рдкреЛрд╕реНрдЯрдмреЙрдХреНрд╕, рдореЗрд▓, рдореЗрд▓рдмреЙрдХреНрд╕
ЁЯУм => ЁЯУм, рдЙрдХрддреЗрдВ, рдЙрдмрд╛рд░рд┐рд▓реНрд▓реНрдпрд╛ рдмрд╛рд╡рдЯреНрдпрд╛ рд╕рдпрдд рдЙрдХрддреЗрдВ рдореЗрд▓рдмреЙрдХреНрд╕, рдЙрдмрд╛рд░рд┐рд▓реНрд▓реНрдпрд╛ рдмрд╛рд╡рдЯреНрдпрд╛рд╕рдпрдд рдЙрдЧрдбрд┐рд▓реНрд▓реЗрдВ рдореЗрд▓рдмреЙрдХреНрд╕, рдкреЛрд╕реНрдЯрдмреЙрдХреНрд╕, рдореЗрд▓, рдореЗрд▓рдмреЙрдХреНрд╕
ЁЯУн => ЁЯУн, рдЙрдХрддреЗрдВ, рджреЗрд╡рдпрд▓реНрд▓реЗрдВ, рджреЗрд╡рдпрд▓реНрд▓реНрдпрд╛ рдмрд╛рд╡рдЯреНрдпрд╛ рд╕рдпрдд рдЙрдХрддреЗрдВ рдореЗрд▓рдмреЙрдХреНрд╕, рджреЗрдВрд╡рдпрд▓реНрд▓реНрдпрд╛ рдмрд╛рд╡рдЯреНрдпрд╛ рд╕рдпрдд рдЙрдХрддреЗрдВ рдореЗрд▓рдмреЙрдХреНрд╕, рдкреЛрд╕реНрдЯрдмреЙрдХреНрд╕, рдореЗрд▓, рдореЗрд▓рдмреЙрдХреНрд╕
ЁЯУо => ЁЯУо, рдкреЛрд╕реНрдЯрдмреЙрдХреНрд╕, рдореЗрд▓, рдореЗрд▓рдмреЙрдХреНрд╕
ЁЯЧ│ => ЁЯЧ│, рдмреЙрдХреНрд╕, рдордд, рдорддрд╛рдВ рд╕рдпрдд рдорддрджрд╛рди рдкреЗрдЯреА, рдорддрд╛рдВ рд╕рдпрдд рдорддрджрд╛рди рдмреЙрдХреНрд╕
тЬП => тЬП, рдкреЗрдиреНрд╕рд┐рд▓
тЬТ => тЬТ, рдХрд╛рд│реЗрдВ рдиреАрдм, рдиреАрдм, рдкреЕрди
ЁЯЦЛ => ЁЯЦЛ, рдкреЕрди, рдлрд╛рдЙрдЯреЗрди
ЁЯЦК => ЁЯЦК, рдкреЕрди, рдмреЙрд▓рдкреЙрдпрдВрдЯ
ЁЯЦМ => ЁЯЦМ, рдЪрд┐рддреНрд░рдХрд▓рд╛, рд░рдВрдЧрдмреНрд░рд╢
ЁЯЦН => ЁЯЦН, рдХреНрд░реЗрдпреЙрди
ЁЯУЭ => ЁЯУЭ, рдкреЗрдиреНрд╕рд┐рд▓, рдореЗрдореЛ
ЁЯТ╝ => ЁЯТ╝, рдмреНрд░рд┐рдлрдХреЗрд╕
ЁЯУБ => ЁЯУБ, рдлрд╛рдпрд▓, рдлреЛрд▓реНрдбрд░
ЁЯУВ => ЁЯУВ, рдЙрдЧрдбрдЪреЛ, рдлрд╛рдпрд▓, рдлреЛрд▓реНрдбрд░
ЁЯЧВ => ЁЯЧВ, рдЗрдВрдбреЗрдХреНрд╕, рдХрд╛рд░реНрдб, рдбрд┐рд╡рд╛рдпрдбрд░
ЁЯУЕ => ЁЯУЕ, рддрд╛рд░реАрдЦ, рджрд┐рдирджрд░реНрд╢рд┐рдХрд╛
ЁЯУЖ => ЁЯУЖ, рддрд╛рд░реАрдЦ рджрд╛рдЦреЛрд╡рдкреА рджрд┐рдирджрд░реНрд╢рд┐рдХрд╛, рджрд┐рдирджрд░реНрд╢рд┐рдХрд╛
ЁЯЧТ => ЁЯЧТ, рдиреЛрдВрдж, рдиреЛрдВрджрдХрд░рдЪреЗрдВ, рдиреЛрдВрджрдкрдЯреНрдЯреА, рдкреЕрдб
ЁЯЧУ => ЁЯЧУ, рджрд┐рдирджрд░реНрд╢рд┐рдХрд╛, рдиреЛрдВрджрдкрдЯреНрдЯреА, рдкреЕрдб
ЁЯУЗ => ЁЯУЗ, рдЗрдВрдбреЗрдХреНрд╕, рдХрд╛рд░реНрдб, рд░реЛрд▓реЛрдбреЗрдХреНрд╕
ЁЯУИ => ЁЯУИ, рдЧреНрд░рд╛рдл, рдЪрд╛рд░реНрдЯ, рдЪрд╛рд░реНрдЯ рд╡рд╛рдбрдЯрд╛, рдЯреНрд░реЗрдВрдб, рд╡рдпрд▓реЗрд╡рдЯреЗрди, рд╡рд╛рдб
ЁЯУЙ => ЁЯУЙ, рдЧреНрд░рд╛рдл, рдЪрд╛рд░реНрдЯ, рдЪрд╛рд░реНрдЯ рджреЗрдВрд╡рддрд╛, рдЯреНрд░реЗрдВрдб, рд╕рдХрдпрд▓
ЁЯУК => ЁЯУК, рдЧреНрд░рд╛рдл, рддрдХрдЯреЛ, рдмрд╛рд░
ЁЯУЛ => ЁЯУЛ, рдХреНрд▓рд┐рдкрдмреЛрд░реНрдб
ЁЯУМ => ЁЯУМ, рдкреАрди, рдкреБрд╢рдкреАрди
ЁЯУН => ЁЯУН, рдкреАрди, рдкреБрд╢рдкреАрди, рд╡рд╛рдВрдЯрдХреБрд│реА рдкреБрд╢рдкреАрди
ЁЯУО => ЁЯУО, рдкреЗрдкрд░рдХреНрд▓рд┐рдк
ЁЯЦЗ => ЁЯЦЗ, рдкреЗрдкрд░рдХреНрд▓рд┐рдк, рд▓рд┐рдВрдХ, рд▓рд┐рдВрдХреНрдб рдкреЗрдкрд░рдХреНрд▓рд┐рдк, рд▓рд┐рдВрдХреНрдб рдкреЗрдкрд░рдХреНрд▓рд┐рдкреНрд╕
ЁЯУП => ЁЯУП, рдкрдЯреНрдЯреА, рд╕рд░рд│ рджреЗрдЧ, рд╕рд░рд│ рдкрдЯреНрдЯреА
ЁЯУР => ЁЯУР, рддреНрд░рд┐рдХреЛрдгреА, рдкрдЯреНрдЯреА, рд╕рдВрдЪ
тЬВ => тЬВ, рдХрд╛рддрд░рдк, рдХрд╛рддрд░реА, рд╕рд╛рдзрди
ЁЯЧГ => ЁЯЧГ, рдХрд╛рд░реНрдб, рдХрд╛рд░реНрдб рдлрд╛рдпрд▓ рдмрд╝реЙрдХреНрд╕, рдлрд╛рдпрд▓, рдмреЙрдХреНрд╕
ЁЯЧД => ЁЯЧД, рдХреЕрдмрд┐рдиреЗрдЯ, рдлрд╛рдпрд▓, рдлрд╛рдпрд▓рд┐рдВрдЧ
ЁЯЧС => ЁЯЧС, рдХреЛрдпрд░рд╛рдмрд╛рд▓рджреА
ЁЯФТ => ЁЯФТ, рдзрд╛рдВрдкрд┐рд▓реНрд▓реЗрдВ, рд▓реЙрдХ рдХреЗрд▓реНрд▓реЗрдВ
ЁЯФУ => ЁЯФУ, рдЕрдирд▓реЙрдХ, рдЕрдирд▓реЙрдХреНрдб, рдЙрдХрддреЗрдВ, рдирд╢реАрдм, рд▓реЙрдХ рдХрд░реВрдВрдХ рдирд╛рд╢рд┐рд▓реНрд▓реЗрдВ
ЁЯФП => ЁЯФП, рдЗрдВрдХ, рдЧреБрдкреНрддрддрд╛рдп, рдиреАрдм, рдкреЕрди, рдкреЕрдирд╛рди рд▓реЙрдХ рдЬрд╛рд▓реЗрдВ, рд▓реЙрдХ, рд▓реЙрдХ рдХреЗрд▓реНрд▓реЗрдВ рдкреЕрди
ЁЯФР => ЁЯФР, рдХрд┐ рд╕рдпрдд рд▓реЙрдХ рдХреЗрд▓рд╛рдВ, рдХреБрд▓рдк, рдЪрд╛рд╡рдпреЗрди рдХреБрд▓рдк рдШрд╛рд▓рд╛рдВ, рдЪрд╛рд╡реА, рдзрд╛рдВрдкрд┐рд▓реНрд▓реЗрдВ, рд╕реБрд░рдХреНрд╖реАрдд
ЁЯФС => ЁЯФС, рдХреБрд▓рдк, рдЪрд╛рд╡реА, рдкрд╛рд╕рд╡рд░реНрдб
ЁЯЧЭ => ЁЯЧЭ, рдХреБрд▓рдк, рдЪрд╛рд╡реА, рдкреЛрд░рдгреА рдЪрд╛рд╡реА, рдкреЛрд░рдгреЗрдВ, рд╕рдВрдХреЗрдд
ЁЯФи => ЁЯФи, рдШрдг, рд╕рд╛рдзрди
ЁЯкУ => ЁЯкУ, рдХреБ-рд╣рд╛рдб, рдХреБрдбрдХреЛ, рдХреБрд░рд╛рдбреЗрдВ, рд▓рд╛рдХреВрдб, рд╕реБрд░реЛ
тЫП => тЫП, рдЦрдгрдк, рдкрд┐рдХрд╛рд╕, рд╕рд╛рдзрди
тЪТ => тЪТ, рдЦреЛрд░реЗрдВ, рдЦреЛрд░реЗрдВ рдЖрдиреА рдкрд┐рдХрд╛рд╕, рдкрд┐рдХрд╛рд╕, рд╕рд╛рдзрди
ЁЯЫа => ЁЯЫа, рдШрдг, рдШрдг рдЖрдиреА рддрд┐рд░рдкрдгреА, рддрд┐рд░рдкрдгреА, рдкрд╛рдиреЛ, рд╕рд╛рдзрди
ЁЯЧб => ЁЯЧб, рдЦрдВрдЬреАрд░, рд╕реБрд░реА, рд╣рддреНрдпрд╛рд░
тЪФ => тЪФ, рдЫреЗрджрдХ, рддрд▓рд╡рд╛рд░реА, рд╣рддреНрдпрд╛рд░
ЁЯФл => ЁЯФл, рдЧрди, рдкрд┐рд╕реНрддреБрд▓, рд░рд┐рд╡реЛрд▓реНрд╡рд░, рд╕рд╛рдзрди, рд╣рдБрдбрдЧрди, рд╣рддреНрдпрд╛рд░
ЁЯкГ => ЁЯкГ, рдСрд╕реНрдЯреНрд░реЗрд▓рд┐рдпрд╛, рдмреБрдорд░рдВрдЧ, рд░рд┐рдмрд╛рд╡рдВрдб, рд░реЗрдкреЗрд░рдХрд╢рди
ЁЯП╣ => ЁЯП╣, рдзрдиреБрд░реНрд╡рд┐рджреНрдпрд╛, рдзрдиреБрд╢реНрдп, рдмрд╛рдг, рдмрд╛рдг рдЖрдиреА рдзрдиреБрд╢реНрдп, рд░рд╛рд╕, рд╡реГрд╢реНрдЪреАрдХ
ЁЯЫб => ЁЯЫб, рдврд╛рд▓, рд╣рддреНрдпрд╛рд░
ЁЯкЪ => ЁЯкЪ, рдЦрд░рд╡рдд, рдерд╡рдп, рдореЗрд╕реНрдд, рд╕рд╛рдзрди
ЁЯФз => ЁЯФз, рддрд┐рд░рдкрдгреА, рдкрд╛рдиреЛ, рд╕рд╛рдзрди
ЁЯкЫ => ЁЯкЫ, рд╕рд╛рдзрди, рд╕реНрдХреНрд░реБ, рд╕реНрдХреНрд░реБрдбреНрд░рд╛рдпрд╡рд░
ЁЯФй => ЁЯФй, рдирдЯ, рдирдЯ рдЖрдиреА рдмреЛрд▓реНрдЯ, рдмреЛрд▓реНрдЯ, рд╕рд╛рдзрди
тЪЩ => тЪЩ, рдХреЙрдЧ, рдХреЙрдЧрд╡реНрд╣реАрд▓, рдЧрд┐рдпрд░, рд╕рд╛рдзрди
ЁЯЧЬ => ЁЯЧЬ, рдХреЙрдореНрдкреНрд░реЗрд╕, рдХреНрд▓реЕрдореНрдк, рд╡рд╛рдпрд╕, рд╕рд╛рдзрди
тЪЦ => тЪЦ, рддрд╛рдЧрдбреА, рддреБрд│, рдиреНрдпрд╛рдп, рдореЗрдЬрдгреА, рд░рд╛рд╕, рд╕рдорддреЛрд▓
ЁЯжп => ЁЯжп, рдНрдХреНрд╕реЕрд╕рд┐рдмрд┐рд▓рд┐рдЯреА, рдХреБрдбреНрдбреЗ, рдкреНрд░реЛрдмрд┐рдВрдЧ рдХреЗрди
ЁЯФЧ => ЁЯФЧ, рд▓рд┐рдВрдХ
тЫУ => тЫУ, рд╕рд╛рдЦрд│реА, рд╕рд╛рдЦрд│реНрдпреЛ
ЁЯкЭ => ЁЯкЭ, рдПрдирд╕реНрдиреЗрд░, рдХрд░реНрд╡, рдХреЕрдЪ, рдХреНрд░реБрдХ, рд╕реЗреЗрд▓рд┐рдВрдЧ рдкреЙрдпрдВрдЯ, рд╣реВрдХ
ЁЯз░ => ЁЯз░, рдкреЗрдЯреА, рдпрд╛рдВрддреНрд░рд┐рдХ, рд╕рд╛рдзрди, рд╕рд╛рдзрдирдкреЗрдЯреА, рд╕рд╛рдзрдирдмреЙрдХреНрд╕
ЁЯз▓ => ЁЯз▓, рдЖрдХрд░реНрд╢рдг, рдШреЛрдбреНрдпрд╛рдирд╛рд│, рдЪреБрдВрдмрдХ, рдЪреБрдВрдмрдХреАрдп
ЁЯкЬ => ЁЯкЬ, рдЪрдврдк, рдирд┐рд╕рдг, рдкрд╛рдВрд╡рдбреЗ, рд░рдВрдЧ
тЪЧ => тЪЧ, рдЕрд▓реЗрдореНрдмрд┐рдХ, рд░рд╕рд╛рдпрдирд╢рд╛рд╕реНрддреНрд░, рд╕рд╛рдзрди
ЁЯзк => ЁЯзк, рдЯреЗрд╕реНрдЯ рдЯреНрдпреБрдм, рдкреНрд░рдпреЛрдЧ, рд░рд╕рд╛рдпрди рд╢рд╛рд╕реНрддреНрд░, рд░рд╕рд╛рдпрдирд╢рд╛рд╕реНрддреНрд░рдЬреНрдЮ, рд▓реЕрдм, рд╡рд┐рдЬреНрдЮрд╛рди
ЁЯзл => ЁЯзл, рдЬреАрд╡рд╢рд╛рд╕реНрддреНрд░, рдЬреИрд╡рд╢рд╛рд╕реНрддреНрд░рдЬреНрдЮ, рдкреЗрдЯреНрд░реА рдбреАрд╢, рдмреЕрдХреНрдЯреЗрд░рд┐рдпрд╛, рд▓реЕрдм, рд╕рдВрд╕реНрдХреГрддреА
ЁЯзм => ЁЯзм, рдЙрддреНрдХреНрд░рд╛рдВрддреА, рдЬрдирдХ, рдЬрдирдирд╢рд╛рд╕реНрддреНрд░, рдЬреАрд╡рди, рдЬреАрд╡рд╢рд╛рд╕реНрддреНрд░рдЬреНрдЮ, рдбреАрдПрдирдП
ЁЯФм => ЁЯФм, рдорд╛рдпрдХреНрд░реЛрд╕реНрдХреЛрдк, рд╡рд┐рдЬреНрдЮрд╛рди, рд╕рд╛рдзрди
ЁЯФн => ЁЯФн, рджреБрд░реНрдмрд┐рдг, рд╡рд┐рдЬреНрдЮрд╛рди, рд╕рд╛рдзрди
ЁЯУб => ЁЯУб, рдЙрдкрдЧрд┐рд░реЛ, рдПрдгреНрдЯреЗрдирд╛, рдбреАрд╢
ЁЯТЙ => ЁЯТЙ, рддреЛрдВрдкрдк, рджреБрдпреЗрдВрдд, рд╡рдЦрджрд╛рдВ, рд╕рд┐рд░рд┐рдВрдЬ, рд╕реБрдп
ЁЯй╕ => ЁЯй╕, рджреБрдЦрд╛рдкрдд, рдорд╛рд╕реАрдХрдзрд░реНрдо, рд░рдХреНрдд рджрд╛рди, рд░рдХреНрддрд╛рдЪреЛ рдереЗрдВрдмреЛ, рд░рдЧрдд, рд╡рдЦрджрд╛рдВ
ЁЯТК => ЁЯТК, рдЧреБрд│реА, рджреБрдпреЗрдВрдд, рджреЛрддреЛрд░, рд╡рдЦрджрд╛рдВ
ЁЯй╣ => ЁЯй╣, рдЪрд┐рдХрдЯ рдмрдБрдбреЗрдЬ, рдмрдБрдбреЗрдЬ
ЁЯй║ => ЁЯй║, рдХрд╛рд│реАрдЬ, рджреЛрддреЛрд░, рд╡рдЦрджрд╛рдВ, рд╕реНрдереЗрдереЛрд╕реНрдХреЛрдк
ЁЯЪк => ЁЯЪк, рджрд╛рд░
ЁЯЫЧ => ЁЯЫЧ, рдНрдХреНрд╕реЕрд╕рд┐рдмрд┐рд▓рд┐рдЯреА, рдПрд▓рд┐рд╡реЗрдЯрд░, рд▓рд┐рдлреНрдЯ, рд╣реЛрдпрд╕реНрдЯ
ЁЯкЮ => ЁЯкЮ, рдЖрд░рд╕реЛ, рдкреНрд░рддрд┐рдмрд┐рдВрдм, рдкреНрд░рддрд┐рдмрд┐рдВрдмрдХ, рднрд┐рдВрдЧ
ЁЯкЯ => ЁЯкЯ, рдЙрдХрддреЗрдВ, рдЪреМрдХрдЯ, рдЬрдиреЗрд▓, рддрд╛рдЬреА рд╣рд╡рд╛, рджреГрд╢реНрдп, рдкрд╛рд░рджрд░реНрд╢рдХ
ЁЯЫП => ЁЯЫП, рдЦрд╛рдЯ, рдиреНрд╣реАрдж, рд╣реЙрдЯреЗрд▓
ЁЯЫЛ => ЁЯЫЛ, рдХреЛрдЪ, рдХреЛрдЪ рдЖрдиреА рд▓реЕрдореНрдк, рд▓реЕрдореНрдк, рд╣реЙрдЯреЗрд▓
ЁЯкС => ЁЯкС, рдХрджреЗрд▓, рдмрд╕, рд╕реАрдЯ
ЁЯЪ╜ => ЁЯЪ╜, рдЯреЙрдпрд▓реЗрдЯ
ЁЯка => ЁЯка, рдЯреЙрдпрд▓реЗрдЯ, рдкреНрд▓рдВрдЧрд░, рдкреНрд▓рдВрдмрд░, рдлреЛрд░реНрд╕ рдХрдк, рд╕рдХреНрд╢рди
ЁЯЪ┐ => ЁЯЪ┐, рдЙрджрдХ, рд╢реЛрд╡рд░
ЁЯЫБ => ЁЯЫБ, рдиреНрд╣рд╛рдг, рдмрд╛рдердЯрдм
ЁЯкд => ЁЯкд, рдЙрдВрджрд░рд╛рдЪреЗрдВ рдЬрд╛рд│реЗрдВ, рдзрд░рдк, рдкрд╛рдВрдЬрд░реЛ, рдкрд╛рдВрджрд░реЛ
ЁЯкТ => ЁЯкТ, рдХрд╛рддрд░, рдзрд╛рд░рджрд╛рд░, рд╢реЗрд╡
ЁЯз┤ => ЁЯз┤, рдореЙрдпрд╢реНрдЪрд░рд╛рдпрдЭрд░, рд▓реЛрд╢рди, рд▓реЛрд╢рди рдмрд╛рдЯрд▓реА, рд╢реЕрдореНрдкреВ, рд╕рдиреНрд╕реНрдХреНрд░рд┐рди
ЁЯз╖ => ЁЯз╖, рдЖрд▓реНрдлрд┐рдиреЗрдд, рдбрд╛рдпрдкрд░, рдкрдВрдХ рд░реЙрдХ
ЁЯз╣ => ЁЯз╣, рдХреЛрдпрд░, рдирд┐рд╡рд│ рдХрд░рдк, рд╕рд╛рдиреНрди, рд╕рд╛рдиреНрди рдорд╛рд░рдк
ЁЯз║ => ЁЯз║, рдкрд┐рдХрдиреАрдХ, рдмрд╛рд╕реНрдХреЗрдЯ, рд▓рд╛рдБрдбреНрд░реА, рд╢реЗрдд
ЁЯз╗ => ЁЯз╗, рдЯреЙрдпрд▓реЗрдЯ рдкреЗрдкрд░, рдЯреЙрд╡реЗрд▓ рдкреЗрдкрд░, рдкреЗрдкрд░рд╛рдЪреА рдЧреБрдВрдбрд╛рд│реА
ЁЯкг => ЁЯкг, рдЯрдорд░реЗрд▓, рдкрд┐рдк, рдмрд╛рджрд▓реА, рдмрд╛рд▓рджреА
ЁЯз╝ => ЁЯз╝, рдирд┐рддрд│рд╕рд╛рдг, рдиреНрд╣рд╛рдВрд╡рдк, рдлреЗрд╕, рдмрд╛рд░, рд╕рд╛рдмрдг, рд╕рд╛рдмрдгрд╛рдЪреА рдмрд╢реА
ЁЯке => ЁЯке, рдХрд╛рд│рдЬреА, рдЯреБрдердмреНрд░рд╢, рджрд╛рдВрдд, рджрд╛рдВрддрд╛рдЪреЗрдВ, рдирд┐рддрд│, рдиреНрд╣рд╛рдгреАрдШрд░, рдмреНрд░рд╢
ЁЯз╜ => ЁЯз╜, рдУрдбрдкреА, рдирд┐рддрд│рд╕рд╛рдг, рд╢реЛрд╢рдг, рд╕реНрдкрд╛рдБрдЬ
ЁЯзп => ЁЯзп, рдЙрдЬреЛ, рдХреНрд╡реЗрдВрдЪ, рдкрд╛рд▓реЛрд╡рдкреА
ЁЯЫТ => ЁЯЫТ, рдХрд╛рд░реНрдЯ, рдЯреНрд░реЙрд▓реА, рд╢реЙрдкрд┐рдВрдЧ
ЁЯЪм => ЁЯЪм, рдзреБрдореНрд░рдкрд╛рди, рд╕рд┐рдЧрд╛рд░реЗрдЯ
тЪ░ => тЪ░, рдХреЙрдлреАрди, рдорд░рдг
ЁЯкж => ЁЯкж, рддреБрд│рд╕, рдорд╕рдВрдб, рдорд╕рдгрднреВрдВрдп, рд╕рд┐рдореЗрдЯреНрд░реА, рд╣реЗрдбрд╕реНрдЯреЛрди
тЪ▒ => тЪ▒, рдЕрд╕реНрдереА, рдЧреЛрдмреЛрд░, рдордбреЗрдВ, рдорд░рдг, рдорд░рдгрдпрд╛рддреНрд░рд╛
ЁЯЧ┐ => ЁЯЧ┐, рдЪреЗрд░реЛ, рдердбрдЧреАрдВ, рдердбрдЧреЗрдВ, рдкреБрддрд│реЛ
ЁЯкз => ЁЯкз, рдХреБрд░реВ, рдкрд╛рдЯреА, рдкрд┐рдХреЗрдЯ, рдкреНрд░рджрд░реНрд╢рди, рд╣рд░рдХрдд
ЁЯПз => ЁЯПз, рдПрдЯреАрдПрдо, рдПрдЯреАрдПрдо рдЪрд┐рдиреНрди, рдЯреЗрд▓рд░, рдмрдБрдХ, рд╕реНрд╡рдпрдВрдЪрд▓реАрдд
ЁЯЪо => ЁЯЪо, рд▓рд┐рдЯрд░, рд▓рд┐рдЯрд░ рдЗрди рдмрд┐рди рдЪрд┐рдиреНрди, рд▓рд┐рдЯрд░ рдмрд┐рди
ЁЯЪ░ => ЁЯЪ░, рдЙрджрдХ, рдкрд┐рдпреЗрд╡рдкрд╛рдЪреЗрдВ, рдкрд┐рд╡рдкрд╛рдЪреЗрдВ
тЩ┐ => тЩ┐, рдПрдХреНрд╕реЕрд╕, рд╡реНрд╣рд┐рд▓рдЪреЕрд░ рдЪрд┐рдиреНрди, рд╡реНрд╣реАрд▓рдЪрдХреНрд░ рдЪрд┐рдиреНрди
ЁЯЪ╣ => ЁЯЪ╣, рджрд╛рджрд▓реЛ, рджрд╛рджрд▓реНрдпрд╛рдЪреА рдХреБрдб, рджрд╛рджрд▓реНрдпрд╛рдВрдЪреА рдХреВрдб, рд╡рд┐рд╕рд╡ рдХреВрдбред wc, рд╕рдВрдбрд╛рд╕
ЁЯЪ║ => ЁЯЪ║, рдмрд╛рдпрд▓рд╛рдВрдЪреА рдХреВрдб, рд╕рдВрдбрд╛рд╕ред рд╡рд┐рд╕рд╡ рдХреВрдбред wcред рдмрд╛рдпрд▓ред рдмрд╛рдпрд▓рд╛рдВрдЪреА рдХреВрдб
ЁЯЪ╗ => ЁЯЪ╗, рд╡рд┐рд╕рд╡ рдХреВрдбред wc, рд╡рд┐рд╕рд╡рдХреВрдб, рд╕рдВрдбрд╛рд╕
ЁЯЪ╝ => ЁЯЪ╝, рдмрджрд▓рддрд╛, рд╢рд┐рд╢реВ, рд╢рд┐рд╢реВ рдЪрд┐рдиреНрди
ЁЯЪ╛ => ЁЯЪ╛, рдЙрджрдХрд╛рдЪреЛ рдХреНрд▓реЛрд╕реЗрдЯ, рдХреБрд░рдХреВрдЯред рд╕рдВрдбрд╛рд╕ред рд╡рд┐рд╕рд╡ рдХреВрдбред рдЙрджрдХред wc
ЁЯЫВ => ЁЯЫВ, рдирд┐рдпрдВрддреНрд░рдг, рдкрд╛рд░рдкрддреНрд░
ЁЯЫГ => ЁЯЫГ, рдХрд╕реНрдЯрдореНрд╕
ЁЯЫД => ЁЯЫД, рджрд╛рд╡реЛ, рдмреЕрдЧреЗрдЬ
ЁЯЫЕ => ЁЯЫЕ, рдЙрд░рд┐рд▓реНрд▓реЗрдВ рд╕рд╛рдорд╛рди, рд▓реЙрдХрд░, рд╕рд╛рдорд╛рди
тЪа => тЪа, рд╢рд┐рдЯрдХрд╛рд╡рдгреА
ЁЯЪ╕ => ЁЯЪ╕, рдХреНрд░реЙрд╕рд┐рдВрдЧ, рдЪрд┐рд▓реНрдбреНрд░реЗрди рдХреНрд░реЙрд╕рд┐рдВрдЧ, рдкрд╛рджрдЪрд╛рд░реА, рднреБрд░рдЧреЗрдВ, рднреБрд░рдЧреНрдпрд╛рдВ рдХреНрд░реЙрд╕рд┐рдВрдЧ, рдпреЗрд░рд╛рджрд╛рд░реА
тЫФ => тЫФ, рдирд╛, рдирд╛рдХрд╛, рдирд┐рд╖рд┐рдзреНрдж, рдкреНрд░рддрд┐рдмрдВрдзреАрдд, рдкреНрд░рд╡реЗрд╢, рдпреЗрд░рд╛рджрд╛рд░реА
ЁЯЪл => ЁЯЪл, рдирд╛, рдирд╛рдХрд╛, рдирд┐рд╖рд┐рдзреНрдж, рдкреНрд░рддрд┐рдмрдВрдзреАрдд, рдкреНрд░рд╡реЗрд╢
ЁЯЪ│ => ЁЯЪ│, рдирд╛, рдирд┐рд╖рд┐рдзреНрдж, рдкреНрд░рддрд┐рдмрдВрдзреАрдд, рдмрд╛рдпрдХ, рд╕рд╛рдпрдХрд▓, рд╕рд╛рдпрдХрд▓реА рдирд╛
ЁЯЪн => ЁЯЪн, рдзреБрдореНрд░рдкрд╛рди, рдирд╛, рдирд╛рдХрд╛, рдирд┐рд╖рд┐рдзреНрдж, рдкреНрд░рддрд┐рдмрдВрдзреАрдд
ЁЯЪп => ЁЯЪп, рдирд╛, рдирд╛рдХрд╛, рдирд┐рд╖рд┐рдзреНрдж, рдкреНрд░рддрд┐рдмрдВрдзреАрдд, рд▓рд┐рдЯрд░, рд▓рд┐рдЯрд░реАрдВрдЧ
ЁЯЪ▒ => ЁЯЪ▒, рдЙрджрдХ, рдкрд┐рдпреЗрд╡рдкрд╛рдЪреЗрдВ рдиреНрд╣рдп, рдкрд┐рдпреЗрд╡рдкрд╛рдЪреЗрдВ рдиреНрд╣рдп рдЕрд╢реЗрдВ рдЙрджрдХ
ЁЯЪ╖ => ЁЯЪ╖, рдирд╛, рдирд╛рдХрд╛, рдирд┐рд╖рд┐рдзреНрдж, рдкрд╛рджрдЪрд╛рд░реА, рдкрд╛рджрдЪрд╛рд░реА рдирд╛рдд, рдкрд╛рджрдЪрд╛рд░реА рдиреНрд╣рдп, рдкреНрд░рддрд┐рдмрдВрдзреАрдд
ЁЯУ╡ => ЁЯУ╡, рдирд╛, рдирд┐рд╖рд┐рдзреНрдж, рдлреЛрди, рдореЛрдмрд╛рдпрд▓, рд╕реЕрд▓
ЁЯФЮ => ЁЯФЮ, 18, рдЕрдард░рд╛, рдЕрдард░рд╛ рд╡рд░реНрд╕рд╛рдВ рдЦрд╛рд▓рд╛ рдХреЛрдг рдирд╛, рдкреНрд░рддрд┐рдмрдВрдзреАрдд, рд╡рдп рдорд░реНрдпрд╛рджрд╛, рд╕рд╛рдирдкрд┐рд░рд╛рдп
тШв => тШв, рдЪрд┐рдиреНрди, рд░реЗрдбрд┐рдпреЛрдПрдХреНрдЯрд┐рд╡
тШг => тШг, рдЪрд┐рдиреНрди, рдмрд╛рдпреЛрд╣рдЬрд╛рд░реНрдб
тмЖ => тмЖ, рдЙрддреНрддрд░, рдХрд╛рд░реНрдбрд┐рдирд▓, рджрд┐рд╢рд╛, рдмрд╛рдг, рд╡рдпрд░ рдмрд╛рдг
тЖЧ => тЖЧ, рдИрд╢рд╛рдиреНрдп, рдЙрдкрджрд┐рд╢рд╛, рджрд┐рд╢рд╛, рдмрд╛рдг, рд╡рдпрд░-рдЙрдЬрд╡реЛ рдмрд╛рдг
тЮб => тЮб, рдЙрдЬрд╡реЛ рдмрд╛рдг, рдЙрджреЗрдВрдд, рджрд┐рд╢рд╛, рдмрд╛рдг, рдореБрдЦреЗрд▓ рджрд┐рд╢рд╛
тЖШ => тЖШ, рдЖрдЧреНрдиреЗрдп, рдЙрдкрджрд┐рд╢рд╛, рджрд┐рд╢рд╛, рдмрд╛рдг, рд╕рдХрдпрд▓-рдЙрдЬрд╡реЛ рдмрд╛рдг
тмЗ => тмЗ, рджрдХреНрд╖рд┐рдг, рджрд┐рд╢рд╛, рдмрд╛рдг, рдореБрдЦреЗрд▓рджрд┐рд╢рд╛, рд╕рдХрдпрд▓
тЖЩ => тЖЩ, рдЙрдкрджрд┐рд╢рд╛, рджрд┐рд╢рд╛, рдиреИрдЛрддреНрдп, рдмрд╛рдг, рд╕рдХрдпрд▓-рджрд╛рд╡реЛ рдмрд╛рдг
тмЕ => тмЕ, рдЕрд╕реНрддрдВрдд, рджрд╛рд╡реЛ рдмрд╛рдг, рджрд┐рд╢рд╛, рдмрд╛рдг, рдореБрдЦреЗрд▓рджрд┐рд╢рд╛
тЖЦ => тЖЦ, рдЙрдкрджрд┐рд╢рд╛, рджрд┐рд╢рд╛, рдмрд╛рдг, рд╡рдпрд░-рджрд╛рд╡реЛ рдмрд╛рдг, рд╡рд╛рдпрд╡реНрдп
тЖХ => тЖХ, рдмрд╛рдг, рд╡рдпрд░-рд╕рдХрдпрд▓ рдмрд╛рдг
тЖФ => тЖФ, рджрд╛рд╡реЛ  рдЙрдЬрд╡реЛ рдмрд╛рдг, рдмрд╛рдг
тЖй => тЖй, рдЙрдЬрд╡реЛ рдмрд╛рдг рджрд╛рд╡реНрдпрд╛рди рд╡рд│рд╛, рдмрд╛рдг
тЖк => тЖк, рджрд╛рд╡реЛ рдмрд╛рдг рдЙрдЬрд╡реНрдпрд╛рди рд╡рд│рд╛, рдмрд╛рдг
тд┤ => тд┤, рдЙрдЬрд╡реЛ рдмрд╛рдг рд╡рдпрд░ рд╡рд│рд╛, рдмрд╛рдг
тд╡ => тд╡, рдЙрдЬрд╡реЛ рдмрд╛рдг рд╕рдХрдпрд▓ рд╡рд│рд╛, рдмрд╛рдг, рд╕рдХрдпрд▓
ЁЯФГ => ЁЯФГ, рдШрдбреНрдпрд╛рд│реАрд╡рд░реАрдВ, рдШрдбреНрдпрд╛рд│реАрд╡рд░реАрдВ рдЙрдЬрд╡реЗ рдмрд╛рдг, рдШрдбреНрдпрд╛рд│реАрд╡рд░реАрдВ рдЙрдмреЗ рдмрд╛рдг, рдкрд░рдд рд▓реЛрдб, рдмрд╛рдг
ЁЯФД => ЁЯФД, рдШрдбреНрдпрд╛рд│реАрд╡рд┐рд░реБрдзреНрдж, рдШрдбреНрдпрд╛рд│реАрд╡рд┐рд░реБрдзреНрдж рдмрд╛рдгрд╛рдВрдЪреЛ рдмрдЯрдг, рдШрдбреНрдпрд╛рд│реАрд╡рд┐рд░реБрдзреНрдж рдмрд╛рдо рдмрдЯрдг, рдмрд╛рдг, рд╡рд┐рдерд░рд╢рд┐рдиреНрд╕
ЁЯФЩ => ЁЯФЩ, рдлрд╛рдЯреАрдВ, рдмрд╛рдг
ЁЯФЪ => ЁЯФЪ, рдмрд╛рдг, рд╕рдорд╛рдкреНрдд
ЁЯФЫ => ЁЯФЫ, рдЦреВрдг, рдЪрд╛рд▓реВ, рдЪрд╛рд▓реВ рдмрд╛рдг, рдмрд╛рдг
ЁЯФЬ => ЁЯФЬ, рдмрд╛рдг, рд░реЛрдЦрдбреЗрдВрдЪ
ЁЯФЭ => ЁЯФЭ, рдЙрдЪ, рдмрд╛рдг, рд╡рдпрд░
ЁЯЫР => ЁЯЫР, рдзрд░реНрдо, рдкреНрд░рд╛рд░реНрдердирд╛, рдкреНрд░рд╛рд░реНрдердиреЗрдЪреА рд╕реБрд╡рд╛рдд
тЪЫ => тЪЫ, рдЕрдгреВ, рдЕрдгреВ рдЪрд┐рдиреНрди, рдЕрдереЗрдпрд╕реНрдЯ
ЁЯХЙ => ЁЯХЙ, рдУрдо, рдзрд░реНрдо, рд╣рд┐рдВрджреБ
тЬб => тЬб, рдЬреНрдпреБ, рдбреЕрд╡рд┐рдб, рдзрд░реНрдо, рдирдЦреЗрддреНрд░, рд╕реНрдЯрд╛рд░ рдСрдл рдбреЕрд╡рд┐рдб
тШ╕ => тШ╕, рдЪрдХреНрд░, рдзрд░реНрдо, рдзрд░реНрдордЪрдХреНрд░, рдмреБрдзреНрджреАрд╢реНрда
тШп => тШп, рдЯрд╛рдУ, рдЯрд╛рдУрдпрд┐рд╕реНрдЯ, рдзрд░реНрдо, рдпрд╛рдВрдЧ, рдпреАрди
тЬЭ => тЬЭ, рдХреНрд░реЙрд╕, рдЦреНрд░рд┐рд╢реНрдЪрди, рдзрд░реНрдо, рд▓реЕрдЯреАрди рдХреНрд░реЙрд╕
тШж => тШж, рдХреНрд░реЙрд╕, рдЦреНрд░рд┐рд╢реНрдЪрди, рдзрд░реНрдо, рд╕рдирд╛рддрдиреА рдХреНрд░реЙрд╕
тШк => тШк, рдИрд╕реНрд▓рд╛рдо, рдзрд░реНрдо, рдирдЦреЗрддреНрд░ рдЖрдиреА рдЪрдВрджреНрд░рдХреЛрд░, рдореБрд╕реНрд▓реАрдо
тШо => тШо, рд╢рд╛рдВрддреА, рд╢рд╛рдВрддреАрдЪреЗрдВ рдЪрд┐рдиреНрди
ЁЯХО => ЁЯХО, рдХрдБрдбрд▓рд╕реНрдЯрд┐рдХ, рдХрдБрдбрд▓рд╛рдмреНрд░рдо, рдзрд░реНрдо, рдордиреЛрд░рд╛
ЁЯФп => ЁЯФп, рдирдЦреЗрддреНрд░, рдлреЙрд░реНрдЪреНрдпреБрди, рдмрд┐рдВрджреБрдВрдЪреЗрдВ рд╕-рдЖрдВрд╕рд╛рдВрдЪреЗрдВ рдирдЦреЗрддреНрд░
тЩИ => тЩИ, рдореЗрд╖, рд░рд╛рдо, рд░рд╛рд╕
тЩЙ => тЩЙ, рдкрд╛рдбреЛ, рдмреИрд▓, рд░рд╛рд╕, рд╡реГрд╖рдн
тЩК => тЩК, рдЬреБрд│реАрдВ, рдорд┐рдереБрди, рд░рд╛рд╕
тЩЛ => тЩЛ, рдХрд░реНрдХ, рдХрд░реНрдХрд░реЛрдЧ, рдХреБрд▓реНрд▓реА, рд░рд╛рд╕
тЩМ => тЩМ, рд░рд╛рд╕, рд╢рд┐рдВрд╡, рд╕рд┐рдВрд╣
тЩН => тЩН, рдХрдиреНрдпрд╛, рд░рд╛рд╕
тЩО => тЩО, рддреБрд│, рдиреНрдпрд╛рдп, рдореЗрдЬрдк, рд░рд╛рд╕, рд╕рдорддреЛрд▓
тЩП => тЩП, рд░рд╛рд╕, рд╡рд┐рдЪрд╡рд╛рд╕рдорд╛рди, рд╡рд┐рдЪреВ, рд╡реГрд╢реНрдЪреАрдХ
тЩР => тЩР, рдзрдиреБ, рдзрдиреБрд░реНрдзрд░, рд░рд╛рд╕
тЩС => тЩС, рдмреЛрдХрдбреА, рдордХрд░, рд░рд╛рд╕
тЩТ => тЩТ, рдЙрджрдХ, рдХреБрдВрдн, рдмреЗрд░рд░, рд░рд╛рд╕
тЩУ => тЩУ, рдиреБрд╕реНрддреНрдпреЗрдВ, рдореАрди, рд░рд╛рд╕
тЫО => тЫО, рдЬрд┐рд╡рд╛рдгреЗрдВ, рдмреЗрд░рд░, рднреБрдЬрдВрдЧрдзрд╛рд░реА, рд░рд╛рд╕, рд╕рд░рдкрдЯрдкреА
ЁЯФА => ЁЯФА, рдХреНрд░реЙрд╕реНрдб, рдмрд╛рдг, рд╢рдлрд▓ рдЯреНрд░реЕрдХреНрд╕ рдмрдЯрдг
ЁЯФБ => ЁЯФБ, рдШрдбреНрдпрд╛рд│реАрд╡рд░реАрдВ, рдкреБрдирд░рд╛рд╡реГрддреНрддреА, рдкреБрдирд░рд╛рд╡реГрддреНрддреА рдмрдЯрдг, рдмрд╛рдг
ЁЯФВ => ЁЯФВ, рдПрдХрджрд╛рдВ, рдШрдбреНрдпрд╛рд│реАрд╡рд░реАрдВ, рдкреБрдирд░рд╛рд╡реГрддреНрддреА рдПрдХреЛрдбреЛ рдмрдЯрдг, рдмрд╛рдг
тЦ╢ => тЦ╢, рдЙрдЬрд╡реЛ, рддреНрд░рд┐рдХреЛрдг, рдмрд╛рдг, рд╡рд╛рдЬреЛрд╡рдЪреЗрдВ, рд╡рд╛рдЬреЛрд╡рдЪреЗрдВ рдмрдЯрдг
тПй => тПй, рдЬрд▓рдж, рдЬрд▓рдж рдлреБрдбреЗрдВ рдзреБрдХрд▓рдк, рдЬрд▓рдж-рдлреБрдбреЗрдВ рдзреБрдХрд▓рдк рдмрдЯрдг, рджреЛрдирджрд╛рдВ, рдлреБрдбреЗрдВ рдзреБрдХрд▓рдк, рдмрд╛рдг
тПн => тПн, рддреНрд░рд┐рдХреЛрдг, рдлреБрдбрд▓реЗ рдЯреНрд░реЕрдХ рдмрдЯрдг, рдлреБрдбрд▓реЗрдВ рджреГрд╢реНрдп, рдлреБрдбрд▓реЛ рдЯреНрд░реЕрдХ, рдлреБрдбрд▓реЛ рдЯреНрд░реЕрдХ рдмрдЯрдг, рдмрд╛рдг
тПп => тПп, рдЙрдЬрд╡реЛ, рддреНрд░рд┐рдХреЛрдг, рдерд╛рд░рд╛рд╡рдк, рдмрд╛рдг, рд╡рд╛рдЬреЛрд╡рдк, рд╡рд╛рдЬреЛрд╡рдк рд╡рд╛ рдерд╛рд░рд╛рд╡рдк рдмрдЯрдг
тЧА => тЧА, рддреНрд░рд┐рдХреЛрдг, рджрд╛рд╡реЛ, рдлрд╛рдЯреАрдВ рдШреЗрд╡рдк, рдлрд╛рдЯреАрдВ рдШреЗрд╡рдк рдмрдЯрдг, рдмрд╛рдг
тПк => тПк, рдЬрд▓рдж рдлрд╛рдЯреАрдВ рдШреЗрд╡рдк, рдЬрд▓рдж рдлрд╛рдЯреАрдВ рдШреЗрд╡рдк рдмрдЯрдг, рджреЛрдирджрд╛рдВ, рдлрд╛рдЯреАрдВ рд╣рд╛рдбрдк, рдмрд╛рдг
тПо => тПо, рдЖрджрд▓реЗрдВ рджреГрд╢реНрдп, рдЖрджрд▓реЛ рдЯреНрд░реЕрдХ, рддреНрд░рд┐рдХреЛрдг, рдирд┐рдорд╛рдгреЛ рдЯреНрд░реЕрдХ рдмрдЯрдг, рдмрд╛рдг
ЁЯФ╝ => ЁЯФ╝, рддрд╛рдВрдмрдбреЛ, рдмрдЯрдг, рдмрд╛рдг, рд╡рдпрд▓реЗ рд╡рдЯреЗрди рдмрдЯрдг, рд╡рдпрд▓реЗрд╡рдЯреЗрди рдмрдЯрдг
тПл => тПл, рдЬрд▓рдж рд╡рдпрд░ рдмрдЯрдг, рджреЛрдирджрд╛рдВ, рдмрд╛рдг
ЁЯФ╜ => ЁЯФ╜, рддрд╛рдВрдмрдбреЛ, рдмрдЯрдг, рдмрд╛рдг, рд╕рдХрдпрд▓, рд╕рдХрдпрд▓ рд╡рдЯреЗрди рдмрдЯрдг
тПм => тПм, рдЬрд▓рдж рд╕рдХрдпрд▓ рдмрдЯрдг, рдбрд▓рдж рд╕рдХрдпрд▓ рдмрдЯрдг, рджреЛрдирджрд╛рдВ, рдмрд╛рдг, рд╕рдХрдпрд▓
тП╕ => тП╕, рдЙрдмреЛ, рдерд╛рд░рд╛рд╡рдгреА, рдерд╛рд░рд╛рд╡рдгреА рдмрдЯрдг, рджреЛрдирджрд╛рдВ, рдмрд╛рд░
тП╣ => тП╣, рдЪрд╡рдХреЛрди, рдерд╛рдВрдмреЛрд╡рдк, рдерд╛рдВрдмреЛрд╡рдк рдмрдЯрдг
тП║ => тП║, рд░реЕрдХреЙрд░реНрдб, рд░реЕрдХреЙрд░реНрдб рдмрдЯрдг, рд╡рд░реНрддреБрд│
тПП => тПП, рднрд╛рдпрд░ рдХрд╛рдбрдк, рднрд╛рдпрд░ рдХрд╛рдбрдк рдмрдЯрдг
ЁЯОж => ЁЯОж, рдХреЕрдореЗрд░рд╛, рдЪрд┐рддреНрд░рдкрдЯ, рдореБрд╡реНрд╣реА, рд╕рд┐рдиреЗрдорд╛
ЁЯФЕ => ЁЯФЕ, рдЙрдЬрд│рд╕рд╛рдг, рдХрдореА, рдордВрдж, рдордВрдж рдмрдЯрдг
ЁЯФЖ => ЁЯФЖ, рдЙрдЬрд│, рдЙрдЬрд│ рдмрдЯрдг, рдЙрдЬрд│рд╕рд╛рдг
ЁЯУ╢ => ЁЯУ╢, рдПрдгреНрдЯреЗрдирд╛, рдПрдгреНрдЯреЗрдирд╛ рдмрд╛рд░реНрд╕, рдлреЛрди, рдмрд╛рд░, рдореЛрдмрд╛рдпрд▓, рд╕реЕрд▓
ЁЯУ│ => ЁЯУ│, рдХрдВрдкрди, рдЯреЕрд▓рд┐рдлреЛрди, рдлреЛрди, рдореЛрдб, рдореЛрдмрд╛рдпрд▓, рд╕реЕрд▓
ЁЯУ┤ => ЁЯУ┤, рдЯреЕрд▓рд┐рдлреЛрди, рдлреЛрди, рдмрдВрдж, рдореЛрдмрд╛рдпрд▓, рд╕реЕрд▓
тЩА => тЩА, рдмрд╛рдпрд▓, рдмрд╛рдпрд▓ рдЪрд┐рдиреНрди
тЩВ => тЩВ, рджрд╛рджрд▓реЛ, рджрд╛рджрд▓реЛ рдЪрд┐рдиреНрди
тЪз => тЪз, рддреГрддрд┐рдпрдкрдВрдереА, рддреГрддрд┐рдпрдкрдВрдереА рдЪрд┐рдиреНрди
тЬЦ => тЬЦ, x, рдЧреБрдгрд╛рдХрд╛рд░, рдЧреБрдгреБрд▓реЗ, рдЪрд┐рдиреНрди, рд░рджреНрдж
тЮХ => тЮХ, рдЕрджреАрдХ, рдЧрдгреАрдд, рдЪрд┐рдиреНрди
тЮЦ => тЮЦ, рдЧрдгреАрдд, рдЪрд┐рдиреНрди, рд╡рдЬрд╛
тЮЧ => тЮЧ, рдЧрдгреАрдд, рдЪрд┐рдиреНрди, рднрд╛рдЧрд╛рдХрд╛рд░
тЩ╛ => тЩ╛, рдЕрдирдВрдд, рдпреБрдирд┐рд╡рд░реНрд╕рд▓, рд╢рд┐рдордирд╛рд╢рд┐рд▓реНрд▓реЗрдВ, рд╕рджрд╛рдВрдХрд╛рд│
тА╝ => тА╝, рдЙрджреНрдЧрдЧрд╛рд░, рдЪрд┐рдиреНрди, рджреЛрдЯреНрдЯреА рдЙрджреНрдЧрд╛рд░ рдЪрд┐рдиреНрди, рдмрдБрдЧрдмрдБрдЧ
тБЙ => тБЙ, рдЗрдВрдЯреЛрд░реЛрдмрдБрдЧ, рдЙрджреНрдЧрд╛рд░, рдЙрджреНрдЧрд╛рд░ рдкреНрд░рд╕реНрди рдЪрд┐рдиреНрди, рдЦреВрдг, рд╡рд┐рд░рд╛рдо рдЪрд┐рдиреНрдиред рдкреНрд░рд╕реНрди
тЭУ => тЭУ, рдЪрд┐рдиреНрди, рдкреНрд░рд╕реНрди, рд╡рд┐рд░рд╛рдордЪрд┐рдиреНрди
тЭФ => тЭФ, рдЪрд┐рдиреНрди, рдзрд╡реЗрдВ рдкреНрд░рд╕реНрди рдЪрд┐рдиреНрди, рдкреНрд░рд╕реНрди, рд░реБрдкрд░реЗрдЦрд╛, рд╡рд┐рд░рд╛рдордЪрд┐рдиреНрди
тЭХ => тЭХ, рдЙрджреНрдЧрд╛рд░, рдЪрд┐рдиреНрди, рдзрд╡реЗрдВ рдЙрджреНрдЧрд╛рд░ рдЪрд┐рдиреНрди, рд░реБрдкрд░реЗрдЦрд╛, рд╡рд┐рд░рд╛рдордЪрд┐рдиреНрди
тЭЧ => тЭЧ, рдЙрджреНрдЧрд╛рд░, рдЪрд┐рдиреНрди, рд╡рд┐рд░рд╛рдордЪрд┐рдиреНрди
уА░ => уА░, рдбреЕрд╢, рддрд░рдВрдЧ, рд╡рд┐рд░рд╛рдордЪрд┐рдиреНрди
ЁЯТ▒ => ЁЯТ▒, рдЪрд▓рди, рдкрдпрд╢реЗ, рдмрдБрдХ, рд╡рд┐рдирд┐рдпреЛрдЧ
ЁЯТ▓ => ЁЯТ▓, рдЪрд▓рди, рдЬрдб рдбреЙрд▓рд░ рдХреБрд░реВ, рдбреЙрд▓рд░, рдкрдпрд╢реЗ
тЪХ => тЪХ, рдПрд╕реНрдХреБрд▓рд╛рдкрд┐рдпрд╕, рд╡реИрджреНрдпрдХреАрдп, рд╡реИрджреНрдпрдХреАрдп рдЪрд┐рдиреНрди, рд╕реНрдЯрд╛рдл
тЩ╗ => тЩ╗, рд░рд┐рд╕рд╛рдпрдХрд▓, рд░рд┐рд╕рд╛рдпрдХрд▓реАрдВрдЧ рдЪрд┐рдиреНрди
тЪЬ => тЪЬ, рдлреНрд▓реБрд░  рджреЗ рд▓реАрд╕, рдлреНрд▓реБрд░ рджреЗ рд▓реАрд╕
ЁЯФ▒ => ЁЯФ▒, рдЪрд┐рдиреНрди, рдЬрд╣рд╛рдЬ, рддреНрд░рд┐рд╢реВрд│, рдирд╛рдВрдЧрд░, рд╕рд╛рдзрди
ЁЯУЫ => ЁЯУЫ, рдирд╛рдВрд╡, рдирд╛рдВрд╡рд╛рдЪреЛ рдмрд┐рд▓реНрд▓реЛ, рдмрд┐рд▓реНрд▓реЛ
ЁЯФ░ => ЁЯФ░, рдЬрдкрд╛рдиреА, рдкрд╛рди, рд╢реЕрд╡рд░реЙрди, рд╕реБрд░рд╡рд╛рдд рдХрд░рдкреА, рд╕реБрд░рд╡рд╛рдд рдХрд░рдкреНрдпрд╛рдВ рдЦрд╛рддреАрд░ рдЬрдкрд╛рдиреА рдЪрд┐рдиреНрди
тнХ => тнХ, o, рддрд╛рдВрдмрдбреЗрдВ, рд╡рд░реНрддреБрд│, рд╡реНрд╣рдб, рд╣реЙрд▓реЛ рддрд╛рдВрдмрдбреЗрдВ рд╡рд░реНрддреБрд│
тЬЕ => тЬЕ, рдЪрд┐рдиреНрди, рддрдкрд╛рд╕рдгреА, рддрдкрд╛рд╕рдгреА рдЪрд┐рдиреНрди рдЦреВрдг, рдмрдЯрдг
тШС => тШС, рддрдкрд╛рд╕ рдЪрд┐рдиреНрдирд╛ рд╕рдпрдд рддрдкрд╛рд╕рдгреА рдмреЙрдХреНрд╕, рддрдкрд╛рд╕рдгреА, рддрдкрд╛рд╕рдгреА рдЪрд┐рдиреНрдирд╛ рд╕рдпрдд рддрдкрд╛рд╕рдгреА рдмреЙрдХреНрд╕, рдмреЙрдХреНрд╕
тЬФ => тЬФ, рдЪрд┐рдиреНрди, рддрдкрд╛рд╕рдгреА
тЭМ => тЭМ, x, рдХреНрд░реЙрд╕, рдХреНрд░реЙрд╕ рдорд╛рд░реНрдХ, рдЦреВрдг, рдЧреБрдгрд╛рдХрд╛рд░, рдЧреБрдгрд╛рдХрд╛рд░ рдХрд░рдк, рд░рджреНрдж
тЭО => тЭО, x, рдХреНрд░реЙрд╕ рдЦреВрдг рдмрдЯрдг, рдХреНрд░реЙрд╕ рдЪрд┐рдиреНрди рдмрдЯрдг, рдЦреВрдг, рдЪрд╡рдХреЛрдг
тЮ░ => тЮ░, рдХреБрд░рд│реЛ, рд╡рд▓рдп
тЮ┐ => тЮ┐, рдХреБрд░рд│реЛ, рджреЛрдЯреНрдЯреА, рд╡рд▓рдп
уА╜ => уА╜, рдЪрд┐рдиреНрди, рднрд╛рдЧ, рднрд╛рдЧ рдмрджрд▓рдкрд╛рдЪреЗрдВ рдЪрд┐рдиреНрди
тЬ│ => тЬ│, рдЖрда-рдЖрдВрд╕рд╛рдЪреЗрдВ рдирдЦреЗрддреНрд░, рдирдЦреЗрддреНрд░
тЬ┤ => тЬ┤, рдЖрда-рдмрд┐рдВрджреБрдВрдЪреЗрдВ рдирдЦреЗрддреНрд░, рдирдЦреЗрддреНрд░
тЭЗ => тЭЗ, рдЪрдХрдЪрдХ
┬й => ┬й, c, рдорд╛рд▓рдХреАрд╣рдХреНрдХ
┬о => ┬о, r, рдиреЛрдВрджрдгреАрдХреГрдд
тДв => тДв, tm, рдЪрд┐рдиреНрди, рд╡реЗрдкрд╛рд░ рдЪрд┐рдиреНрди, рд╡реЗрдкрд╛рд░рдЪрд┐рдиреНрди
ЁЯФа => ЁЯФа, ABCD, рдЕрдХреНрд╖рд░рд╛рдВ, рдЗрдирдкреВрдЯ, рдЗрдирдкреВрдЯ рд▓реЕрдЯреАрди рдЕрдкрд░рдХреЗрд╕, рд▓рд╛рддреАрдВ, рд╡реНрд╣рдб рдЕрдХреНрд╖рд░рд╛рдВ
ЁЯФб => ЁЯФб, abcd, рдЕрдХреНрд╖рд░рд╛рдВ, рдЗрдирдкреВрдЯ, рдЗрдирдкреВрдЯ рд▓реЕрдЯреАрди рд▓реЛрд╡рд░рдХреЗрд╕, рд▓рд╛рддреАрдВ, рд▓реНрд╣рд╛рди рдЕрдХреНрд╖рд░рд╛рдВ
ЁЯФв => ЁЯФв, 1234, рдЖрдВрдХрдбреЗ, рдЗрдирдкреВрдЯ
ЁЯФг => ЁЯФг, уАТтЩк&%, рдЗрдирдкреВрдЯ, рдЗрдирдкреВрдЯ рдЪрд┐рдиреНрдирд╛рдВ
ЁЯФд => ЁЯФд, abc, рдЕрдХреНрд╖рд░рд╛рдВ, рдЗрдирдкреВрдЯ, рдЗрдирдкреВрдЯ рд▓реЕрдЯреАрди рдЕрдХреНрд╖рд░рд╛рдВ, рд▓рд╛рддреАрдВ
ЁЯЕ░ => ЁЯЕ░, a, A рдмрдЯрдг (рд░рдХреНрддрд╛рдЪреЛ рдЧрдЯ), рд░рдХреНрддрд╛рдЪреЛ рдЧрдЯ
ЁЯЖО => ЁЯЖО, ab, AB рдмрдЯрдг (рд░рдХреНрддрд╛рдЪреЛ рдЧрдЯ), рд░рдХреНрддрд╛рдЪреЛ рдЧрдЯ
ЁЯЕ▒ => ЁЯЕ▒, b, B рдмрдЯрдг (рд░рдХреНрддрд╛рдЪреЛ рдЧрдЯ), рд░рдХреНрддрд╛рдЪреЛ рдЧрдЯ
ЁЯЖС => ЁЯЖС, cl, CL рдмрдЯрдг
ЁЯЖТ => ЁЯЖТ, рдердВрдб, рдердВрдб рдмрдЯрдг
ЁЯЖУ => ЁЯЖУ, рдореЗрдХрд│реЛ, рдореЗрдХрд│реЛ рдмрдЯрдг
тД╣ => тД╣, рдорд╛рд╣рд┐рддреА, рдореНрд╣рд╛рдпрддреА
ЁЯЖФ => ЁЯЖФ, id, ID рдмрдЯрдг, рд╡рд│рдЦ
тУВ => тУВ, m, рд╡рд░реНрддреБрд│, рд╡рд░реНрддреБрд│ рдХреЗрд▓реНрд▓реЛ M
ЁЯЖХ => ЁЯЖХ, рдирд╡реЛ, рдирд╡реЛ рдмрдЯрдг
ЁЯЖЦ => ЁЯЖЦ, ng, NG рдмрдЯрдг
ЁЯЕ╛ => ЁЯЕ╛, o, O рдмрдЯрдг (рд░рдХреНрддрд╛рдЪреЛ рдЧрдЯ), рд░рдХреНрддрд╛рдЪреЛ рдЧрдЯ
ЁЯЖЧ => ЁЯЖЧ, рдУрдХреЗ, рдУрдХреЗ рдмрдЯрдг
ЁЯЕ┐ => ЁЯЕ┐, P рдмрдЯрдг, рдкрд╛рд░реНрдХрд┐рдВрдЧ
ЁЯЖШ => ЁЯЖШ, sos, SOS рдмрдЯрдг, рдЖрджрд╛рд░
ЁЯЖЩ => ЁЯЖЩ, UP рдмрдЯрдг, рдЦреВрдгред рд╡рдпрд░ред рд╡рдпрд░ рдмрдЯрдг
ЁЯЖЪ => ЁЯЖЪ, VS рдмрдЯрдг, рдЖрдб
ЁЯИБ => ЁЯИБ, тАЬрд╣рд╛рдВрдЧрд╛тАЭ, рдХрд╛рдЯрд╛рдХрд╛рдирд╛, рдЬрдкрд╛рдиреА, рдЬрдкрд╛рдиреА тАЬрд╣рд╛рдВрдЧрд╛тАЭ рдмрдЯрдг, уВ│уВ│
ЁЯИВ => ЁЯИВ, тАЬрд╕реЗрд╡рд╛ рд╢реБрд▓реНрдХтАЭ, рдХрд╛рдЯрдХрд╛рдирд╛, рдЬрдкрд╛рдиреА, рдЬрдкрд╛рдиреА тАЬрд╕реЗрд╡рд╛ рд╢реБрд▓реНрдХтАЭ рдмрдЯрдг, уВ╡
ЁЯИ╖ => ЁЯИ╖, тАЬрдореНрд╣рдпрдиреНрдпрд╛рд│реА рд░рдХреНрдХрдотАЭ, рдЖрдпрдбрд┐рдУрдЧреНрд░рд╛рдл, рдЬрдкрд╛рдиреА, рдЬрдкрд╛рдиреА тАЬрдорд╛рд╕реАрдХ рд░рдХреНрдХрдотАЭрдмрдЯрдг, рдЬрдкрд╛рдиреА тАЬрдореНрд╣рдпрдиреНрдпрд╛рд│реА рд░рдХреНрдХрдотАЭ рдмрдЯрдг, цЬИ
ЁЯИ╢ => ЁЯИ╢, тАЬрдлреБрдХрдЯ рдиреНрд╣рдптАЭ, рдЖрдпрдбрд┐рдУрдЧреНрд░рд╛рдл, рдЬрдкрд╛рдиреА, рдЬрдкрд╛рдиреА тАЬрдлреБрдХрдЯ рдиреНрд╣рдптАЭ рдмрдЯрдг, рдЬрдкрд╛рдиреА тАЬрд╢реБрд▓реНрдХ рдирд╛рд╕рддрдирд╛ рдиреНрд╣рдптАЭ рдмрдЯрдг, цЬЙ
ЁЯИп => ЁЯИп, тАЬрдЖрд░рдХреНрд╖реАрддтАЭ, рдЖрдпрдбрд┐рдпреЛрдЧреНрд░рд╛рдл, рдЬрдкрд╛рдиреА, рдЬрдкрд╛рдиреА тАЬрдЖрд░рдХреНрд╖реАрддтАЭ рдмрдЯрдг, цМЗ
ЁЯЙР => ЁЯЙР, тАЬрд╡рд╛рдгрдкрдгтАЭ, рдЖрдпрдбрд┐рдУрдЧреНрд░рд╛рдл, рдЬрдкрд╛рдиреА, рдЬрдкрд╛рдиреА тАЬрдмрд╛рд░рдЧреЗрдитАЭ рдмрдЯрдг, рдЬрдкрд╛рдиреА тАЬрд╡рд╛рдгрдкрдгтАЭ рдмрдЯрдг, х╛Ч
ЁЯИ╣ => ЁЯИ╣, тАЬрд╕реВрдЯтАЭ, рдЖрдпрдбрд┐рдУрдЧреНрд░рд╛рдл, рдЬрдкрд╛рдиреА, рдЬрдкрд╛рдиреА тАЬрд╕рд╡рд▓рддтАЭ рдмрдЯрдг, рдЬрдкрд╛рдиреА тАЬрд╕реВрдЯтАЭ рдмрдЯрдг, хЙ▓
ЁЯИЪ => ЁЯИЪ, тАЬрдлреБрдХрдЯтАЭ, рдЖрдпрдбрд┐рдУрдЧреНрд░рд╛рдл, рдЬрдкрд╛рдиреА, рдЬрдкрд╛рдиреА тАЬрдлреБрдХрдЯтАЭ рдмрдЯрдг, рдЬрдкрд╛рдиреА тАЬрд╢реБрд▓реНрдХ рдирд╛ тАЬ рдмрдЯрдг, чДб
ЁЯИ▓ => ЁЯИ▓, тАЬрдкреНрд░рддрд┐рдмрдВрдзреАрддтАЭ, рдЖрдпрдбрд┐рдУрдЧреНрд░рд╛рдл, рдЬрдкрд╛рдиреА, рдЬрдкрд╛рдиреА тАЬрдкреНрд░рддрд┐рдмрдВрдзтАЭ рдмрдЯрдг, рдЬрдкрд╛рдиреА тАЬрдкреНрд░рддрд┐рдмрдВрдзреАрддтАЭ рдмрдЯрдг, чжБ
ЁЯЙС => ЁЯЙС, тАЬрд╕реНрд╡рд┐рдХрд╛рд░ рдпреЛрдЧреНрдптАЭ, рдЖрдпрдбрд┐рдУрдЧреНрд░рд╛рдл, рдЬрдкрд╛рдиреА, рдЬрдкрд╛рдиреА тАЬрд╕реНрд╡рд┐рдХрд╛рд░ рдХрд░рдкрд╛рдпреЛрдЧреНрдптАЭ рдмрдЯрдг, рдЬрдкрд╛рдиреА тАЬрд╕реНрд╡рд┐рдХрд╛рд░ рдпреЛрдЧреНрдптАЭ рдмрдЯрдг, хПп
ЁЯИ╕ => ЁЯИ╕, тАЬрдЕрд░реНрдЬтАЭ, рдЖрдпрдбрд┐рдУрдЧреНрд░рд╛рдл, рдЬрдкрд╛рдиреА, рдЬрдкрд╛рдиреА тАЬрдЕрд░реНрдЬтАЭ рдмрдЯрдг, чФ│
ЁЯИ┤ => ЁЯИ┤, тАЬрдкрд╛рд╕реАрдВрдЧ рдЧреНрд░реЗрдбтАЭ, рдЖрдпрдбрд┐рдпреЛрдЧреНрд░рд╛рдл, рдЬрдкрд╛рдиреА, рдЬрдкрд╛рдиреА тАЬрдкрд╛рд╕реАрдВрдЧ рдЧреНрд░реЗрдбтАЭ рдмрдЯрдг, хРИ
ЁЯИ│ => ЁЯИ│, тАЬрд░рд┐рдХреНрдд рд╕реБрд╡рд╛рддтАЭ, рдЖрдпрдбрд┐рдУрдЧреНрд░рд╛рдл, рдЬрдкрд╛рдиреА, рдЬрдкрд╛рдиреА тАЬрд░рд┐рдХреНрдд рд╕реБрд╡рд╛рддтАЭ рдмрдЯрдг, рдЬрдкрд╛рдиреА тАЬрд╕реБрд╡рд╛рддтАЭ рдмрдЯрдг, чй║
уКЧ => уКЧ, тАЬрдкрд░рдмреАрдВтАЭ, рдЖрдпрдбрд┐рдУрдЧреНрд░рд╛рдл, рдЬрдкрд╛рдиреА, рдЬрдкрд╛рдиреА тАЬрдЕрднрд┐рдирдВрджрдитАЭ рдмрдЯрдг, рдЬрдкрд╛рдиреА тАЬрдкрд░рдмреАрдВтАЭ рдмрдЯрдг, чеЭ
уКЩ => уКЩ, тАЬрдЧреБрдкреАрддтАЭ, рдЖрдпрдбрд┐рдУрдЧреНрд░рд╛рдл, рдЬрдкрд╛рдиреА, рдЬрдкрд╛рдиреА тАЬрдЧреБрдкреАрддтАЭ рдмрдЯрдг, чзШ
ЁЯИ║ => ЁЯИ║, тАЬрд╡реЗрд╡рд╕рд╛рдпрд╛рдХ рдЙрдХреНрддреЛтАЭ, рдЖрдпрдбрд┐рдУрдЧреНрд░рд╛рдл, рдЬрдкрд╛рдиреА, рдЬрдкрд╛рдиреА тАЬрд╡реЗрд╡рд╕рд╛рдпрд╛ рдЦрд╛рддреАрд░ рдЙрдХрддреЗрдВтАЭ рдмрдЯрдг, рдЬрдкрд╛рдиреА тАЬрд╡реЗрд╡рд╕рд╛рдпрд╛рдХ рдЙрдХреНрддреЛтАЭ рдмрдЯрдг, хЦ╢
ЁЯИ╡ => ЁЯИ╡, тАЬрд░рд┐рдХреНрдд рд╕реБрд╡рд╛рдд рдирд╛тАЭ, рдЖрдпрдбрд┐рдУрдЧреНрд░рд╛рдл, рдЬрдкрд╛рдиреА, рдЬрдкрд╛рдиреА тАЬрд░рд┐рдХреНрдд рд╕реБрд╡рд╛рдд рдирд╛тАЭ рдмрдЯрдг, рдЬрдкрд╛рдиреА тАЬрд╕реБрд╡рд╛рдд рдирд╛тАЭ рдмрдЯрдг, ц║А
ЁЯФ┤ => ЁЯФ┤, рдЬрд┐рдпреЛрдореЕрдЯреНрд░реАрдХ, рддрд╛рдВрдмрдбреЗрдВ, рд╡рд░реНрддреБрд│
ЁЯЯа => ЁЯЯа, рдирд╛рд░рдВрдЧреА, рд▓рд╛рд░рд╛рдВрдЬреА рд╡рд░реНрддреБрд│, рд╡рд░реНрддреБрд│
ЁЯЯб => ЁЯЯб, рд╡рд░реНрддреБрд│, рд╣рд│рджреБрд╡реЗрдВ
ЁЯЯв => ЁЯЯв, рдкрд╛рдЪрд╡реЗрдВ, рд╡рд░реНрддреБрд│
ЁЯФ╡ => ЁЯФ╡, рдЬрд┐рдпреЛрдореЕрдЯреНрд░рд┐рдХ, рдирд┐рд│реЗрдВ, рд╡рд░реНрддреБрд│
ЁЯЯг => ЁЯЯг, рдЬрд╛рдВрднрд│реЗрдВ, рд╡рд░реНрддреБрд│
ЁЯЯд => ЁЯЯд, рддрдкрдХрд┐рд░реА, рд╡рд░реНрддреБрд│
тЪл => тЪл, рдХрд╛рд│реЗрдВ рд╡рд░реНрддреБрд│, рдЬрд┐рдпреЛрдореЕрдЯреНрд░реАрдХ, рд╡рд░реНрддреБрд│
тЪк => тЪк, рдЬрд┐рдпреЛрдореЕрдЯреНрд░реАрдХ, рдзрд╡реЗрдВ рд╡рд░реНрддреБрд│, рд╡рд░реНрддреБрд│
ЁЯЯе => ЁЯЯе, рдЪрд╡рдХреЛрди, рддрд╛рдВрдмрдбреЛ
ЁЯЯз => ЁЯЯз, рдЪрд╡рдХреЛрди, рдирд╛рд░рдВрдЧреА
ЁЯЯи => ЁЯЯи, рдЪрд╡рдХреЛрди, рд╣рд│рджреБрд╡реЛ
ЁЯЯй => ЁЯЯй, рдЪрд╡рдХреЛрди, рдкрд╛рдЪрд╡реЛ
ЁЯЯж => ЁЯЯж, рдЪрд╡рдХреЛрди, рдирд┐рд│реЛ
ЁЯЯк => ЁЯЯк, рдЪрд╡рдХреЛрди, рдЬрд╛рдВрднрд│реЛ
ЁЯЯл => ЁЯЯл, рдЪрд╡рдХреЛрди, рддрдкрдХрд┐рд░реА
тмЫ => тмЫ, рдХрд╛рд│реЛ рд╡реНрд╣рдб рдЪрд╡рдХреЛрди, рдХреЛрд│реЛ рд╡реНрд╣рдб рдЪрд╡рдХреЛрди, рдЪрд╡рдХреЛрди, рдЬрд┐рдпреЛрдореЕрдЯреНрд░реАрдХ
тмЬ => тмЬ, рдЪрд╡рдХреЛрди, рдЬрд┐рдпреЛрдореЕрдЯреНрд░реАрдХ, рдзрд╡реЛ рд╡реНрд╣рдб рдЪрд╡рдХреЛрди
тЧ╝ => тЧ╝, рдХрд╛рд│реЛ рдордзреНрдпрдо рдЪрд╡рдХреЛрди, рдЪрд╡рдХреЛрди, рдЬрд┐рдпреЛрдореЕрдЯреНрд░реАрдХ
тЧ╗ => тЧ╗, рдЪрд╡рдХреЛрди, рдЬрд┐рдпреЛрдореЕрдЯреНрд░реАрдХ, рдзрд╡реЛ рдордзреНрдпрдо рдЪрд╡рдХреЛрди
тЧ╛ => тЧ╛, рдХрд╛рд│реЛ рдордзреНрдпрдо-рд▓реНрд╣рд╛рди рдЪрд╡рдХреЛрди, рдЪрд╡рдХреЛрди, рдЬрд┐рдпреЛрдореЕрдЯреНрд░реАрдХ
тЧ╜ => тЧ╜, рдЪрд╡рдХреЛрди, рдЬрд┐рдпреЛрдореЕрдЯреНрд░реАрдХ, рдзрд╡реЛ рдордзреНрдпрдо-рд▓реНрд╣рд╛рди рдЪрд╡рдХреЛрди
тЦк => тЦк, рдХрд╛рд│реЛ рд▓реНрд╣рд╛рди рдЪрд╡рдХреЛрди, рдЪрд╡рдХреЛрди, рдЬрд┐рдпреЛрдореЕрдЯреНрд░реАрдХ
тЦл => тЦл, рдЪрд╡рдХреЛрди, рдЬрд┐рдпреЛрдореЕрдЯреНрд░реАрдХ, рдзрд╡реЛ рд▓реНрд╣рд╛рди рдЪрд╡рдХреЛрди
ЁЯФ╢ => ЁЯФ╢, рдЬрд┐рдпреЛрдореЕрдЯреНрд░реАрдХ, рдирд╛рд░рдВрдЧреА, рд╡реНрд╣рдб рдирд╛рд░рдВрдЧреА рд╣рд┐рд░реЛ, рд╣рд┐рд░реЛ
ЁЯФ╖ => ЁЯФ╖, рдЬрд┐рдпреЛрдореЕрдЯреНрд░реАрдХ, рдирд┐рд│реЛ, рд╡реНрд╣рдб рдирд┐рд│реЛ рд╣рд┐рд░реЛ, рд╣рд┐рд░реЛ
ЁЯФ╕ => ЁЯФ╕, рдЬрд┐рдпреЛрдореЕрдЯреНрд░реАрдХ, рдирд╛рд░рдВрдЧреА, рд▓реНрд╣рд╛рди рдирд╛рд░рдВрдЧреА рд╣рд┐рд░реЛ, рд╣рд┐рд░реЛ
ЁЯФ╣ => ЁЯФ╣, рдЬрд┐рдпреЛрдореЕрдЯреНрд░реАрдХ, рдирд┐рд│реЛ, рд▓реНрд╣рд╛рди рдирд┐рд│реЛ рд╣рд┐рд░реЛ, рд╣рд┐рд░реЛ
ЁЯФ║ => ЁЯФ║, рдЬрд┐рдпреЛрдореЕрдЯреНрд░реАрдХ, рддрд╛рдВрдмрдбреЗрдВ, рддрд╛рдВрдмрдбреЛ рддреНрд░рд┐рдХреЛрдг рд╡рдпрд░ рдкрд│рдпрддрд╛
ЁЯФ╗ => ЁЯФ╗, рдЬрд┐рдпреЛрдореЕрдЯреНрд░реАрдХ, рддрд╛рдВрдмрдбреЛ, рддрд╛рдВрдмрдбреЛ рддреНрд░рд┐рдХреЛрдг рд╕рдХрдпрд▓ рдкрд│рдпрддрд╛, рд╕рдХрдпрд▓
ЁЯТа => ЁЯТа, рдЬрд┐рдпреЛрдореЕрдЯреНрд░реАрдХ, рдмрд┐рдВрджреВ рд╕рдпрдд рд╣рд┐рд░реЛ, рднрд┐рддрд░, рд╡рд┐рдиреЛрджреА, рд╣рд┐рд░реЛ
ЁЯФШ => ЁЯФШ, рдЬрд┐рдпреЛрдореЕрдЯреНрд░реАрдХ, рдмрдЯрдг, рд░реЗрдбрд┐рдпреЛ
ЁЯФ│ => ЁЯФ│, рдЪрд╡рдХреЛрди, рдЬрд┐рдпреЛрдореЕрдЯреНрд░реАрдХ, рдзрд╡реЛ рдЪрд╡рдХреЛрди рдмрдЯрдг, рдмрдЯрдг, рд░реБрдкрд░реЗрдЦрд╛
ЁЯФ▓ => ЁЯФ▓, рдХрд╛рд│реЛ рдЪрд╡рдХреЛрди рдмрдЯрдг, рдЪрд╡рдХреЛрди, рдЬрд┐рдпреЛрдореЕрдЯреНрд░реАрдХ, рдмрдЯрдг
ЁЯПБ => ЁЯПБ, рдЪреМрдХрдЯреАрдЪреЛ, рдЪреМрдХрдЯреАрдВрдЪреЛ, рдЪреМрдХрдЯреАрдВрдЪреЛ рдлреНрд▓реЕрдЧ, рдЪреМрдХрдЯреАрдВрдЪреЛ рдмрд╛рд╡рдЯреЛ, рд╕реНрдкрд░реНрдзрд╛
ЁЯЪй => ЁЯЪй, рддреНрд░рд┐рдХреЛрдгреА рдмрд╛рд╡рдЯреЛ, рдкреЛрд╕реНрдЯ
ЁЯОМ => ЁЯОМ, рдХреНрд░реЙрд╕, рдХреНрд░реЙрд╕ рдХреЗрд▓реНрд▓реЗрдВ, рдХреНрд░реЙрд╕ рдХреЗрд▓реНрд▓реЗ рдмрд╛рд╡рдЯреЗ, рдХреНрд░реЙрд╕ рдмрд╛рд╡рдЯреЛ, рдЬрдкрд╛рдиреА, рд╕реБрд╡рд╛рд│реЛ
ЁЯП┤ => ЁЯП┤, рдХрд╛рд│реЛ рдмрд╛рд╡рдЯреЛ, рд╣рд╛рд▓рдпрддрд╛
ЁЯП│ => ЁЯП│, рдзрд╡реЛ рдмрд╛рд╡рдЯреЛ, рд╣рд╛рд▓рдпрд▓реЛ
ЁЯП│тАНЁЯМИ => ЁЯП│тАНЁЯМИ, рдЗрдВрджреНрд░рдзреЛрдгреВ, рдЗрдВрджреНрд░рдзреЛрдгреВ рдмрд╛рд╡рдЯреЛ
ЁЯП│тАНтЪз => ЁЯП│тАНтЪз, рддреГрддрд┐рдпрдкрдВрдереА, рдирд┐рд│реЛ, рдЧреБрд▓рд╛рдмреА рдЖрдиреА рдзрд╡реЛ рдмрд╛рд╡рдЯреЛ, рдмрд╛рд╡рдЯреЛ
ЁЯП┤тАНтШа => ЁЯП┤тАНтШа, рдЪрд╛рдЪреНрдпреЗ рдмрд╛рд╡рдЯреЛ, рдЪреНрдпрд╛рдЪреЗ, рдЪреНрдпрд╛рдЪреНрдпрд╛рдВрдЪреЛ рдмрд╛рд╡рдЯреЛ, рдЬреЙрд▓реА рд░реЛрдЬрд░, рддрд┐рдЬреЛрд░реА, рдкреНрд▓рдВрдбрд░
┬г => ┬г, рдЪрд▓рдиред EGPред GBPред рдкрд╛рд╡рдВрдб, рдкрд╛рд╡рдВрдб
┬е => ┬е, CNY, JPY, рдЪрд▓рди, рдпреБрдЖрди, рдпреЕрди
тВм => тВм, рдЪрд▓рдиред рдпреБрд░реЛред рдпреБрд░реЛ, рдпреБрд░реЛ
тВ╣ => тВ╣, рдЪрд▓рдиред рднрд╛рд░рддреАрдп рд░реБрдкрдпрд╛ред рд░реБрдкрдпрд╛, рднрд╛рд░рддреАрдп рд░реБрдкрдпрд╛
тВ╜ => тВ╜, рдЪрд▓рдиред рд░реБрдмрд▓ (рд░рд╢рд┐рдпреЗрдЪреЗ рдирд╛рдгреЗ), рд░реБрдмрд▓ (рд░рд╢рд┐рдпреЗрдЪреЗ рдирд╛рдгреЗ)
┬╣ => ┬╣, рдПрдХ ред рд╕реБрдкрд░рд╕реНрдХреНрд░рд┐рдкреНрдЯ, рд╕реБрдкрд░рд╕реНрдХреНрд░рд┐рдкреНрдЯ рдПрдХ
┬▓ => ┬▓, рд╕рдордХреЛрдиреАред рд╕реБрдкрд░рд╕реНрдХреНрд░рд┐рдкреНрдЯред рджреЛрди, рд╕реБрдкрд░рд╕реНрдХреНрд░рд┐рдкреНрдЯ рджреЛрди
┬│ => ┬│, рдШрдирд╛рдХрд╛рд░ред рд╕реБрдкрд░рд╕реНрдХреНрд░рд┐рдкреНрдЯред рддреАрди, рд╕реБрдкрд░рд╕реНрдХреНрд░рд┐рдкреНрдЯ рддреАрди
┬╡ => ┬╡, рдорд╛рдпрдХреНрд░реЛ рдЦреВрдг, рдореЗрдЬрдгреАред рдорд╛рдпрдХреНрд░реЛ рдЦреВрдг
