ЁЯП╗ => ЁЯП╗, ржЗржорзЛржЬрж┐ ржкрж░рж┐ржмрж░рзНрждржиржХрж╛рж░рзА, ржЯрзЛржи, рждрзНржмржХ, рждрзНржмржХрзЗрж░ ржзрж░ржи 1тАУ2, ржлрж┐ржЯржЬржкрзНржпрж╛ржЯрзНрж░рж┐ржХ
ЁЯП╝ => ЁЯП╝, ржЗржорзЛржЬрж┐ ржкрж░рж┐ржмрж░рзНрждржиржХрж╛рж░рзА, ржЯрзЛржи, рждрзНржмржХ, рждрзНржмржХрзЗрж░ ржзрж░-3, ржлрж┐ржЯржЬржкрзНржпрж╛ржЯрзНрж░рж┐ржХ
ЁЯП╜ => ЁЯП╜, ржЗржорзЛржЬрж┐ ржкрж░рж┐ржмрж░рзНрждржиржХрж╛рж░рзА, ржЯрзЛржи, рждрзНржмржХ, рждрзНржмржХрзЗрж░ ржзрж░ржи-4, ржлрж┐ржЯржЬржкрзНржпрж╛ржЯрзНрж░рж┐ржХ
ЁЯП╛ => ЁЯП╛, ржЗржорзЛржЬрж┐ ржкрж░рж┐ржмрж░рзНрждржиржХрж╛рж░рзА, ржЯрзЛржи, рждрзНржмржХ, рждрзНржмржХрзЗрж░ ржзрж░ржи-5, ржлрж┐ржЯржЬржкрзНржпрж╛ржЯрзНрж░рж┐ржХ
ЁЯП┐ => ЁЯП┐, ржЗржорзЛржЬрж┐ ржкрж░рж┐ржмрж░рзНрждржиржХрж╛рж░рзА, ржЯрзЛржи, рждрзНржмржХ, рждрзНржмржХрзЗрж░ ржзрж░ржи-6, ржлрж┐ржЯржЬржкрзНржпрж╛ржЯрзНрж░рж┐ржХ
ЁЯША => ЁЯША, ржжрзЗржБрждрзЛ рж╣рж╛рж╕рж┐, ржорзБржЦ, ржорзБржЦрзЗ ржжрзЗржБрждрзЛ рж╣рж╛рж╕рж┐
ЁЯШБ => ЁЯШБ, ржЪрзЛржЦ, ржЪрзЛржЦрзЗ рж╣рж╛рж╕рж┐рж░ рж╕рж╛ржерзЗ ржорзБржЦрзЗ ржжрзЗржБрждрзЛ рж╣рж╛рж╕рж┐, ржжрзЗржБрждрзЛ рж╣рж╛рж╕рж┐, ржорзБржЦ, рж╣рж╛рж╕рж┐
ЁЯШВ => ЁЯШВ, ржЖржиржирзНржж, ржЖржиржирзНржжрзЗрж░ ржХрж╛ржирзНржирж╛ ржнрж░рж╛ ржорзБржЦ, ржХрж╛ржирзНржирж╛, ржЬрзЛрж░рзЗ рж╣рж╛рж╕рж╛, ржорзБржЦ
ЁЯдг => ЁЯдг, ржЧржбрж╝рж╛ржЧржбрж╝рж┐, ржорж╛ржЯрж┐, ржорзБржЦ, рж╣рж╛рж╕рж┐, рж╣рзЗрж╕рзЗ ржорж╛ржЯрж┐рждрзЗ рж▓рзБржЯрзЛржкрзБржЯрж┐ ржЦрж╛ржУржпрж╝рж╛
ЁЯШГ => ЁЯШГ, ржЦрзЛрж▓рж╛, ржарзЛржБржЯ, ржмржбрж╝ ржмржбрж╝ ржЪрзЛржЦ ржХрж░рзЗ рж╣рж╛рж╕рж┐ ржорзБржЦ, ржорзБржЦ, рж╣рж╛рж╕рж┐
ЁЯШД => ЁЯШД, ржЦрзЛрж▓рж╛, ржЦрзЛрж▓рж╛ ржорзБржЦрзЗ ржЪрзЛржЦрзЗ рж╣рж╛рж╕рж┐рж░ рж╕рж╛ржерзЗ ржорзБржЦрзЗ рж╣рж╛рж╕рж┐, ржЪрзЛржЦ, ржарзЛржБржЯ, ржорзБржЦ, рж╣рж╛рж╕рж┐
ЁЯШЕ => ЁЯШЕ, ржЦрзЛрж▓рж╛, ржШрж░рзНржорж╛ржХрзНржд ржЕржмрж╕рзНржерж╛, ржарж╛ржирзНржбрж╛, ржорзБржЦ, ржорзБржЦ ржЦрзЛрж▓рж╛ ржПржмржВ ржарж╛ржгрзНржбрж╛ ржШрж╛ржорзЗрж░ рж╕рж╛ржерзЗ ржорзБржЦрзЗ рж╣рж╛рж╕рж┐, рж╣рж╛рж╕рж┐
ЁЯШЖ => ЁЯШЖ, ржЦрзЛрж▓рж╛, ржЬрзЛрж░рзЗ рж╣рж╛рж╕рж╛, ржарзЛржБржЯ, ржорзБржЦ, ржорзБржЦрзЗ рж╣рж╛рж╕рж┐рж░ рж╕рж╛ржерзЗ ржорзБржЦ ржЦрзЛрж▓рж╛ ржПржмржВ ржПржБржЯрзЗ ржЪрзЛржЦ ржмржирзНржз ржХрж░рж╛, рж╕ржирзНрждрзБрж╖рзНржЯ, рж╣рж╛рж╕рж┐
ЁЯШЙ => ЁЯШЙ, ржЪрзЛржЦ ржорж╛рж░рж╛, ржорзБржЦ
ЁЯШК => ЁЯШК, ржЧрж╛рж▓рзЗ рж▓ржЬрзНржЬрж╛рж░ ржЧрзЛрж▓рж╛ржкрзА ржЖржнрж╛, ржЪрзЛржЦ, ржЪрзЛржЦрзЗ рж╣рж╛рж╕рж┐рж░ рж╕рж╛ржерзЗ ржорзБржЦрзЗ рж╣рж╛рж╕рж┐, ржорзБржЦ, рж╣рж╛рж╕рж┐
ЁЯШЛ => ЁЯШЛ, ржЗржпрж╝рж╛ржо ржХрж░рзЗ ржЖржУржпрж╝рж╛ржЬ ржХрж░рж╛, ржЙржо ржХрж░рзЗ ржЖржУржпрж╝рж╛ржЬ ржХрж░рж╛, ржШрзНрж░рж╛ржг ржирзЗржУржпрж╝рж╛, ржорзБржЦ, рж╕рзБрж╕рзНржмрж╛ржжрзБ, рж╕рзБрж╕рзНржмрж╛ржжрзБ ржЦрж╛ржжрзНржпрзЗрж░ рж╕рзНржмрж╛ржж ржирзЗржУржпрж╝рж╛рж░ ржоржд ржорзБржЦ, рж╣рж╛рж╕рж┐
ЁЯШО => ЁЯШО, ржЖржмрж╣рж╛ржУржпрж╝рж╛, ржЙржЬрзНржЬрзНржмрж▓, ржЪрж╢ржорж╛, ржЪрзЛржЦ, ржорзБржЦ, рж╢рзАрждрж▓, рж╕рж╛ржиржЧрзНрж▓рж╛рж╕, рж╕рж╛ржиржЧрзНрж▓рж╛рж╕ ржкрж░рж┐рж╣рж┐ржд рж╣рж╛рж╕рж┐ ржорзБржЦ, рж╕рзВрж░рзНржп, рж╣рж╛рж╕рж┐
ЁЯШН => ЁЯШН, ржЪрзЛржЦ, ржнрж╛рж▓ржмрж╛рж╕рж╛, ржорзБржЦ, рж╣рж╛рж░рзНржЯ, рж╣рж╛рж░рзНржЯрзЗрж░-ржЖржХрж╛рж░рзЗрж░ ржЪрзЛржЦрзЗрж░ рж╕рж╛ржерзЗ рж╣рж╛рж╕рж┐ ржорзБржЦ, рж╣рж╛рж╕рж┐
ЁЯШШ => ЁЯШШ, ржЪрзБржорзНржмржи, ржорзБржЦ, ржорзБржЦ ржжрж┐ржпрж╝рзЗ ржЪрзБржорзНржмржи ржЫрзЛржБржбрж╝рж╛
ЁЯШЧ => ЁЯШЧ, ржЪрзБржорзНржмржи, ржЪрзБржорзНржмржирж░ржд ржорзБржЦ, ржорзБржЦ
ЁЯШЩ => ЁЯШЩ, ржЪрзБржорзНржмржи, ржЪрзБржорзНржмржирж░ржд ржорзБржЦрзЗрж░ рж╕рж╛ржерзЗ ржЪрзЛржЦрзЗ рж╣рж╛рж╕рж┐, ржЪрзЛржЦ, ржорзБржЦ, рж╣рж╛рж╕рж┐
ЁЯШЪ => ЁЯШЪ, ржЪрзБржорзНржмржи, ржЪрзЛржЦ, ржЪрзЛржЦ ржмржирзНржз ржерж╛ржХрж╛ ржЕржмрж╕рзНржерж╛ржпрж╝ ржЪрзБржорзНржмржирж░ржд ржорзБржЦ, ржмржирзНржз, ржорзБржЦ
тШ║ => тШ║, ржирж┐рж╢рзНржЪрж┐ржирзНржд, ржорзБржЦ, рж░рзВржкрж░рзЗржЦрж╛, рж╣рж╛рж╕рж┐, рж╣рж╛рж╕рж┐ ржорзБржЦ
ЁЯЩВ => ЁЯЩВ, ржорзБржЦ, ржорзБржЦрзЗ рж╕рж╛ржорж╛ржирзНржп рж╣рж╛рж╕рж┐, рж╣рж╛рж╕рж┐
ЁЯдЧ => ЁЯдЧ, ржЖрж▓рж┐ржЩрзНржЧржи, ржЖрж▓рж┐ржЩрзНржЧржи рж░ржд, ржЖрж▓рж┐ржЩрзНржЧржирж░ржд ржорзБржЦ, ржорзБржЦ
ЁЯдй => ЁЯдй, ржЪрзЛржЦ, рждрж╛рж░ржХрж╛-ржкрзНрж░ржгржпрж╝рж╛ржнрж┐рж▓рж╛рж╕рзА, рждрж╛рж░рж╛, ржорзБржЦ, рж╣рж╛рж╕рзНржпрж░ржд
ЁЯдФ => ЁЯдФ, ржЪрж┐ржирзНрждрж╛ ржХрж░рж╛рж░ ржоржд ржорзБржЦ, ржЪрж┐ржирзНрждрж┐ржд, ржорзБржЦ
ЁЯди => ЁЯди, ржЕржмрж┐рж╢рзНржмрж╛рж╕, ржнрзНрж░рзБ ржХрзЛржЪржХрж╛ржирзЛ ржорзБржЦ, рж╕ржирзНржжрзЗрж╣ржнрж╛ржЬржи
ЁЯШР => ЁЯШР, ржирж┐рж░ржкрзЗржХрзНрж╖, ржирж┐рж░ржкрзЗржХрзНрж╖ ржорзБржЦ, ржнрж╛ржмрж▓рзЗрж╢рж╣рзАржи, ржорзБржЦ
ЁЯШС => ЁЯШС, ржЕрж░рзНржерж╢рзВржирзНржп, ржЕрж░рзНржерж╣рзАржи, ржнрж╛ржмрж▓рзЗрж╢рж╣рзАржи, ржнрж╛ржмрж▓рзЗрж╢рж╣рзАржи ржорзБржЦ, ржорзБржЦ
ЁЯШ╢ => ЁЯШ╢, ржарзЛржБржЯ, ржирзАрж░ржм, ржорзБржЦ, ржорзБржЦ ржЫрж╛ржбрж╝рж╛ржЗ ржорзБржЦржоржгрзНржбрж▓, рж╢рж╛ржирзНржд
ЁЯЩД => ЁЯЩД, ржШрзВрж░рзНржгрж╛ржпрж╝ржорж╛ржи, ржЪрзЛржЦ, ржЪрзЛржЦ ржЧрзЛрж▓ ржЧрзЛрж▓ ржХрж░рж╛ ржорзБржЦ, ржорзБржЦ
ЁЯШП => ЁЯШП, ржХрзГрждрзНрж░рж┐ржо рж╣рж╛рж╕рж┐рж░ ржорзБржЦ, ржмрзНржпржЩрзНржЧ ржХрж░рзЗ рж╣рж╛рж╕рж╛, ржорзБржЦ
ЁЯШг => ЁЯШг, ржЬрж┐ржж ржХрж░рж╛, ржЬрзЗржжрж┐ ржорзБржЦ, ржорзБржЦ
ЁЯШе => ЁЯШе, ржЖрж╢рзНржЪрж░рзНржп рж╣ржУржпрж╝рж╛, ржорзБржЦ, рж╕рзНржмрж╕рзНрждрж┐ ржкрж╛ржУржпрж╝рж╛, рж╣рждрж╛рж╢, рж╣рждрж╛рж╢ рждржмрзЗ рж╕рзНржмрж╕рзНрждрж┐ ржкрж╛ржУржпрж╝рж╛ ржорзБржЦ
ЁЯШо => ЁЯШо, ржЦрзЛрж▓рж╛, ржарзЛржБржЯ, ржорзБржЦ, рж╕рж╣рж╛ржирзБржнрзВрждрж┐, рж╣рж╛ржБ ржХрж░рж╛ ржорзБржЦ
ЁЯдР => ЁЯдР, ржарзЛржБржЯ, ржорзБржЦ, ржорзБржЦрзЗ ржХрзБрж▓рзБржк ржЖржБржЯрж╛
ЁЯШп => ЁЯШп, ржЪрзБржк ржХрж░рж╛рж░ ржЗржЩрзНржЧрж┐ржд ржХрж░рж╛, ржирж┐рж╕рзНрждржмрзНржз ржорзБржЦ, ржмрж┐рж╕рзНржорж┐ржд рж╣ржУржпрж╝рж╛, ржорзБржЦ, рж╣рждржнржорзНржм рж╣ржУржпрж╝рж╛
ЁЯШк => ЁЯШк, ржШрзБржо ржШрзБржо ржнрж╛ржм, ржШрзБржоржирзНржд ржЕржмрж╕рзНржерж╛, ржорзБржЦ
ЁЯШл => ЁЯШл, ржХрзНрж▓рж╛ржирзНржд, ржХрзНрж▓рж╛ржирзНржд ржорзБржЦ, ржорзБржЦ
ЁЯШ┤ => ЁЯШ┤, ржШрзБржоржирзНржд ржЕржмрж╕рзНржерж╛, ржШрзБржоржирзНржд ржорзБржЦ, ржирж╛ржХ ржбрж╛ржХрж╛, ржорзБржЦ
ЁЯШМ => ЁЯШМ, ржЪрж┐ржирзНрждрж╛ ржорзБржХрзНржд ржорзБржЦ, ржорзБржЦ, рж╕рзНржмрж╕рзНрждрж┐ ржкрж╛ржУржпрж╝рж╛
ЁЯШЫ => ЁЯШЫ, ржЬрж┐ржн ржмрж╛рж░ ржХрж░рж╛ ржорзБржЦ, ржЬрж┐ржн ржнрзЗржЩрж╛ржирзЛ, ржорзБржЦ
ЁЯШЬ => ЁЯШЬ, ржЪрзЛржЦ, ржЪрзЛржЦ ржорж╛рж░рж╛, ржЬрж┐ржн ржмрж╛рж░ ржХрж░рж╛, ржЬрж┐ржн ржмрж╛рж░ ржХрж░рзЗ ржХрж╛ржЯрж╛ ржУ ржЪрзЛржЦ ржорж╛рж░рж╛ ржорзБржЦ, ржоржЬрж╛ ржХрж░рж╛, ржорзБржЦ
ЁЯШЭ => ЁЯШЭ, ржЪрзЛржЦ, ржЬрж┐ржн ржмрж╛рж░ ржХрж░рж╛, ржЬрж┐ржн ржмрж╛рж░ ржХрж░рзЗ ржХрж╛ржЯрж╛ ржУ ржжрзГржврж╝ржнрж╛ржмрзЗ ржЪрзЛржЦ ржмржирзНржз ржХрж░рж╛ ржорзБржЦ, ржнржпрж╝ржЩрзНржХрж░, ржорзБржЦ, рж╕рзНржмрж╛ржж
ЁЯдд => ЁЯдд, ржорзБржЦ, рж▓рзЛржнрзА, рж▓рзЛржнрзА ржорзБржЦ
ЁЯШТ => ЁЯШТ, ржЕрж╕рзБржЦрзА, ржмрж┐рж░ржХрзНржд, ржмрж┐рж░ржХрзНржд ржорзБржЦ, ржорзБржЦ
ЁЯШУ => ЁЯШУ, ржШрж░рзНржорж╛ржХрзНржд ржЕржмрж╕рзНржерж╛, ржарж╛ржирзНржбрж╛, ржорзБржЦ, ржорзБржЦрзЗрж░ ржоржзрзНржпрзЗ ржарж╛ржгрзНржбрж╛ ржШрж╛ржо рж▓рж╛ржЧрж╛
ЁЯШФ => ЁЯШФ, ржмрж┐рж╖ржгрзНржг, ржмрж┐рж╖ржгрзНржг ржорзБржЦ, ржоржиржорж░рж╛, ржорзБржЦ
ЁЯШХ => ЁЯШХ, ржмрж┐ржнрзНрж░рж╛ржирзНржд, ржмрж┐ржнрзНрж░рж╛ржирзНржд ржорзБржЦ, ржорзБржЦ
ЁЯЩГ => ЁЯЩГ, ржУрж▓рзНржЯрж╛ржирзЛ ржЪрзЗрж╣рж╛рж░рж╛, ржорж╛ржерж╛ржЯрж╛ ржирж┐ржЪрзЗ рждрж▓рж╛ржЯрж╛ ржЙржкрж░рзЗ ржПржоржи ржорзБржЦ, ржорзБржЦ
ЁЯдС => ЁЯдС, ржЕрж░рзНржерзЗрж░ ржоржд ржорзБржЦ, ржЯрж╛ржХрж╛, ржарзЛржБржЯ, ржорзБржЦ
ЁЯШ▓ => ЁЯШ▓, ржЕржмрж╛ржХ рж╣ржпрж╝рзЗ ржпрж╛ржУржпрж╝рж╛ ржорзБржЦ, ржЖрж╢рзНржЪрж░рзНржп рж╣ржУржпрж╝рж╛, ржорж░рзНржорж╛рж╣ржд, ржорзБржЦ, рж╕ржорзНржкрзВрж░рзНржг
тШ╣ => тШ╣, ржнрзНрж░рзВ ржХрзБржЪржБржХрж╛ржирзЛ, ржорзБржЦ, рж░рж╛ржЧрж╛ржирзНржмрж┐ржд ржорзБржЦ
ЁЯЩБ => ЁЯЩБ, ржнрзНрж░рзВ ржХрзБржЪржБржХрж╛ржирзЛ, ржорзБржЦ, рж╕рж╛ржорж╛ржирзНржп рж░рж╛ржЧрж╛ржирзНржмрж┐ржд ржорзБржЦ
ЁЯШЦ => ЁЯШЦ, ржмрж┐рж╕рзНржорж┐ржд ржорзБржЦ, ржорзБржЦ, рж╣ржХржЪржХрж┐ржпрж╝рзЗ ржпрж╛ржУржпрж╝рж╛
ЁЯШЮ => ЁЯШЮ, ржорзБржЦ, рж╣рждрж╛рж╢, рж╣рждрж╛рж╢ ржорзБржЦ
ЁЯШЯ => ЁЯШЯ, ржЙржжрзНржмрж┐ржЧрзНржи, ржЪрж┐ржирзНрждрж┐ржд ржорзБржЦ, ржорзБржЦ
ЁЯШд => ЁЯШд, ржЬржпрж╝ржЬржпрж╝ржХрж╛рж░, ржирж╛ржХ ржерзЗржХрзЗ рж╕рзНржЯрж┐ржо ржмрзЗрж░рзЛржЪрзНржЫрзЗ ржПржоржи ржорзБржЦ, ржмрж┐ржЬржпрж╝рзА, ржорзБржЦ
ЁЯШв => ЁЯШв, ржХрж╛ржирзНржирж╛, ржХрж╛ржирзНржирж╛ржХрж╛ржЯрж┐ ржХрж░рж╛, ржХрзНрж░ржирзНржжржирж░ржд ржорзБржЦ, ржжрзБржГржЦрж┐ржд, ржорзБржЦ
ЁЯШн => ЁЯШн, ржЕрж╢рзНрж░рзБрж╕ржЬрж▓ ржорзБржЦ, ржХрж╛ржирзНржирж╛, ржХрж╛ржирзНржирж╛ржХрж╛ржЯрж┐ ржХрж░рж╛, ржЬрзЛрж░рзЗ ржХрзНрж░ржирзНржжржирж░ржд ржорзБржЦ, ржжрзБржГржЦрж┐ржд, ржорзБржЦ
ЁЯШж => ЁЯШж, ржЦрзЛрж▓рж╛, ржЦрзЛрж▓рж╛ ржорзБржЦрзЗрж░ рж╕рж╛ржерзЗ ржнрзНрж░рзБржХрзБржЯрж┐ ржорзБржЦржоржгрзНржбрж▓, ржарзЛржБржЯ, ржнрзНрж░рзВ ржХрзБржЪржБржХрж╛ржирзЛ, ржорзБржЦ
ЁЯШз => ЁЯШз, ржЙржжрзНржмрзЗржЧржкрзВрж░рзНржг ржорзБржЦ, ржмрзЗржжржирж╛рж░рзНржд, ржорзБржЦ
ЁЯШи => ЁЯШи, ржнржпрж╝, ржнржпрж╝рж╛рж░рзНржд ржорзБржЦ, ржнрзАржд, ржнрзАрждрж┐ржЬржиржХ, ржорзБржЦ
ЁЯШй => ЁЯШй, ржХрзНрж▓рж╛ржирзНржд рж╣ржУржпрж╝рж╛, ржкрж░рж┐рж╢рзНрж░рж╛ржирзНржд, ржкрж░рж┐рж╢рзНрж░рж╛ржирзНржд ржорзБржЦ, ржорзБржЦ
ЁЯдп => ЁЯдп, ржлрзЗржЯрзЗ ржкрж░рж╛ ржорж╛ржерж╛, ржорж░рзНржорж╛рж╣ржд ржорзБржЦ
ЁЯШм => ЁЯШм, ржжрж╛ржБржд ржмрж╛рж░ ржХрж░рж╛ ржорзБржЦ, ржнрзЗржВржЪрж╛ржирзЛ, ржорзБржЦ
ЁЯШ░ => ЁЯШ░, ржЖржХрж╕рзНржорж┐ржХрждрж╛, ржЦрзЛрж▓рж╛, ржЦрзЛрж▓рж╛ ржорзБржЦ ржПржмржВ ржарж╛ржгрзНржбрж╛ ржШрж╛ржорзЗрж░ рж╕рж╛ржерзЗ ржорзБржЦржоржгрзНржбрж▓, ржШрж░рзНржорж╛ржХрзНржд ржЕржмрж╕рзНржерж╛, ржарж╛ржирзНржбрж╛, ржарзЛржБржЯ, ржирзАрж▓, ржорзБржЦ
ЁЯШ▒ => ЁЯШ▒, ржЦрзЛрж▓рж╛ ржорзБржЦ, ржЪрж┐рзОржХрж╛рж░ ржХрж░рж╛, ржнржпрж╝, ржнржпрж╝рзЗ ржЪрж┐рзОржХрж╛рж░ ржХрж░рж╛ ржорзБржЦ, ржнрзАржд, ржнрзАрждрж┐ржЬржиржХ, ржорзБржЦ
ЁЯШ│ => ЁЯШ│, ржЪржоржХрж┐ржд, ржорзБржЦ, рж░ржХрзНрждрж┐ржо, рж░ржХрзНрждрж┐ржо ржорзБржЦ
ЁЯдк => ЁЯдк, ржЪрзЛржЦ, ржЫрзЛржЯ, ржкрж╛ржЧрж▓рзЗрж░ ржоржд ржорзБржЦ, ржмржбрж╝
ЁЯШ╡ => ЁЯШ╡, ржорзБржЦ, рж╣рждржмрзБржжрзНржзрж┐, рж╣рждржмрзБржжрзНржзрж┐ рж╣ржУржпрж╝рж╛ ржорзБржЦ
ЁЯШб => ЁЯШб, ржХрзНрж░рзБржжрзНржз, ржХрзНрж╖рж┐ржкрзНржд, ржЧрж░рзНржЬржи, ржмрж┐рж╕рзНржлрж╛рж░рж┐ржд ржЪрзЛржЦ, ржмрж┐рж╕рзНржлрзБрж░рж┐ржд ржорзБржЦ, ржорзБржЦ, рж▓рж╛рж▓
ЁЯШа => ЁЯШа, ржХрзНрж░рзБржжрзНржз, ржХрзНрж╖рж┐ржкрзНржд, ржорзБржЦ, рж░рж╛ржЧрзЗрж░ ржорзБржЦ
ЁЯдм => ЁЯдм, ржарзЛржЯрзЗ ржЪрж┐рж╣рзНржиржпрзБржХрзНржд ржорзБржЦ, ржжрж┐ржмрзНржпрж┐ ржЦрж╛ржУржпрж╝рж╛ ржорзБржЦ
ЁЯШ╖ => ЁЯШ╖, ржЕрж╕рзБрж╕рзНрже, ржУрж╖рзБржз, ржарж╛ржирзНржбрж╛, ржбрж╛ржХрзНрждрж╛рж░, ржорзБржЦ, ржорзБржЦрзЗрж░ ржоржзрзНржпрзЗ ржорзЗржбрж┐ржХрзНржпрж╛рж▓ ржорж╛рж╕рзНржХ, ржорзБржЦрзЛрж╢
ЁЯдТ => ЁЯдТ, ржЕрж╕рзБрж╕рзНрже, ржерж╛рж░рзНржорзЛржорж┐ржЯрж╛рж░, ржорзБржЦ, ржорзБржЦрзЗрж░ ржоржзрзНржпрзЗ ржерж╛рж░рзНржорзЛржорж┐ржЯрж╛рж░, рж░рзЛржЧржЧрзНрж░рж╕рзНржд
ЁЯдХ => ЁЯдХ, ржЖржШрж╛ржд, ржЪрзЛржЯ, ржмрзНржпрж╛ржирзНржбрзЗржЬ, ржорж╛ржерж╛ржпрж╝ ржмрзНржпрж╛ржирзНржбрзЗржЬ ржХрж░рж╛ ржорзБржЦ, ржорзБржЦ
ЁЯдв => ЁЯдв, ржЧрж╛ ржмржорж┐ ржХрж░рж╛ ржорзБржЦ, ржмржорж┐, ржмржорж┐ ржмржорж┐ ржнрж╛ржЧ, ржорзБржЦ
ЁЯдо => ЁЯдо, ржЕрж╕рзБрж╕рзНрже, ржмржоржирж░ржд ржорзБржЦ, ржмржорж┐ ржХрж░рж╛
ЁЯдз => ЁЯдз, ржнрж╛рж▓ ржерж╛ржХ, ржорзБржЦ, рж╣рж╛ржБржЪрж┐
ЁЯШЗ => ЁЯШЗ, ржХрж▓рзНржкржирж╛, ржЬрзНржпрзЛрждрж┐рж░рзНржмрж▓ржпрж╝, ржжрзЗржмржжрзВржд, ржирж┐рж░рзАрж╣, ржорж╛ржерж╛ржпрж╝ ржЪржХрзНрж░рзЗрж░ рж╕рж╛ржерзЗ ржорзБржЦрзЗ рж╣рж╛рж╕рж┐, ржорзБржЦ, рж░рзВржкржХржерж╛, рж╣рж╛рж╕рж┐
ЁЯда => ЁЯда, ржХрж╛ржЙржЧрж╛рж░рзНрж▓, ржХрж╛ржЙржмржпрж╝, ржХрж╛ржЙржмржпрж╝ ржЯрзБржкрж┐ ржкрж░рж╛ ржорзБржЦ, ржЯрзБржкрж┐, ржорзБржЦ
ЁЯдб => ЁЯдб, ржЬрзЛржХрж╛рж░, ржЬрзЛржХрж╛рж░рзЗрж░ ржорзБржЦ, ржорзБржЦ
ЁЯде => ЁЯде, ржкрж┐ржирж╛ржХрж┐ржУ, ржорж┐ржерзНржпрж╛, ржорж┐ржерзНржпрзБржХрзЗрж░ ржирж╛ржХ рж▓ржорзНржмрж╛, ржорзБржЦ
ЁЯдл => ЁЯдл, ржЪрзБржк ржХрж░рж╛, ржЪрзБржк ржХрж░рж╛ ржорзБржЦ, рж╢рж╛ржирзНржд
ЁЯдн => ЁЯдн, ржЙрж▓рзНрж▓рж╕рж┐ржд ржорзБржЦ, ржорзБржЦрзЗрж░ ржУржкрж░ рж╣рж╛ржд ржжрзЗржУржпрж╝рж╛ ржорзБржЦ
ЁЯзР => ЁЯзР, ржПржХржЪрзЛржЦрзЗ ржЪрж╢ржорж╛ ржУржпрж╝рж╛рж▓рж╛ ржорзБржЦ, ржжржоржмржирзНржз ржХрж░рж╛ ржорзБржЦ
ЁЯдУ => ЁЯдУ, ржЧрзБрж░рзБ, ржкржбрж╝рзБржпрж╝рж╛ ржорзБржЦ, ржмрзЛржХрж╛, ржорзБржЦ
ЁЯШИ => ЁЯШИ, ржХрж▓рзНржкржирж╛, ржорзБржЦ, рж░рзВржкржХржерж╛, рж╢рж┐ржВ, рж╢рж┐ржВ ржПрж░ рж╕рж╛ржерзЗ рж╣рж╛рж╕рж┐ ржорзБржЦ, рж╣рж╛рж╕рж┐
ЁЯС┐ => ЁЯС┐, ржХрж▓рзНржкржирж╛, ржжрзИрждрзНржп, ржорзБржЦ, рж░рзВржкржХржерж╛, рж╢ржпрж╝рждрж╛ржи
ЁЯС╣ => ЁЯС╣, ржХрж▓рзНржкржирж╛, ржЬрж╛ржкрж╛ржирж┐, ржжрж╛ржиржм, ржмрзБржирзЛ ржЬрзАржм, ржорзБржЦ, рж░рж╛ржХрзНрж╖рж╕, рж░рзВржкржХржерж╛
ЁЯС║ => ЁЯС║, ржЕржкржжрзЗржмрждрж╛, ржХрж▓рзНржкржирж╛, ржЬрж╛ржкрж╛ржирж┐, ржжрж╛ржиржм, ржмрзБржирзЛ ржЬрзАржм, ржорзБржЦ, рж░рзВржкржХржерж╛
ЁЯТА => ЁЯТА, ржЦрзБрж▓рж┐, ржжрж╛ржиржм, ржорзБржЦ, ржорзГрждрзНржпрзБ, рж░рзВржкржХржерж╛, рж╢рж░рзАрж░
тШа => тШа, ржЖржбрж╝рж╛ржЖржбрж╝рж┐ржнрж╛ржмрзЗ ржерж╛ржХрж╛ ржжрзБтАШржЯрж┐ рж╣рж╛ржбрж╝, ржЦрзБрж▓рж┐, ржжрж╛ржиржм, ржорж╛ржерж╛рж░ ржЦрзБрж▓рж┐ ржПржмржВ ржЖржбрж╝рж╛ржЖржбрж╝рж┐ржнрж╛ржмрзЗ ржерж╛ржХрж╛ ржжрзБтАШржЯрж┐ рж╣рж╛ржбрж╝, ржорзБржЦ, ржорзГрждрзНржпрзБ, рж╢рж░рзАрж░
ЁЯС╗ => ЁЯС╗, ржХрж▓рзНржкржирж╛, ржжрж╛ржиржм, ржмрзБржирзЛ ржЬрзАржм, ржнрзВржд, ржорзБржЦ, рж░рзВржкржХржерж╛
ЁЯС╜ => ЁЯС╜, ржЖржкрж╛рж░рзНржерж┐ржм ржЬрзАржм, ржЙржбрж╝ржирзНржд ржЪрж╛ржХрждрж┐, ржХрж▓рзНржкржирж╛, ржжрж╛ржиржм, ржмрзБржирзЛ ржЬрзАржм, ржнрзАржи ржЧрзНрж░рж╣рзЗрж░ ржкрзНрж░рж╛ржгрзА, ржорж╣рж╛ржХрж╛рж╢, ржорзБржЦ, рж░рзВржкржХржерж╛
ЁЯС╛ => ЁЯС╛, ржЖржкрж╛рж░рзНржерж┐ржм ржЬрзАржм, ржЙржбрж╝ржирзНржд ржЪрж╛ржХрждрж┐, ржПрж▓рж┐ржпрж╝рж╛ржи ржоржирж╕рзНржЯрж╛рж░, ржХрж▓рзНржкржирж╛, ржжрж╛ржиржм, ржмрзБржирзЛ ржЬрзАржм, ржнрзАржи ржЧрзНрж░рж╣рзЗрж░ ржкрзНрж░рж╛ржгрзА, ржорж╣рж╛ржХрж╛рж╢, ржорзБржЦ, рж░рзВржкржХржерж╛
ЁЯдЦ => ЁЯдЦ, ржжрж╛ржиржм, ржорзБржЦ, ржпржирзНрждрзНрж░ржорж╛ржиржм, рж░рзЛржмрзЛржЯрзЗрж░ ржорзБржЦ
ЁЯТй => ЁЯТй, ржЕржзрзИрж░рзНржпрзНржп ржкрзНрж░ржХрж╛рж╢ ржХрж░рж╛, ржЙрж▓рзНржЯрж╛ржи ржжрж┐ржХ, ржХржорж┐ржХ, ржЧрзЛржмрж░, ржжрж╛ржиржм, ржкрж╛ржЗрж▓ ржЕржл ржкрзЛ, ржорзБржЦ
ЁЯШ║ => ЁЯШ║, ржЦрзЛрж▓рж╛, ржарзЛржБржЯ, ржмрж┐ржбрж╝рж╛рж▓, ржорзБржЦ, ржорзБржЦ ржЦрзЛрж▓рж╛ ржЕржмрж╕рзНржерж╛ржпрж╝ ржмрзЗржбрж╝рж╛рж▓рзЗрж░ рж╣рж╛рж╕рж┐ ржорзБржЦ, рж╣рж╛рж╕рж┐
ЁЯШ╕ => ЁЯШ╕, ржЪрзЛржЦ, ржЪрзЛржЪрзЛржЦрзЗ рж╣рж╛рж╕рж┐рж░ рж╕рж╛ржерзЗ ржорзБржЦрзЗ рж╣рж╛рж╕рж┐, ржжрзЗржБрждрзЛ рж╣рж╛рж╕рж┐, ржмрж┐ржбрж╝рж╛рж▓, ржорзБржЦ, рж╣рж╛рж╕рж┐
ЁЯШ╣ => ЁЯШ╣, ржЖржиржирзНржж, ржЖржиржирзНржжрзЗрж░ ржХрж╛ржирзНржирж╛ рж╕рж╣ ржмрзЗржбрж╝рж╛рж▓рзЗрж░ ржорзБржЦ, ржХрж╛ржирзНржирж╛, ржмрж┐ржбрж╝рж╛рж▓, ржорзБржЦ
ЁЯШ╗ => ЁЯШ╗, ржЪрзЛржЦ, ржмрж┐ржбрж╝рж╛рж▓, ржнрж╛рж▓ржмрж╛рж╕рж╛, ржорзБржЦ, рж╣рж╛рж░рзНржЯ, рж╣рж╛рж░рзНржЯ ржЖржХрж╛рж░рзЗрж░ ржЪрзЛржЦрзЗрж░ рж╕рж╛ржерзЗ ржмрзЗржбрж╝рж╛рж▓рзЗрж░ ржорзБржЦ, рж╣рж╛рж╕рж┐
ЁЯШ╝ => ЁЯШ╝, ржмрж╛ржБржХрж╛ рж╣рж╛рж╕рж┐рж░ рж╕рж╛ржерзЗ ржмрзЗржбрж╝рж╛рж▓рзЗрж░ ржорзБржЦ, ржмрж┐ржХрзГржд, ржмрж┐ржбрж╝рж╛рж▓, ржорзБржЦ, рж╢рзНрж▓рзЗрж╖рж╛рждрзНржоржХ, рж╣рж╛рж╕рж┐
ЁЯШ╜ => ЁЯШ╜, ржЪрзБржорзНржмржи, ржЪрзЛржЦ, ржмржирзНржз ржЪрзЛржЦ рж╕рж╣ ржЪрзБржорзНржмржирж░ржд ржмрж┐ржбрж╝рж╛рж▓рзЗрж░ ржорзБржЦ, ржмрж┐ржбрж╝рж╛рж▓, ржорзБржЦ
ЁЯЩА => ЁЯЩА, ржХрзНрж▓рж╛ржирзНржд ржмрж┐ржбрж╝рж╛рж▓рзЗрж░ ржорзБржЦ, ржкрж░рж┐рж╢рзНрж░рж╛ржирзНржд, ржмрж┐ржбрж╝рж╛рж▓, ржмрж┐рж╕рзНржоржпрж╝рж╕рзВржЪржХ ржорзБржЦ ржЧрзЛрж▓ ржХрж░рзЗ ржУрж╣ржГ ржХрж░рж╛, ржмрж┐рж╕рзНржорж┐ржд рж╣ржУржпрж╝рж╛, ржорзБржЦ
ЁЯШ┐ => ЁЯШ┐, ржХрж╛ржирзНржирж╛, ржХрж╛ржирзНржирж╛ржХрж╛ржЯрж┐ ржХрж░рж╛, ржжрзБржГржЦрж┐ржд, ржмрж┐ржбрж╝рж╛рж▓, ржмрж┐ржбрж╝рж╛рж▓рзЗрж░ ржорзБржЦрзЗ ржХрж╛ржирзНржирж╛, ржорзБржЦ
ЁЯШ╛ => ЁЯШ╛, ржмрж┐ржбрж╝рж╛рж▓, ржмрж┐рж╕рзНржлрж╛рж░рж┐ржд ржЪрзЛржЦ, ржмрж┐рж╕рзНржлрзБрж░рж┐ржд ржмрж┐ржбрж╝рж╛рж▓рзЗрж░ ржорзБржЦ, ржорзБржЦ
ЁЯЩИ => ЁЯЩИ, ржЕржЩрзНржЧржнржЩрзНржЧрж┐, ржХрзЛржирзЛ ржЦрж╛рж░рж╛ржк ржЬрж┐ржирж┐рж╕ ржжрзЗржЦржм ржирж╛, ржжрзБрж╖рзНржЯ, ржжрзЗржЦрж╛, ржиржпрж╝, ржирж╛, ржирж┐рж╖рж┐ржжрзНржз, ржирж┐рж╖рж┐ржжрзНржз ржерж╛ржХрж╛, ржмрж╛ржирж░, ржорзБржЦ
ЁЯЩЙ => ЁЯЩЙ, ржЕржЩрзНржЧржнржЩрзНржЧрж┐, ржХрзЛржирзЛ ржЦрж╛рж░рж╛ржк ржХрж┐ржЫрзБ рж╢рзБржиржм ржирж╛, ржжрзБрж╖рзНржЯ, ржиржпрж╝, ржирж╛, ржирж┐рж╖рж┐ржжрзНржз, ржирж┐рж╖рж┐ржжрзНржз ржерж╛ржХрж╛, ржмрж╛ржирж░, ржорзБржЦ, рж╢рзЛржирж╛
ЁЯЩК => ЁЯЩК, ржЕржЩрзНржЧржнржЩрзНржЧрж┐, ржХржерж╛ ржмрж▓рж╛, ржХрзЛржирзЛ ржЦрж╛рж░рж╛ржк ржХржерж╛ ржмрж▓ржм ржирж╛, ржжрзБрж╖рзНржЯ, ржиржпрж╝, ржирж╛, ржирж┐рж╖рж┐ржжрзНржз, ржирж┐рж╖рж┐ржжрзНржз ржерж╛ржХрж╛, ржмрж╛ржирж░, ржорзБржЦ
ЁЯС╢ => ЁЯС╢, ржмрж╛ржЪрзНржЪрж╛, рж╢рж┐рж╢рзБ
ЁЯзТ => ЁЯзТ, ржмрж╛ржЪрзНржЪрж╛, ржпрзБржмржХ, рж▓рж┐ржЩрзНржЧ- ржирж┐рж░ржкрзЗржХрзНрж╖
ЁЯСж => ЁЯСж, ржЫрзЗрж▓рзЗ, ржпрзБржмржХ
ЁЯСз => ЁЯСз, ржХржирзНржпрж╛рж░рж╛рж╢рж┐, ржХрзБржорж╛рж░рзА, рждрж░рзБржгрзА, ржорзЗржпрж╝рзЗ, рж░рж╛рж╢рж┐ржЪржХрзНрж░
ЁЯзС => ЁЯзС, ржкрзНрж░рж╛ржкрзНрждржмржпрж╝рж╕рзНржХ, рж▓рж┐ржЩрзНржЧ-ржирж┐рж░ржкрзЗржХрзНрж╖
ЁЯСи => ЁЯСи, ржирж░, ржкрзБрж░рзБрж╖
ЁЯСй => ЁЯСй, ржирж╛рж░рзА, ржорж╣рж┐рж▓рж╛
ЁЯзУ => ЁЯзУ, ржмржбрж╝ ржкрзНрж░рж╛ржкрзНрждржмржпрж╝рж╕рзНржХ, ржмржпрж╝рж╕рзНржХ, рж▓рж┐ржЩрзНржЧ-ржирж┐рж░ржкрзЗржХрзНрж╖
ЁЯС┤ => ЁЯС┤, ржкрзБрж░рзБрж╖, ржмржпрж╝рж╕рзНржХ, ржмрзГржжрзНржз ржкрзБрж░рзБрж╖
ЁЯС╡ => ЁЯС╡, ржмржпрж╝рж╕рзНржХ ржирж╛рж░рзА, ржмрзГржжрзНржз ржорж╣рж┐рж▓рж╛
ЁЯСитАНтЪХ => ЁЯСитАНтЪХ, ржбрж╛ржХрзНрждрж╛рж░, ржерзЗрж░рж╛ржкрж┐рж╕рзНржЯ, ржирж╛рж░рзНрж╕, ржкрзБрж░рзБрж╖, ржкрзБрж░рзБрж╖ рж╕рзНржмрж╛рж╕рзНржерзНржп ржХрж░рзНржорзА, рж╕рзНржмрж╛рж╕рзНржерзНржп ржкрж░рж┐ржЪрж░рзНржпрж╛
ЁЯСйтАНтЪХ => ЁЯСйтАНтЪХ, ржбрж╛ржХрзНрждрж╛рж░, ржерзЗрж░рж╛ржкрж┐рж╕рзНржЯ, ржирж╛рж░рзНрж╕, ржорж╣рж┐рж▓рж╛, ржорж╣рж┐рж▓рж╛ рж╕рзНржмрж╛рж╕рзНржерзНржп ржХрж░рзНржорзА, рж╕рзНржмрж╛рж╕рзНржерзНржп ржкрж░рж┐ржЪрж░рзНржпрж╛
ЁЯСитАНЁЯОУ => ЁЯСитАНЁЯОУ, ржЫрж╛рждрзНрж░, ржкрзБрж░рзБрж╖, рж╕рзНржирж╛рждржХ
ЁЯСйтАНЁЯОУ => ЁЯСйтАНЁЯОУ, ржЫрж╛рждрзНрж░рзА, ржорж╣рж┐рж▓рж╛, рж╕рзНржирж╛рждржХ
ЁЯСитАНЁЯПл => ЁЯСитАНЁЯПл, ржЕржзрзНржпрж╛ржкржХ, ржЗржирж╕рзНржЯрзНрж░рж╛ржХржЯрж░, ржкрзБрж░рзБрж╖, рж╢рж┐ржХрзНрж╖ржХ
ЁЯСйтАНЁЯПл => ЁЯСйтАНЁЯПл, ржЕржзрзНржпрж╛ржкрж┐ржХрж╛, ржЗржирж╕рзНржЯрзНрж░рж╛ржХржЯрж░, ржорж╣рж┐рж▓рж╛, рж╢рж┐ржХрзНрж╖рж┐ржХрж╛
ЁЯСитАНтЪЦ => ЁЯСитАНтЪЦ, ржЫрзЗрж▓рзЗ, рждрзБрж▓рж╛ржжржгрзНржб, ржжрж╛ржБржбрж╝рж┐ржкрж╛рж▓рзНрж▓рж╛, ржкрзБрж░рзБрж╖, ржкрзБрж░рзБрж╖ ржмрж┐ржЪрж╛рж░ржХ, ржмрж┐ржЪрж╛рж░
ЁЯСйтАНтЪЦ => ЁЯСйтАНтЪЦ, рждрзБрж▓рж╛ржжржгрзНржб, ржжрж╛ржБржбрж╝рж┐ржкрж╛рж▓рзНрж▓рж╛, ржмрж┐ржЪрж╛рж░, ржорж╣рж┐рж▓рж╛, ржорж╣рж┐рж▓рж╛ ржмрж┐ржЪрж╛рж░ржХ, ржорзЗржпрж╝рзЗ
ЁЯСитАНЁЯМ╛ => ЁЯСитАНЁЯМ╛, ржХрзГрж╖ржХ, ржЪрж╛рж╖рзА, ржЫрзЗрж▓рзЗ, ржЫрзЗрж▓рзЗ,ржкрзБрж░рзБрж╖, ржЪрж╛рж╖рзА ,ржХрзГрж╖ржХ, ржкрзБрж░рзБрж╖, ржорж╛рж▓рж┐
ЁЯСйтАНЁЯМ╛ => ЁЯСйтАНЁЯМ╛, ржХрзГрж╖ржХ, ржЪрж╛рж╖рзА, ржорж╣рж┐рж▓рж╛, ржорж╛рж▓рж┐, ржорзЗржпрж╝рзЗ, ржорзЗржпрж╝рзЗ , ржорж╣рж┐рж▓рж╛ ,ржЪрж╛рж╖рзА , ржХрзГрж╖ржХ
ЁЯСитАНЁЯН│ => ЁЯСитАНЁЯН│, ржХрзБржХ, ржЫрзЗрж▓рзЗ, ржЫрзЗрж▓рзЗ ,ржкрзБрж░рзБрж╖ , ржХрзБржХ , ржкрж╛ржЪржХ , рж░рж╛ржБржзрзБржирж┐, ржкрж╛ржЪржХ, ржкрзБрж░рзБрж╖, рж░рж╛ржБржзрзБржирж┐
ЁЯСйтАНЁЯН│ => ЁЯСйтАНЁЯН│, ржХрзБржХ, ржкрж╛ржЪржХ, ржорж╣рж┐рж▓рж╛, ржорзЗржпрж╝рзЗ, ржорзЗржпрж╝рзЗ , ржорж╣рж┐рж▓рж╛ , ржХрзБржХ , ржкрж╛ржЪржХ , рж░рж╛ржБржзрзБржирж┐, рж░рж╛ржБржзрзБржирж┐
ЁЯСитАНЁЯФз => ЁЯСитАНЁЯФз, ржЗрж▓рзЗржХржЯрзНрж░рж┐рж╢рж┐ржпрж╝рж╛ржи, ржЫрзЗрж▓рзЗ, ржЫрзЗрж▓рзЗ , ржкрзБрж░рзБрж╖ , ржорзЗржХрж╛ржирж┐ржХ, ржЯрзНрж░рзЗржбржкрж╛рж░рзНрж╕ржи, ржкрзБрж░рзБрж╖, ржкрзНрж▓рж╛ржорзНржмрж╛рж░, ржорзЗржХрж╛ржирж┐ржХ
ЁЯСйтАНЁЯФз => ЁЯСйтАНЁЯФз, ржЗрж▓рзЗржХржЯрзНрж░рж┐рж╢рж┐ржпрж╝рж╛ржи, ржЯрзНрж░рзЗржбржкрж╛рж░рзНрж╕ржи, ржкрзНрж▓рж╛ржорзНржмрж╛рж░, ржорж╣рж┐рж▓рж╛, ржорзЗржХрж╛ржирж┐ржХ, ржорзЗржпрж╝рзЗ, ржорзЗржпрж╝рзЗ , ржорж╣рж┐рж▓рж╛ , ржорзЗржХрж╛ржирж┐ржХ
ЁЯСитАНЁЯПн => ЁЯСитАНЁЯПн, ржЕрзНржпрж╛рж╕рзЗржоржмрзНрж▓рж┐, ржЗржиржбрж╛рж╕ржЯрзНрж░рж┐, ржХрж░рзНржорзА, ржХрж╛рж░ржЦрж╛ржирж╛, ржЫрзЗрж▓рзЗ, ржЫрзЗрж▓рзЗ , ржкрзБрж░рзБрж╖ , ржорж┐рж▓рзЗрж░ ржХрж░рзНржорж┐, ржкрзБрж░рзБрж╖
ЁЯСйтАНЁЯПн => ЁЯСйтАНЁЯПн, ржЕрзНржпрж╛рж╕рзЗржоржмрзНрж▓рж┐, ржЗржиржбрж╛рж╕ржЯрзНрж░рж┐, ржХрж░рзНржорзА, ржХрж╛рж░ржЦрж╛ржирж╛, ржорж╣рж┐рж▓рж╛, ржорзЗржпрж╝рзЗ, ржорзЗржпрж╝рзЗ , ржорж╣рж┐рж▓рж╛ , ржорж┐рж▓рзЗрж░ ржХрж░рзНржорж┐
ЁЯСитАНЁЯТ╝ => ЁЯСитАНЁЯТ╝, ржЕржлрж┐рж╕, ржЖрж░рзНржХрж┐ржЯрзЗржХрзНржЯ, ржЫрзЗрж▓рзЗ, ржЫрзЗрж▓рзЗ , ржкрзБрж░рзБрж╖ , ржЕржлрж┐рж╕ ржХрж░рзНржорж┐, ржкрзБрж░рзБрж╖, ржмрзНржпржмрж╕рж╛, ржорзНржпрж╛ржирзЗржЬрж╛рж░, рж╣рзЛржпрж╝рж╛ржЗржЯ - ржХрж▓рж╛рж░
ЁЯСйтАНЁЯТ╝ => ЁЯСйтАНЁЯТ╝, ржЕржлрж┐рж╕, ржЖрж░рзНржХрж┐ржЯрзЗржХрзНржЯ, ржмрзНржпржмрж╕рж╛, ржорж╣рж┐рж▓рж╛, ржорзЗржпрж╝рзЗ , ржорж╣рж┐рж▓рж╛ , ржЕржлрж┐рж╕ ржХрж░рзНржорж┐, ржорзНржпрж╛ржирзЗржЬрж╛рж░, рж╣рзЛржпрж╝рж╛ржЗржЯ - ржХрж▓рж╛рж░
ЁЯСитАНЁЯФм => ЁЯСитАНЁЯФм, ржЗржЮрзНржЬрж┐ржирж┐ржпрж╝рж╛рж░, ржЧржгрж┐рждржЬрзНржЮ, ржЫрзЗрж▓рзЗ, ржЬрзАржмржмрж┐ржЬрзНржЮрж╛ржирзА, ржкрзБрж░рзБрж╖, ржкрзБрж░рзБрж╖ ржмрж┐ржЬрзНржЮрж╛ржирзА, ржкрзНрж░ржХрзГрждрж┐ржмрж┐ржЬрзНржЮрж╛ржирзА, ржмрж┐ржЬрзНржЮрж╛ржирзА, рж░рж╕рж╛ржпрж╝ржиржмрж┐ржж
ЁЯСйтАНЁЯФм => ЁЯСйтАНЁЯФм, ржЗржЮрзНржЬрж┐ржирж┐ржпрж╝рж╛рж░, ржЧржгрж┐рждржЬрзНржЮ, ржЫрзЗрж▓рзЗ, ржЬрзАржмржмрж┐ржЬрзНржЮрж╛ржирзА, ржкрзНрж░ржХрзГрждрж┐ржмрж┐ржЬрзНржЮрж╛ржирзА, ржмрж┐ржЬрзНржЮрж╛ржирзА, ржорж╣рж┐рж▓рж╛, ржорж╣рж┐рж▓рж╛ ржмрж┐ржЬрзНржЮрж╛ржирзА, рж░рж╕рж╛ржпрж╝ржиржмрж┐ржж
ЁЯСитАНЁЯТ╗ => ЁЯСитАНЁЯТ╗, ржЗржиржнрзЗржирзНржЯрж░, ржЙржжрзНржнрж╛ржмржХ, ржХрзЛржбрж╛рж░, ржЫрзЗрж▓рзЗ, ржЫрзЗрж▓рзЗ , ржкрзБрж░рзБрж╖ ржЯрзЗржХржирзЛрж▓ржЬрж┐рж╕рзНржЯ, ржЯрзЗржХржирзЛрж▓ржЬрж┐рж╕рзНржЯ, ржбрзЗржнрзЗрж▓ржкрж╛рж░, ржкрзБрж░рзБрж╖, рж╕ржлрзНржЯржУржпрж╝рзНржпрж╛рж░
ЁЯСйтАНЁЯТ╗ => ЁЯСйтАНЁЯТ╗, ржЗржиржнрзЗржирзНржЯрж░, ржЙржжрзНржнрж╛ржмржХ, ржХрзЛржбрж╛рж░, ржЯрзЗржХржирзЛрж▓ржЬрж┐рж╕рзНржЯ, ржбрзЗржнрзЗрж▓ржкрж╛рж░, ржорж╣рж┐рж▓рж╛, ржорзЗржпрж╝рзЗ, ржорзЗржпрж╝рзЗ , ржорж╣рж┐рж▓рж╛ ржЯрзЗржХржирзЛрж▓ржЬрж┐рж╕рзНржЯ, рж╕ржлрзНржЯржУржпрж╝рзНржпрж╛рж░
ЁЯСитАНЁЯОд => ЁЯСитАНЁЯОд, ржЕржнрж┐ржирзЗрждрж╛, ржПржирзНржЯрж╛ржЯрзЗржирж╛рж░, ржЧрж╛ржпрж╝ржХ, ржЫрзЗрж▓рзЗ, ржЫрзЗрж▓рзЗ , ржкрзБрж░рзБрж╖ ржЧрж╛ржпрж╝ржХ, ржкрзБрж░рзБрж╖, рж░ржХ, рж╕рзНржЯрж╛рж░
ЁЯСйтАНЁЯОд => ЁЯСйтАНЁЯОд, ржЕржнрж┐ржирзЗрждрж╛, ржПржирзНржЯрж╛ржЯрзЗржирж╛рж░, ржЧрж╛ржпрж╝ржХ, ржорж╣рж┐рж▓рж╛, ржорзЗржпрж╝рзЗ, ржорзЗржпрж╝рзЗ , ржорж╣рж┐рж▓рж╛ ржЧрж╛ржпрж╝ржХ, рж░ржХ, рж╕рзНржЯрж╛рж░
ЁЯСитАНЁЯОи => ЁЯСитАНЁЯОи, ржЫрзЗрж▓рзЗ, ржЫрзЗрж▓рзЗ , ржкрзБрж░рзБрж╖ рж╢рж┐рж▓рзНржкрзА, ржкрзБрж░рзБрж╖, ржкрзНржпрж╛рж▓рзЗржЯ, рж╢рж┐рж▓рзНржкрзА
ЁЯСйтАНЁЯОи => ЁЯСйтАНЁЯОи, ржкрзНржпрж╛рж▓рзЗржЯ, ржорж╣рж┐рж▓рж╛, ржорзЗржпрж╝рзЗ, ржорзЗржпрж╝рзЗ , ржорж╣рж┐рж▓рж╛ рж╢рж┐рж▓рзНржкрзА, рж╢рж┐рж▓рзНржкрзА
ЁЯСитАНтЬИ => ЁЯСитАНтЬИ, ржЫрзЗрж▓рзЗ, ржЫрзЗрж▓рзЗ , ржкрзБрж░рзБрж╖ ржкрж╛ржпрж╝рж▓ржЯ, ржкрж╛ржпрж╝рж▓ржЯ, ржкрзБрж░рзБрж╖, ржкрзНрж▓рзЗржи
ЁЯСйтАНтЬИ => ЁЯСйтАНтЬИ, ржкрж╛ржпрж╝рж▓ржЯ, ржкрзНрж▓рзЗржи, ржорж╣рж┐рж▓рж╛, ржорзЗржпрж╝рзЗ, ржорзЗржпрж╝рзЗ , ржорж╣рж┐рж▓рж╛ ржкрж╛ржпрж╝рж▓ржЯ
ЁЯСитАНЁЯЪА => ЁЯСитАНЁЯЪА, ржЫрзЗрж▓рзЗ, ржЫрзЗрж▓рзЗ , ржкрзБрж░рзБрж╖ ржорж╣рж╛ржХрж╛рж╢ ржЕржнрж┐ржпрж╛рждрзНрж░рзА, ржкрзБрж░рзБрж╖, ржорж╣рж╛ржХрж╛рж╢ ржЕржнрж┐ржпрж╛рждрзНрж░рзА, рж░ржХрзЗржЯ, рж╕рзНржкрзЗрж╕
ЁЯСйтАНЁЯЪА => ЁЯСйтАНЁЯЪА, ржорж╣рж╛ржХрж╛рж╢ ржЕржнрж┐ржпрж╛рждрзНрж░рзА, ржорж╣рж┐рж▓рж╛, ржорж╣рж┐рж▓рж╛ , ржорзЗржпрж╝рзЗ ржорж╣рж╛ржХрж╛рж╢ ржЕржнрж┐ржпрж╛рждрзНрж░рзА, ржорзЗржпрж╝рзЗ, рж░ржХрзЗржЯ, рж╕рзНржкрзЗрж╕
ЁЯСитАНЁЯЪТ => ЁЯСитАНЁЯЪТ, ржЫрзЗрж▓рзЗ, ржЫрзЗрж▓рзЗ , ржкрзБрж░рзБрж╖ ржлрж╛ржпрж╝рж╛рж░ржлрж╛ржЗржЯрж╛рж░, ржкрзБрж░рзБрж╖, ржлрж╛ржпрж╝рж╛рж░ржЯрзНрж░рж╛ржХ, ржлрж╛ржпрж╝рж╛рж░ржлрж╛ржЗржЯрж╛рж░
ЁЯСйтАНЁЯЪТ => ЁЯСйтАНЁЯЪТ, ржлрж╛ржпрж╝рж╛рж░ржЯрзНрж░рж╛ржХ, ржлрж╛ржпрж╝рж╛рж░ржлрж╛ржЗржЯрж╛рж░, ржорж╣рж┐рж▓рж╛, ржорзЗржпрж╝рзЗ, ржорзЗржпрж╝рзЗ , ржорж╣рж┐рж▓рж╛ ржлрж╛ржпрж╝рж╛рж░ржлрж╛ржЗржЯрж╛рж░
ЁЯСо => ЁЯСо, ржЕржлрж┐рж╕рж╛рж░, ржкрзБрж▓рж┐рж╢, ржкрзБрж▓рж┐рж╢ ржЕржлрж┐рж╕рж╛рж░, рж╢рж╛ржирзНрждрж┐рж░ржХрзНрж╖ржХ
ЁЯСотАНтЩВ => ЁЯСотАНтЩВ, ржЕржлрж┐рж╕рж╛рж░, ржЫрзЗрж▓рзЗ, ржЫрзЗрж▓рзЗ , ржкрзБрж░рзБрж╖ ржкрзБрж▓рж┐рж╢ ржЕржлрж┐рж╕рж╛рж░, ржкрзБрж░рзБрж╖, ржкрзБрж▓рж┐рж╕
ЁЯСотАНтЩА => ЁЯСотАНтЩА, ржЕржлрж┐рж╕рж╛рж░, ржкрзБрж▓рж┐рж╕, ржорж╣рж┐рж▓рж╛, ржорзЗржпрж╝рзЗ, ржорзЗржпрж╝рзЗ , ржорж╣рж┐рж▓рж╛ ржкрзБрж▓рж┐рж╢ ржЕржлрж┐рж╕рж╛рж░
ЁЯХ╡ => ЁЯХ╡, ржЧрзБржкрзНрждржЪрж░, ржЧрзЛржпрж╝рзЗржирзНржжрж╛
ЁЯХ╡тАНтЩВ => ЁЯХ╡тАНтЩВ, ржЧрзБржкрзНрждржЪрж░, ржЫрзЗрж▓рзЗ, ржЫрзЗрж▓рзЗ , ржкрзБрж░рзБрж╖ ржбрж┐ржЯрзЗржХржЯрж┐ржн, ржЯрж┐ржХржЯрж┐ржХрж┐, ржбрж┐ржЯрзЗржХржЯрж┐ржн, ржкрзБрж░рзБрж╖
ЁЯХ╡тАНтЩА => ЁЯХ╡тАНтЩА, ржЧрзБржкрзНрждржЪрж░, ржЯрж┐ржХржЯрж┐ржХрж┐, ржбрж┐ржЯрзЗржХржЯрж┐ржн, ржорж╣рж┐рж▓рж╛, ржорзЗржпрж╝рзЗ, ржорзЗржпрж╝рзЗ , ржорж╣рж┐рж▓рж╛ ржбрж┐ржЯрзЗржХржЯрж┐ржн
ЁЯТВ => ЁЯТВ, ржкрж╛рж╣рж╛рж░рж╛ржжрж╛рж░
ЁЯТВтАНтЩВ => ЁЯТВтАНтЩВ, ржЧрж╛рж░рзНржб, ржЫрзЗрж▓рзЗ, ржЫрзЗрж▓рзЗ , ржкрзБрж░рзБрж╖ ржЧрж╛рж░рзНржб, ржкрзБрж░рзБрж╖
ЁЯТВтАНтЩА => ЁЯТВтАНтЩА, ржЧрж╛рж░рзНржб, ржорж╣рж┐рж▓рж╛, ржорзЗржпрж╝рзЗ, ржорзЗржпрж╝рзЗ , ржорж╣рж┐рж▓рж╛ ржЧрж╛рж░рзНржб
ЁЯС╖ => ЁЯС╖, ржХрж░рзНржорзА, ржЯрзБржкрж┐, ржирж┐рж░рзНржорж╛ржг, ржирж┐рж░рзНржорж╛ржг ржХрж░рзНржорзА
ЁЯС╖тАНтЩВ => ЁЯС╖тАНтЩВ, ржЫрзЗрж▓рзЗ, ржирж┐рж░рзНржорж╛ржг, ржирж┐рж░рзНржорж╛ржг ржХрж░рзНржорзА, ржкрзБрж░рзБрж╖, ржкрзБрж░рзБрж╖ , ржЫрзЗрж▓рзЗ ржирж┐рж░рзНржорж╛ржг ржХрж░рзНржорзА
ЁЯС╖тАНтЩА => ЁЯС╖тАНтЩА, ржЧрж╛ржБржержирж┐, ржирж┐рж░рзНржорж╛ржг ржХрж░рзНржорзА, ржорж╣рж┐рж▓рж╛, ржорж╣рж┐рж▓рж╛ , ржорзЗржпрж╝рзЗ ржирж┐рж░рзНржорж╛ржг ржХрж░рзНржорзА, ржорзЗржпрж╝рзЗ
ЁЯд┤ => ЁЯд┤, рж░рж╛ржЬржкрзБрждрзНрж░
ЁЯС╕ => ЁЯС╕, ржХрж▓рзНржкржирж╛, рж░рж╛ржЬржХрзБржорж╛рж░рзА, рж░рзВржкржХржерж╛
ЁЯС│ => ЁЯС│, ржкрж╛ржЧржбрж╝рж┐, ржкрзБрж░рзБрж╖, ржмрзНржпржХрзНрждрж┐рж░ ржорж╛ржерж╛ржпрж╝ ржкрж╛ржЧржбрж╝рж┐ рж▓рж╛ржЧрж╛ржирзЛ
ЁЯС│тАНтЩВ => ЁЯС│тАНтЩВ, ржЫрзЗрж▓рзЗ, ржкрж╛ржЧржбрж╝рж┐, ржкрж╛ржЧржбрж╝рж┐ржУржпрж╝рж╛рж▓рж╛, ржкрзБрж░рзБрж╖
ЁЯС│тАНтЩА => ЁЯС│тАНтЩА, ржкрж╛ржЧржбрж╝рж┐, ржкрж╛ржЧржбрж╝рж┐ржУржпрж╝рж╛рж▓рж┐, ржорж╣рж┐рж▓рж╛, ржорзЗржпрж╝рзЗ
ЁЯС▓ => ЁЯС▓, ржЧрзБржпрж╝рж╛ ржкрж┐ ржорж╛ржУ, ржЪрзАржирж╛ ржЯрзБржкрж┐ ржорж╛ржерж╛ржпрж╝ ржмрзНржпржХрзНрждрж┐, ржЯрзБржкрж┐, ржкрзБрж░рзБрж╖
ЁЯзХ => ЁЯзХ, ржЯрзЗржЪрзЗрж▓, ржорж╛ржерж╛рж░рж╕рзНржХрж╛рж░рзНржл, ржорзНржпрж╛ржиржЯрж┐рж▓рж╛, рж╕рзНржХрж╛рж░рзНржл ржкрж░рж╛ ржорж╣рж┐рж▓рж╛, рж╣рж┐ржЬрж╛ржм
ЁЯзФ => ЁЯзФ, ржжрж╛ржбрж╝рж┐, ржжрж╛ржбрж╝рж┐ржУржпрж╝рж╛рж▓рж╛ ржмрзНржпржХрзНрждрж┐
ЁЯС▒ => ЁЯС▒, рж╕рзНржмрж░рзНржгржХрзЗрж╢рзА, рж╕рзНржмрж░рзНржгржХрзЗрж╢рзА ржмрзНржпржХрзНрждрж┐
ЁЯС▒тАНтЩВ => ЁЯС▒тАНтЩВ, ржЫрзЗрж▓рзЗ, ржкрзБрж░рзБрж╖, рж╕рзНржмрж░рзНржгржХрзЗрж╢, рж╕рзНржмрж░рзНржгржХрзЗрж╢ ржУржпрж╝рж╛рж▓рж╛ ржкрзБрж░рзБрж╖
ЁЯС▒тАНтЩА => ЁЯС▒тАНтЩА, ржорж╣рж┐рж▓рж╛, ржорзЗржпрж╝рзЗ, рж╕рзНржмрж░рзНржгржХрзЗрж╢рзА, рж╕рзНржмрж░рзНржгржХрзЗрж╢рзА ржорж╣рж┐рж▓рж╛
ЁЯд╡ => ЁЯд╡, ржкрзБрж░рзБрж╖, рж╕рзБржЯ, рж╕рзБржЯ ржмрзБржЯ ржкрж░рж╛, рж╕рзБрж╕ржЬрзНржЬрж┐ржд
ЁЯС░ => ЁЯС░, ржШрзЛржоржЯрж╛, ржШрзЛржоржЯрж╛ ржжрзЗржУржпрж╝рж╛ ржиржмржмржзрзВ, ржиржмржмржзрзВ, ржмрж┐ржмрж╛рж╣
ЁЯд░ => ЁЯд░, ржЧрж░рзНржнржмрждрзА, ржЧрж░рзНржнржмрждрзА ржорж╣рж┐рж▓рж╛, ржорж╣рж┐рж▓рж╛
ЁЯд▒ => ЁЯд▒, рж╢рж┐рж╢рзБ, рж╢рзБрж╢рзНрж░рзБрж╖рж╛, рж╕рзНрждржи, рж╕рзНрждржирзНржпржкрж╛ржи
ЁЯС╝ => ЁЯС╝, ржХрж▓рзНржкржирж╛, ржжрзЗржмржжрзВржд, ржмрж╛ржЪрзНржЪрж╛, ржорзБржЦ, рж░рзВржкржХржерж╛, рж╢рж┐рж╢рзБ ржЕрзНржпрж╛ржЮрзНржЬрзЗрж▓
ЁЯОЕ => ЁЯОЕ, ржЙржжржпрж╛ржкржи ржХрж░рж╛, ржХрж▓рзНржкржирж╛, ржХрзНрж░рж┐рж╕ржорж╛рж╕, ржмрж╛ржмрж╛, рж░рзВржкржХржерж╛, рж╕рж╛ржирзНрждрж╛, рж╕рж╛ржирзНрждрж╛ ржХрзНрж▓ржЬ
ЁЯд╢ => ЁЯд╢, ржЦрзНрж░рж┐рж╖рзНржЯржорж╛рж╕, ржорж╛, ржорж╛ржжрж╛рж░ ржЦрзНрж░рж┐рж╖рзНржЯржорж╛рж╕, ржорж┐рж╕рзЗрж╕ ржХрзНрж▓ржЬ
ЁЯзЩ => ЁЯзЩ, ржЙржЗржЪ, ржЙржЗржЬрж╛рж░рзНржб, ржЬрж╛ржжрзБржХрж░, ржЬрж╛ржжрзБржХрж░рзА, ржорзЗржЬ
ЁЯзЩтАНтЩА => ЁЯзЩтАНтЩА, ржЙржЗржЪ, ржЬрж╛ржжрзБржХрж░рзА, ржорж╣рж┐рж▓рж╛ ржорзЗржЬ
ЁЯзЩтАНтЩВ => ЁЯзЩтАНтЩВ, ржЙржЗржЬрж╛рж░рзНржб, ржЬрж╛ржжрзБржХрж░, ржкрзБрж░рзБрж╖ ржорзЗржЬ
ЁЯзЪ => ЁЯзЪ, ржУржмрзЛрж░ржи, ржЯрж╛ржЗржЯрзЗржирж┐ржпрж╝рж╛, ржжрзБрж╖рзНржЯрзБ ржЫрзЗрж▓рзЗ, ржкрж░рзА
ЁЯзЪтАНтЩА => ЁЯзЪтАНтЩА, ржЯрж╛ржЗржЯрзЗржирж┐ржпрж╝рж╛, ржорж╣рж┐рж▓рж╛ ржкрж░рзА
ЁЯзЪтАНтЩВ => ЁЯзЪтАНтЩВ, ржУржмрзЛрж░ржи, ржЫрзЗрж▓рзЗ ржкрж░рзА, ржжрзБрж╖рзНржЯрзБ ржЫрзЗрж▓рзЗ
ЁЯзЫ => ЁЯзЫ, ржЖржзржорж░рж╛, ржбрзНрж░рж╛ржХрзБрж▓рж╛, ржнрзНржпрж╛ржорзНржкрж╛ржпрж╝рж╛рж░
ЁЯзЫтАНтЩА => ЁЯзЫтАНтЩА, ржЖржзржорж░рж╛, ржорж╣рж┐рж▓рж╛ ржнрзНржпрж╛ржорзНржкрж╛ржпрж╝рж╛рж░
ЁЯзЫтАНтЩВ => ЁЯзЫтАНтЩВ, ржЖржзржорж░рж╛, ржбрзНрж░рж╛ржХрзБрж▓рж╛, ржкрзБрж░рзБрж╖ ржнрзНржпрж╛ржорзНржкрж╛ржпрж╝рж╛рж░
ЁЯзЬ => ЁЯзЬ, ржорж╛рж░ржЙржЗржорзЗржи, ржорж╛рж░ржкрж╛рж░рзНрж╕рзЗржи, ржорж╛рж░ржорзЗржб, ржорж╛рж░ржорзЗржи
ЁЯзЬтАНтЩА => ЁЯзЬтАНтЩА, ржорж╛рж░ржЙржЗржорзЗржи, ржорж╛рж░ржорзЗржб
ЁЯзЬтАНтЩВ => ЁЯзЬтАНтЩВ, ржЯрзНрж░рж┐ржЯржи, ржорж╛рж░ржорзНржпрж╛ржи
ЁЯзЭ => ЁЯзЭ, ржПрж▓рзНржл, ржЬрж╛ржжрзБржХрж░рзА
ЁЯзЭтАНтЩА => ЁЯзЭтАНтЩА, ржЬрж╛ржжрзБржХрж░рзА, ржорж╣рж┐рж▓рж╛ ржПрж▓рзНржл
ЁЯзЭтАНтЩВ => ЁЯзЭтАНтЩВ, ржЬрж╛ржжрзБржХрж░рзА, ржкрзБрж░рзБрж╖ ржПрж▓рзНржл
ЁЯзЮ => ЁЯзЮ, ржЬрзАржирж┐, ржЬрзНржмрзАржи ржЬрж╛рждрж┐
ЁЯзЮтАНтЩА => ЁЯзЮтАНтЩА, ржЬрзНржмрзАржи ржЬрж╛рждрж┐, ржорж╣рж┐рж▓рж╛ ржЬрзАржирж┐
ЁЯзЮтАНтЩВ => ЁЯзЮтАНтЩВ, ржЬрзНржмрзАржи ржЬрж╛рждрж┐, ржкрзБрж░рзБрж╖ ржЬрзАржирж┐
ЁЯзЯ => ЁЯзЯ, ржЖржзржорж░рж╛, ржУржпрж╝рж╛ржХрж┐ржВ ржбрзЗржб, ржЬржорзНржмрж┐
ЁЯзЯтАНтЩА => ЁЯзЯтАНтЩА, ржЖржзржорж░рж╛, ржУржпрж╝рж╛ржХрж┐ржВ ржбрзЗржб, ржорж╣рж┐рж▓рж╛ ржЬржорзНржмрж┐
ЁЯзЯтАНтЩВ => ЁЯзЯтАНтЩВ, ржЖржзржорж░рж╛, ржУржпрж╝рж╛ржХрж┐ржВ ржбрзЗржб, ржкрзБрж░рзБрж╖ ржЬржорзНржмрж┐
ЁЯЩН => ЁЯЩН, ржЕржЩрзНржЧржнржЩрзНржЧрж┐, ржХрзНрж░рзЛржзрж┐ ржмрзНржпржХрзНрждрж┐, ржнрзНрж░рзВ ржХрзБржЪржБржХрж╛ржирзЛ
ЁЯЩНтАНтЩВ => ЁЯЩНтАНтЩВ, ржЕржЩрзНржЧрж┐ржнржЩрзНржЧрж┐, ржЫрзЗрж▓рзЗ, ржкрзБрж░рзБрж╖, ржкрзБрж░рзБрж╖ , ржЫрзЗрж▓рзЗ ржнрзБрж░рзБ ржХрзБржБржЪржХрж╛ржирзЛ, ржнрзБрж░рзБ ржХрзБржБржЪржХрж╛ржирзЛ
ЁЯЩНтАНтЩА => ЁЯЩНтАНтЩА, ржЕржЩрзНржЧрж┐ржнржЩрзНржЧрж┐, ржнрзБрж░рзБ ржХрзБржБржЪржХрж╛ржирзЛ, ржорж╣рж┐рж▓рж╛, ржорж╣рж┐рж▓рж╛ , ржорзЗржпрж╝рзЗ ржнрзБрж░рзБ ржХрзБржБржЪржХрж╛ржирзЛ, ржорзЗржпрж╝рзЗ
ЁЯЩО => ЁЯЩО, ржЕржЩрзНржЧржнржЩрзНржЧрж┐, ржмрж┐рж╕рзНржлрж╛рж░рж┐ржд ржЪрзЛржЦ, ржмрж┐рж╕рзНржлрзБрж░рж┐ржд ржмрзНржпржХрзНрждрж┐
ЁЯЩОтАНтЩВ => ЁЯЩОтАНтЩВ, ржЕржЩрзНржЧрж┐ржнржЩрзНржЧрж┐, ржЫрзЗрж▓рзЗ, ржкрж╛ржЙржЯрж┐ржВ, ржкрзБрж░рзБрж╖, ржкрзБрж░рзБрж╖ , ржЫрзЗрж▓рзЗ ржкрж╛ржЙржЯрж┐ржВ
ЁЯЩОтАНтЩА => ЁЯЩОтАНтЩА, ржЕржЩрзНржЧрж┐ржнржЩрзНржЧрж┐, ржкрж╛ржЙржЯрж┐ржВ, ржорж╣рж┐рж▓рж╛, ржорж╣рж┐рж▓рж╛ , ржорзЗржпрж╝рзЗ ржкрж╛ржЙржЯрж┐ржВ, ржорзЗржпрж╝рзЗ
ЁЯЩЕ => ЁЯЩЕ, ржЕржЩрзНржЧржнржЩрзНржЧрж┐, ржиржпрж╝, ржирж╛, ржирж╛ ржПрж░ ржЕржЩрзНржЧржнржЩрзНржЧрж┐, ржирж┐рж╖рж┐ржжрзНржз, ржирж┐рж╖рж┐ржжрзНржз ржерж╛ржХрж╛, рж╣рж╛ржд
ЁЯЩЕтАНтЩВ => ЁЯЩЕтАНтЩВ, ржЕржЩрзНржЧрж┐ржнржЩрзНржЧрж┐, ржЕржмрзИржз, ржарж┐ржХ ржирзЗржЗ, ржирж╛, ржирж┐рж╖рж┐ржжрзНржз, ржкрзБрж░рзБрж╖, ржкрзБрж░рзБрж╖рзЗрж░ ржжрзЗржЦрж╛ржирзЛ ржарж┐ржХ ржирзЗржЗ ржЕржЩрзНржЧрж┐ржнржЩрзНржЧрж┐, рж╣рж╛ржд
ЁЯЩЕтАНтЩА => ЁЯЩЕтАНтЩА, ржЕржЩрзНржЧрж┐ржнржЩрзНржЧрж┐, ржЕржмрзИржз, ржарж┐ржХ ржирзЗржЗ, ржирж╛, ржирж┐рж╖рж┐ржжрзНржз, ржорж╣рж┐рж▓рж╛, ржорж╣рж┐рж▓рж╛рж░ ржжрзЗржЦрж╛ржирзЛ ржарж┐ржХ ржирзЗржЗ ржЕржЩрзНржЧрж┐ржнржЩрзНржЧрж┐, ржорзЗржпрж╝рзЗ, рж╣рж╛ржд
ЁЯЩЖ => ЁЯЩЖ, ржЕржЩрзНржЧржнржЩрзНржЧрж┐, ржУржХрзЗрж░ ржЕржЩрзНржЧржнржЩрзНржЧрж┐, ржарж┐ржХ ржЖржЫрзЗ, рж╣рж╛ржд
ЁЯЩЖтАНтЩВ => ЁЯЩЖтАНтЩВ, ржЕржЩрзНржЧрж┐ржнржЩрзНржЧрж┐, ржЫрзЗрж▓рзЗ, ржарж┐ржХ ржЖржЫрзЗ, ржкрзБрж░рзБрж╖, ржкрзБрж░рзБрж╖рзЗрж░ ржжрзЗржЦрж╛ржирзЛ ржарж┐ржХ ржЖржЫрзЗ ржЕржЩрзНржЧрж┐ржнржЩрзНржЧрж┐, рж╣рж╛ржд
ЁЯЩЖтАНтЩА => ЁЯЩЖтАНтЩА, ржЕржЩрзНржЧрж┐ржнржЩрзНржЧрж┐, ржарж┐ржХ ржЖржЫрзЗ, ржорж╣рж┐рж▓рж╛, ржорж╣рж┐рж▓рж╛рж░ ржжрзЗржЦрж╛ржирзЛ ржарж┐ржХ ржЖржЫрзЗ ржЕржЩрзНржЧрж┐ржнржЩрзНржЧрж┐, рж╣рж╛ржд
ЁЯТБ => ЁЯТБ, рждржерзНржп, рждржерзНржп ржбрзЗрж╕рзНржХрзЗрж░ ржмрзНржпржХрзНрждрж┐, ржкрзНрж░рж╛ржгржмржирзНржд, рж╕рж╣рж╛ржпрж╝рждрж╛, рж╣рж╛ржд
ЁЯТБтАНтЩВ => ЁЯТБтАНтЩВ, ржЫрзЗрж▓рзЗ, ржЫрзЗрж▓рзЗржжрзЗрж░ ржЯрж┐ржк ржЪрж╛ржУржпрж╝рж╛, ржЯрж┐ржк ржЪрж╛ржУржпрж╝рж╛, ржкрзБрж░рзБрж╖, ржоржЬрж╛ржжрж╛рж░
ЁЯТБтАНтЩА => ЁЯТБтАНтЩА, ржЯрж┐ржк ржЪрж╛ржУржпрж╝рж╛, ржоржЬрж╛ржжрж╛рж░, ржорж╣рж┐рж▓рж╛, ржорзЗржпрж╝рзЗ, ржорзЗржпрж╝рзЗржжрзЗрж░ ржЯрж┐ржк ржЪрж╛ржУржпрж╝рж╛
ЁЯЩЛ => ЁЯЩЛ, ржЕржЩрзНржЧржнржЩрзНржЧрж┐, ржЙрждрзНржерж┐ржд, ржЦрзБрж╢рж┐, рж╕рзБржЦрж┐ ржмрзНржпржХрзНрждрж┐ ржпрж┐ржирж┐ рж╣рж╛ржд рждрзБрж▓рзЗржЫрзЗржи, рж╣рж╛ржд
ЁЯЩЛтАНтЩВ => ЁЯЩЛтАНтЩВ, ржЕржЩрзНржЧрж┐ржнржЩрзНржЧрж┐, ржЫрзЗрж▓рзЗ, ржЫрзЗрж▓рзЗржжрзЗрж░ рж╣рж╛ржд рждрзЛрж▓рж╛, ржкрзБрж░рзБрж╖, рж╣рж╛ржд, рж╣рж╛ржд рждрзЛрж▓рж╛
ЁЯЩЛтАНтЩА => ЁЯЩЛтАНтЩА, ржЕржЩрзНржЧрж┐ржнржЩрзНржЧрж┐, ржорж╣рж┐рж▓рж╛, ржорзЗржпрж╝рзЗ, ржорзЗржпрж╝рзЗржжрзЗрж░ рж╣рж╛ржд рждрзЛрж▓рж╛, рж╣рж╛ржд, рж╣рж╛ржд рждрзЛрж▓рж╛
ЁЯЩЗ => ЁЯЩЗ, ржЕржЩрзНржЧржнржЩрзНржЧрж┐, ржХрзНрж╖ржорж╛ ржкрзНрж░рж╛рж░рзНржержирж╛, ржжрзБржГржЦрж┐ржд, ржмрзНржпржХрзНрждрж┐рж░ ржкрзНрж░ржгрж╛ржо, ржорж╛ржерж╛ ржиржд
ЁЯЩЗтАНтЩВ => ЁЯЩЗтАНтЩВ, ржЕржЩрзНржЧрж┐ржнржЩрзНржЧрж┐, ржЫрзЗрж▓рзЗ, ржЫрзЗрж▓рзЗржжрж░ ржорж╛ржерж╛ ржиржд ржХрж░рж╛, ржжрзБржГржЦрж┐ржд, ржкрзБрж░рзБрж╖, ржорж╛ржерж╛ ржиржд ржХрж░рж╛, ржорж╛ржк ржЪрж╛ржУржпрж╝рж╛
ЁЯЩЗтАНтЩА => ЁЯЩЗтАНтЩА, ржЕржЩрзНржЧрж┐ржнржЩрзНржЧрж┐, ржжрзБржГржЦрж┐ржд, ржорж╣рж┐рж▓рж╛, ржорж╛ржерж╛ ржиржд ржХрж░рж╛, ржорж╛ржк ржЪрж╛ржУржпрж╝рж╛, ржорзЗржпрж╝рзЗржжрзЗрж░ ржорж╛ржерж╛ ржиржд ржХрж░рж╛, ржорзЗрж▓рзЗ
ЁЯдж => ЁЯдж, ржЕржмрж┐рж╢рзНржмрж╛рж╕, ржмрж┐рж░ржХрзНрждрж┐, ржорж╛ржерж╛ржпрж╝, ржорж╛ржерж╛ржпрж╝ рж╣рж╛ржд, рж╣рж╛ржд
ЁЯджтАНтЩВ => ЁЯджтАНтЩВ, ржЕржмрж┐рж╢рзНржмрж╛рж╕, ржХржкрж╛рж▓рзЗ рж╣рж╛ржд, ржХрзНрж░рзЛржз, ржЫрзЗрж▓рзЗ, ржЫрзЗрж▓рзЗржжрзЗрж░ ржХржкрж╛рж▓рзЗ рж╣рж╛ржд, ржкрзБрж░рзБрж╖, ржорж╛ржерж╛ржпрж╝ рж╣рж╛ржд
ЁЯджтАНтЩА => ЁЯджтАНтЩА, ржЕржмрж┐рж╢рзНржмрж╛рж╕, ржХржкрж╛рж▓рзЗ рж╣рж╛ржд, ржХрзНрж░рзЛржз, ржорж╣рж┐рж▓рж╛, ржорж╛ржерж╛ржпрж╝ рж╣рж╛ржд, ржорзЗржпрж╝рзЗ, ржорзЗржпрж╝рзЗржжрзЗрж░ ржХржкрж╛рж▓рзЗ рж╣рж╛ржд
ЁЯд╖ => ЁЯд╖, ржЕржЬрзНржЮрж╛ржи, ржЕржирж┐рж╢рзНржЪрж┐ржд, ржЙржжрж╛рж╕рзАржирждрж╛, ржХрж╛ржБржз ржирж╛ржбрж╝рж┐ржпрж╝рзЗ ржЙрждрзНрждрж░рж▓ ржжрзЗржУржпрж╝рж╛, ржарж┐ржХ ржЬрж╛ржирж┐ ржирж╛
ЁЯд╖тАНтЩВ => ЁЯд╖тАНтЩВ, ржЕржмрж┐рж╢рзНржмрж╛рж╕, ржЙржжрж╛рж╕рзАржирждрж╛, ржХрж╛ржБржз ржЭрж╛ржБржХрж╛ржирзЛ, ржЫрзЗрж▓рзЗ, ржЫрзЗрж▓рзЗржжрзЗрж░ ржХрж╛ржБржз ржЭрж╛ржБржХрж╛ржирзЛ, ржкрзБрж░рзБрж╖, рж╕ржирзНржжрзЗрж╣, рж╕ржВрж╢ржпрж╝
ЁЯд╖тАНтЩА => ЁЯд╖тАНтЩА, ржЕржмрж┐рж╢рзНржмрж╛рж╕, ржЙржжрж╛рж╕рзАржирждрж╛, ржХрж╛ржБржз ржЭрж╛ржБржХрж╛ржирзЛ, ржорж╣рж┐рж▓рж╛, ржорзЗржпрж╝рзЗ, ржорзЗржпрж╝рзЗржжрзЗрж░ ржХрж╛ржБржз ржЭрж╛ржБржХрж╛ржирзЛ, рж╕ржирзНржжрзЗрж╣, рж╕ржВрж╢ржпрж╝
ЁЯТЖ => ЁЯТЖ, ржлрзЗрж╕ ржорзНржпрж╛рж╕рзЗржЬ, ржорзНржпрж╛рж╕рж╛ржЬ, рж╕рзЗрж▓рзБржи
ЁЯТЖтАНтЩВ => ЁЯТЖтАНтЩВ, ржЫрзЗрж▓рзЗ, ржЫрзЗрж▓рзЗржжрзЗрж░ ржлрзЗрж╕ ржорж╛рж╕рж╛ржЬ, ржкрзБрж░рзБрж╖, ржорж╛рж╕рж╛ржЬ, ржорзБржЦ
ЁЯТЖтАНтЩА => ЁЯТЖтАНтЩА, ржорж╣рж┐рж▓рж╛, ржорж╛рж╕рж╛ржЬ, ржорзБржЦ, ржорзЗржпрж╝рзЗ, ржорзЗржпрж╝рзЗржжрзЗрж░ ржлрзЗрж╕ ржорж╛рж╕рж╛ржЬ
ЁЯТЗ => ЁЯТЗ, ржЪрзБрж▓ ржХрж╛ржЯрж╛, ржирж╛ржкрж┐ржд, ржкрж╛рж░рзНрж▓рж╛рж░, рж╕рзМржирзНржжрж░рзНржпрзНржп
ЁЯТЗтАНтЩВ => ЁЯТЗтАНтЩВ, ржЪрзБрж▓ ржХрж╛ржЯрж╛, ржЫрзЗрж▓рзЗ, ржЫрзЗрж▓рзЗржжрзЗрж░ ржЪрзБрж▓ ржХрж╛ржЯрж╛, ржкрзБрж░рзБрж╖
ЁЯТЗтАНтЩА => ЁЯТЗтАНтЩА, ржЪрзБрж▓ ржХрж╛ржЯрж╛, ржорж╣рж┐рж▓рж╛, ржорзЗржпрж╝рзЗ, ржорзЗржпрж╝рзЗржжрзЗрж░ ржЪрзБрж▓ ржХрж╛ржЯрж╛
ЁЯЪ╢ => ЁЯЪ╢, ржЪрж▓ржорж╛ржи, ржЪрж▓рж╛, ржнрзНрж░ржоржг ржХрж░рж╛, рж╣рж╛ржБржЯрж╛
ЁЯЪ╢тАНтЩВ => ЁЯЪ╢тАНтЩВ, ржЫрзЗрж▓рзЗ, ржЫрзЗрж▓рзЗржжрзЗрж░ рж╣рж╛ржБржЯрж╛, ржкрзБрж░рзБрж╖, рж╣ржиржЯржи, рж╣рж╛ржБржЯрж╛
ЁЯЪ╢тАНтЩА => ЁЯЪ╢тАНтЩА, ржорж╣рж┐рж▓рж╛, ржорзЗржпрж╝рзЗ, ржорзЗржпрж╝рзЗржжрзЗрж░ рж╣рж╛ржБржЯрж╛, рж╣ржиржЯржи, рж╣рж╛ржБржЯрж╛
ЁЯПГ => ЁЯПГ, ржжрзМржбрж╝, ржжрзМржбрж╝рж░ржд, ржорзНржпрж╛рж░рж╛ржержи
ЁЯПГтАНтЩВ => ЁЯПГтАНтЩВ, ржЫрзЗрж▓рзЗ, ржЫрзЗрж▓рзЗржжрзЗрж░ ржжрзМржбрж╝, ржжрзМржбрж╝, ржкрзБрж░рзБрж╖, ржорзНржпрж╛рж░рж╛ржержи, рж░рзЗрж╕рж┐ржВ
ЁЯПГтАНтЩА => ЁЯПГтАНтЩА, ржжрзМржбрж╝, ржорж╣рж┐рж▓рж╛, ржорзЗржпрж╝рзЗ, ржорзЗржпрж╝рзЗржжрзЗрж░ ржжрзМржбрж╝, ржорзНржпрж╛рж░рж╛ржержи, рж░рзЗрж╕рж┐ржВ
ЁЯТГ => ЁЯТГ, ржбрж╛ржирж╕рж╛рж░, ржирзГрждрзНржпрж░ржд ржорж╣рж┐рж▓рж╛
ЁЯХ║ => ЁЯХ║, ржирж╛ржЪржЫрзЗ, ржирзГрждрзНржпрж░ржд ржкрзБрж░рзБрж╖, ржкрзБрж░рзБрж╖
ЁЯСп => ЁЯСп, ржХрж╛ржи, ржЦрж░ржЧрзЛрж╢, ржЭрзЛрж▓рж╛ ржХрж╛ржиржпрзБржХрзНржд рж▓рзЛржХ, ржирж░рзНрждржХрзА, ржирж╛рж░рзА, ржорзЗржпрж╝рзЗ
ЁЯСптАНтЩВ => ЁЯСптАНтЩВ, ржЫрзЗрж▓рзЗ, ржЭрзЛрж▓рж╛ ржХрж╛ржиржпрзБржХрзНржд ржкрзБрж░рзБрж╖, ржбрж╛ржирж╕рж╛рж░, ржкрж╛рж░рзНржЯрж┐, ржмрж╛ржирж┐ ржЗржпрж╝рж╛рж░
ЁЯСптАНтЩА => ЁЯСптАНтЩА, ржЭрзЛрж▓рж╛ ржХрж╛ржиржпрзБржХрзНржд ржирж╛рж░рж┐, ржбрж╛ржирж╕рж╛рж░, ржкрж╛рж░рзНржЯрж┐, ржмрж╛ржирж┐ ржЗржпрж╝рж╛рж░, ржорзЗржпрж╝рзЗ
ЁЯзЦ => ЁЯзЦ, ржмрж╛рж╖рзНржкрзАржпрж╝ рж░рзБржо, ржмрж╛рж╖рзНржкрзАржпрж╝ рж░рзБржорзЗ ржПржХржЬржи, рж╕ржирж╛
ЁЯзЦтАНтЩА => ЁЯзЦтАНтЩА, ржмрж╛рж╖рзНржкрзАржпрж╝ рж░рзБржо, ржмрж╛рж╖рзНржкрзАржпрж╝ рж░рзБржорзЗ ржорж╣рж┐рж▓рж╛, рж╕ржирж╛
ЁЯзЦтАНтЩВ => ЁЯзЦтАНтЩВ, ржмрж╛рж╖рзНржкрзАржпрж╝ рж░рзБржо, ржмрж╛рж╖рзНржкрзАржпрж╝ рж░рзБржорзЗ ржкрзБрж░рзБрж╖, рж╕ржирж╛
ЁЯзЧ => ЁЯзЧ, ржЖрж░рзЛрж╣рзА, ржПржХржЬржи ржЙржкрж░рзЗ ржЙржаржЫрзЗ
ЁЯзЧтАНтЩА => ЁЯзЧтАНтЩА, ржЖрж░рзЛрж╣рзА, ржорж╣рж┐рж▓рж╛ ржЖрж░рзЛрж╣рзА
ЁЯзЧтАНтЩВ => ЁЯзЧтАНтЩВ, ржЖрж░рзЛрж╣рзА, ржкрзБрж░рзБрж╖ ржЖрж░рзЛрж╣рзА
ЁЯзШ => ЁЯзШ, ржзрзНржпрж╛ржи, ржкржжрзНржорж╛рж╕ржирзЗ ржмрж╕рж╛ ржмрзНржпржХрзНрждрж┐, ржпрзЛржЧрж╛
ЁЯзШтАНтЩА => ЁЯзШтАНтЩА, ржзрзНржпрж╛ржи, ржкржжрзНржорж╛рж╕ржирзЗ ржмрж╕рж╛ ржорж╣рж┐рж▓рж╛, ржпрзЛржЧрж╛
ЁЯзШтАНтЩВ => ЁЯзШтАНтЩВ, ржзрзНржпрж╛ржи, ржкржжрзНржорж╛рж╕ржирзЗ ржмрж╕рж╛ ржкрзБрж░рзБрж╖, ржпрзЛржЧрж╛
ЁЯЫА => ЁЯЫА, ржмрж╛ржержЯржм, ржмрзНржпржХрзНрждрж┐ рж╕рзНржирж╛ржи ржХрж░ржЫрзЗ, рж╕рзНржирж╛ржи
ЁЯЫМ => ЁЯЫМ, ржмрзНржпржХрзНрждрж┐ ржмрж┐ржЫрж╛ржирж╛ржпрж╝ ржЖржЫрзЗржи, рж╢рзЛржУржпрж╝рж╛, рж╣рзЛржЯрзЗрж▓
ЁЯХ┤ => ЁЯХ┤, ржкрзБрж░рзБрж╖, ржмрзНржпржмрж╕рж╛, ржмрзНржпржмрж╕рж╛рж░ рж╕рзНржпрзБржЯ ржкрж░рж┐рж╣рж┐ржд ржнрж╛рж╕ржорж╛ржи ржорж╛ржирзБрж╖, рж╕рзНржпрзБржЯ
ЁЯЧг => ЁЯЧг, ржХржерж╛ ржмрж▓рж╛, ржХржерж╛ ржмрж▓рж╛ ржорзБржЦ, ржХржерж╛рж░ржд, ржЫрж╛ржпрж╝рж╛, ржорзБржЦ, рж╣рж╛ржд
ЁЯСд => ЁЯСд, ржЖржмржХрзНрж╖, ржЫрж╛ржпрж╝рж╛, рж╕рж┐рж▓рзБржпрж╝рзЗржЯрзЗ ржЖржмржХрзНрж╖ ржорзВрж░рзНрждрж┐
ЁЯСе => ЁЯСе, ржЖржмржХрзНрж╖, ржЫрж╛ржпрж╝рж╛, рж╕рж┐рж▓рзБржпрж╝рзЗржЯрзЗ ржЖржмржХрзНрж╖ ржорзВрж░рзНрждрж┐ржЧрзБрж▓рж┐
ЁЯд║ => ЁЯд║, ржЦрзЗрж▓рж╛, рждрж▓рзЛржпрж╝рж╛рж░, рждрж▓рзЛржпрж╝рж╛рж░ ржЦрзЗрж▓рж╛, рждрж▓рзЛржпрж╝рж╛рж░ ржЦрзЗрж▓рзЛржпрж╝рж╛ржбрж╝, ржмрзНржпржХрзНрждрж┐
ЁЯПЗ => ЁЯПЗ, ржШрзЛржбрж╝рж╛, ржШрзЛржбрж╝рж╛ ржжрзМржбрж╝, ржЬржХрж┐, рж░рзЗрж╕рж┐ржВ
тЫ╖ => тЫ╖, рждрзБрж╖рж╛рж░ржкрж╛ржд, рж╕рзНржХрж┐, рж╕рзНржХрж┐ржЪрж╛рж▓ржХ
ЁЯПВ => ЁЯПВ, рждрзБрж╖рж╛рж░ржкрж╛ржд, рж╕рзНржХрж┐, рж╕рзНржирзЛ ржмрж░рзНржбрж╛рж░, рж╕рзНржирзЛржмрзЛрж░рзНржб
ЁЯПМ => ЁЯПМ, ржЧрж▓ржл, ржЧрж▓рзНржлрж╛рж░, ржмрж▓
ЁЯПМтАНтЩВ => ЁЯПМтАНтЩВ, ржЧрж▓рзНржл, ржЫрзЗрж▓рзЗ, ржЫрзЗрж▓рзЗржжрзЗрж░ ржЧрж▓рзНржл ржЦрзЗрж▓рж╛, ржкрзБрж░рзБрж╖
ЁЯПМтАНтЩА => ЁЯПМтАНтЩА, ржЧрж▓рзНржл, ржорж╣рж┐рж▓рж╛, ржорзЗржпрж╝рзЗ, ржорзЗржпрж╝рзЗржжрзЗрж░ ржЧрж▓рзНржл ржЦрзЗрж▓рж╛
ЁЯПД => ЁЯПД, рж╕рж╛рж░рзНржлрж╛рж░, рж╕рж╛рж░рзНржлрж┐ржВ
ЁЯПДтАНтЩВ => ЁЯПДтАНтЩВ, ржЫрзЗрж▓рзЗ, ржЫрзЗрж▓рзЗржжрзЗрж░ рж╕рж╛рж░рзНржлрж┐ржВ, ржкрзБрж░рзБрж╖, рж╕рж╛рж░рзНржлрж┐ржВ
ЁЯПДтАНтЩА => ЁЯПДтАНтЩА, ржорж╣рж┐рж▓рж╛, ржорзЗржпрж╝рзЗржжрзЗрж░ рж╕рж╛рж░рзНржлрж┐ржВ, рж╕рж╛рж░рзНржлрж┐ржВ
ЁЯЪг => ЁЯЪг, ржЧрзЛрж▓ ржирзМржХрж╛, ржирзМржХрж╛, ржпрж╛ржиржмрж╛рж╣ржи
ЁЯЪгтАНтЩВ => ЁЯЪгтАНтЩВ, ржЫрзЗрж▓рзЗ, ржирзМржХрж╛, ржкрзБрж░рзБрж╖, ржкрзБрж░рзБрж╖ржжрзЗрж░ ржирзМржХрж╛ ржЪрж╛рж▓рж╛ржирзЛ, ржмрж╛ржЗржЪрзЗрж░ ржирзМржХрж╛
ЁЯЪгтАНтЩА => ЁЯЪгтАНтЩА, ржирзМржХрж╛, ржмрж╛ржЗржЪрзЗрж░ ржирзМржХрж╛, ржорж╣рж┐рж▓рж╛, ржорзЗржпрж╝рзЗржжрзЗрж░ ржирзМржХрж╛ ржЪрж╛рж▓рж╛ржирзЛ, рж╕рзНрждрзНрж░рж┐
ЁЯПК => ЁЯПК, рж╕рж╛ржБрждрж╛рж░ ржХрж╛ржЯрж╛, рж╕рж╛ржБрждрж╛рж░рзБ
ЁЯПКтАНтЩВ => ЁЯПКтАНтЩВ, ржЫрзЗрж▓рзЗ, ржкрзБрж░рзБрж╖, ржкрзБрж░рзБрж╖ рж╕рж╛ржБрждрж╛рж░рзБ, рж╕рж╛ржБрждрж╛рж░
ЁЯПКтАНтЩА => ЁЯПКтАНтЩА, ржорж╣рж┐рж▓рж╛, ржорж╣рж┐рж▓рж╛ рж╕рж╛ржБрждрж╛рж░рзБ, рж╕рж╛ржБрждрж╛рж░, рж╕рзНрждрзНрж░рж┐
тЫ╣ => тЫ╣, ржмрж▓, ржмрж▓ ржирж┐ржпрж╝рзЗ ржмрзНржпржХрзНрждрж┐
тЫ╣тАНтЩВ => тЫ╣тАНтЩВ, ржЫрзЗрж▓рзЗ, ржЫрзЗрж▓рзЗржжрзЗрж░ ржмрж▓ ржЦрзЗрж▓рж╛, ржкрж░рзБрж╖, ржмрж▓
тЫ╣тАНтЩА => тЫ╣тАНтЩА, ржмрж▓, ржорж╣рж┐рж▓рж╛, ржорзЗржпрж╝рзЗржжрзЗрж░ ржмрж▓ ржЦрзЗрж▓рж╛, рж╕рзНрждрзНрж░рж┐
ЁЯПЛ => ЁЯПЛ, ржЙрждрзНрждрзЛрж▓ржХ ржмрзНржпржХрзНрждрж┐, ржУржЬржи, ржнрж╛рж░рзЛрждрзНрждрзЛрж▓ржХ
ЁЯПЛтАНтЩВ => ЁЯПЛтАНтЩВ, ржУржпрж╝рзЗржЯрж▓рж┐ржлрзНржЯрж╛рж░, ржЫрзЗрж▓рзЗ, ржЫрзЗрж▓рзЗржжрзЗрж░ ржУржпрж╝рзЗржЗржЯрж▓рж┐ржлржЯрж┐ржВ, ржкрзБрж░рзБрж╖
ЁЯПЛтАНтЩА => ЁЯПЛтАНтЩА, ржУржпрж╝рзЗржЯрж▓рж┐ржлрзНржЯрж╛рж░, ржорж╣рж┐рж▓рж╛, ржорзЗржпрж╝рзЗржжрзЗрж░ ржУржпрж╝рзЗржЗржЯрж▓рж┐ржлржЯрж┐ржВ, рж╕рзНрждрзНрж░рж┐
ЁЯЪ┤ => ЁЯЪ┤, ржмрж╛ржЗржХ, ржмрж╛ржЗрж╕рж╛ржЗржХрзЗрж▓, ржмрж╛ржЗрж╕рж╛ржЗржХрзЗрж▓ ржЖрж░рзЛрж╣рзА, рж╕рж╛ржЗржХрзЗрж▓ ржЖрж░рзЛрж╣рзА
ЁЯЪ┤тАНтЩВ => ЁЯЪ┤тАНтЩВ, ржЫрзЗрж▓рзЗ, ржЫрзЗрж▓рзЗржжрзЗрж░ рж╕рж╛рж╛ржЗржХрзЗрж▓ ржЪрж╛рж▓рж╛ржирзЛ, ржкрзБрж░рзБрж╖, ржмрж╛ржЗрж╕рж╛ржЗржХрзЗрж▓, рж╕рж╛ржЗржХрзЗрж▓
ЁЯЪ┤тАНтЩА => ЁЯЪ┤тАНтЩА, ржмрж╛ржЗрж╕рж╛ржЗржХрзЗрж▓, ржорж╣рж┐рж▓рж╛, ржорзЗржпрж╝рзЗржжрзЗрж░ рж╕рж╛рж╛ржЗржХрзЗрж▓ ржЪрж╛рж▓рж╛ржирзЛ, рж╕рж╛ржЗржХрзЗрж▓, рж╕рзНрждрзНрж░рж┐
ЁЯЪ╡ => ЁЯЪ╡, ржкрж░рзНржмржд, ржкрж░рзНржмрждрзЗ рж╕рж╛ржЗржХрзЗрж▓ ржЖрж░рзЛрж╣рзА, ржмрж╛ржЗржХ, ржмрж╛ржЗрж╕рж╛ржЗржХрзЗрж▓, рж╕рж╛ржЗржХрзЗрж▓ ржЖрж░рзЛрж╣рзА
ЁЯЪ╡тАНтЩВ => ЁЯЪ╡тАНтЩВ, ржЫрзЗрж▓рзЗржжрзЗрж░ ржкрж╛рж╣рж╛ржбрж╝рзЗ рж╕рж╛ржЗржХрзЗрж▓ ржЪрж╛рж▓рж╛ржирзЛ, ржкрж╛рж╣рж╛ржбрж╝, ржкрзБрж░рзБрж╖, ржмрж╛ржЗрж╕рж╛ржЗржХрзЗрзЗрж▓, рж╕рж╛ржЗржХрзЗрж▓
ЁЯЪ╡тАНтЩА => ЁЯЪ╡тАНтЩА, ржкрж╛рж╣рж╛ржбрж╝, ржмрж╛ржЗрж╕рж╛ржЗржХрзЗрзЗрж▓, ржорж╣рж┐рж▓рж╛, ржорзЗржпрж╝рзЗржжрзЗрж░ ржкрж╛рж╣рж╛ржбрж╝рзЗ рж╕рж╛ржЗржХрзЗрж▓ ржЪрж╛рж▓рж╛ржирзЛ, рж╕рж╛ржЗржХрзЗрж▓
ЁЯПО => ЁЯПО, ржЧрж╛ржбрж╝рж┐, рж░рзЗрж╕рж┐ржВ, рж░рзЗрж╕рж┐ржВ ржХрж╛рж░
ЁЯПН => ЁЯПН, ржоржЯрж░рж╕рж╛ржЗржХрзЗрж▓, рж░рзЗрж╕рж┐ржВ
ЁЯд╕ => ЁЯд╕, ржХрж╛рж░рзНржЯрж╣рзБржЗрж▓, ржЦрзЗрж▓рж╛, ржЬрж┐ржоржирзНржпрж╛рж╕рзНржЯ, ржмрзНржпржХрзНрждрж┐
ЁЯд╕тАНтЩВ => ЁЯд╕тАНтЩВ, ржПржХржЬржи ржЫрзЗрж▓рзЗ ржХрж╛рж░рзНржЯрж╣рзБржЗрж▓ ржХрж░ржЫрзЗ, ржХрж╛рж░рзНржЯрж╣рзБржЗрж▓, ржЦрзЗрж▓рж╛ржзрзБрж▓рж╛, ржЬрж┐ржоржирзНржпрж╛рж╕рзНржЯрж┐ржХ, ржкрзБрж░рзБрж╖, ржмрзНржпржХрзНрждрж┐
ЁЯд╕тАНтЩА => ЁЯд╕тАНтЩА, ржПржХржЬржи ржорзЗржпрж╝рзЗ ржХрж╛рж░рзНржЯрж╣рзБржЗрж▓ ржХрж░ржЫрзЗ, ржХрж╛рж░рзНржЯрж╣рзБржЗрж▓, ржЦрзЗрж▓рж╛ржзрзБрж▓рж╛, ржЬрж┐ржоржирзНржпрж╛рж╕рзНржЯрж┐ржХ, ржмрзНржпржХрзНрждрж┐, ржорж╣рж┐рж▓рж╛
ЁЯд╝ => ЁЯд╝, ржХрзБрж╕рзНрждрж┐, ржХрзБрж╕рзНрждрж┐ржЧрзАрж░, ржЦрзЗрж▓рж╛, ржмрзНржпржХрзНрждрж┐
ЁЯд╝тАНтЩВ => ЁЯд╝тАНтЩВ, ржХрзБрж╕рзНрждрж┐, ржЦрзЗрж▓рж╛ржзрзБрж▓рж╛, ржкрзБрж░рзБрж╖, ржкрзБрж░рзБрж╖ ржХрзБрж╕рзНрждрж┐ржЧрзАрж░, ржмрзНржпржХрзНрждрж┐
ЁЯд╝тАНтЩА => ЁЯд╝тАНтЩА, ржХрзБрж╕рзНрждрж┐, ржЦрзЗрж▓рж╛ржзрзБрж▓рж╛, ржмрзНржпржХрзНрждрж┐, ржорж╣рж┐рж▓рж╛, ржорж╣рж┐рж▓рж╛ ржХрзБрж╕рзНрждрж┐ржЧрзАрж░
ЁЯд╜ => ЁЯд╜, ржУржпрж╝рж╛ржЯрж╛рж░, ржУржпрж╝рж╛ржЯрж╛рж░ ржкрзЛрж▓рзЛ, ржЦрзЗрж▓рж╛, ржЬрж▓, ржкрзЛрж▓рзЛ, ржмрзНржпржХрзНрждрж┐
ЁЯд╜тАНтЩВ => ЁЯд╜тАНтЩВ, ржУржпрж╝рж╛ржЯрж╛рж░, ржУржпрж╝рж╛ржЯрж╛рж░ ржкрзЛрж▓рзЛ ржЦрзЗрж▓ржЫрзЗ ржПржоржи ржкрзБрж░рзБрж╖, ржЦрзЗрж▓рж╛ржзрзБрж▓рж╛, ржЬрж▓, ржкрзБрж░рзБрж╖, ржкрзЛрж▓рзЛ, ржмрзНржпржХрзНрждрж┐
ЁЯд╜тАНтЩА => ЁЯд╜тАНтЩА, ржУржпрж╝рж╛ржЯрж╛рж░, ржУржпрж╝рж╛ржЯрж╛рж░ ржкрзЛрж▓рзЛ ржЦрзЗрж▓ржЫрзЗ ржПржоржи ржорж╣рж┐рж▓рж╛, ржЦрзЗрж▓рж╛, ржЬрж▓, ржкрзЛрж▓рзЛ, ржмрзНржпржХрзНрждрж┐, ржорж╣рж┐рж▓рж╛
ЁЯд╛ => ЁЯд╛, ржЦрзЗрж▓рж╛, ржмрж▓, ржмрзНржпржХрзНрждрж┐, рж╣рзНржпрж╛ржирзНржбржмрж▓
ЁЯд╛тАНтЩВ => ЁЯд╛тАНтЩВ, ржЦрзЗрж▓рж╛ржзрзБрж▓рж╛, ржкрзБрж░рзБрж╖, ржмрзНржпржХрзНрждрж┐, рж╣рзНржпрж╛ржирзНржбржмрж▓, рж╣рзНржпрж╛ржирзНржбржмрж▓ ржЦрзЗрж▓ржЫрзЗ ржПржоржи ржкрзБрж░рзБрж╖
ЁЯд╛тАНтЩА => ЁЯд╛тАНтЩА, ржЦрзЗрж▓рж╛ржзрзБрж▓рж╛, ржмрзНржпржХрзНрждрж┐, ржорж╣рж┐рж▓рж╛, рж╣рзНржпрж╛ржирзНржбржмрж▓, рж╣рзНржпрж╛ржирзНржбржмрж▓ ржЦрзЗрж▓ржЫрзЗ ржПржоржи ржорж╣рж┐рж▓рж╛
ЁЯд╣ => ЁЯд╣, ржПржХ рж╕рж╛ржерзЗ ржЕржирзЗржХржЧрзБрж▓рзЛ ржХрж╛ржЬ ржХрж░рж╛, ржЬрж╛ржЧрж▓рж┐ржВ, ржжржХрзНрж╖рждрж╛, ржмрзНржпрж╛рж▓рзЗржирзНрж╕
ЁЯд╣тАНтЩВ => ЁЯд╣тАНтЩВ, ржПржХ рж╕рж╛ржерж╛ ржЕржирзЗржХржЧрзБрж▓рзЛ ржХрж╛ржЬ ржХрж░рж╛, ржЬрж╛ржЧрж▓рж┐ржВ, ржкрзБрж░рзБржп, ржкрзБрж░рзБрж╖ ржЬрж╛ржЧрж▓рж┐ржВ ржХрж░ржЫрзЗ
ЁЯд╣тАНтЩА => ЁЯд╣тАНтЩА, ржПржХ рж╕рж╛ржерж╛ ржЕржирзЗржХржЧрзБрж▓рзЛ ржХрж╛ржЬ ржХрж░рж╛, ржЬрж╛ржЧрж▓рж┐ржВ, ржорж╣рж┐рж▓рж╛, ржорж╣рж┐рж▓рж╛ ржЬрж╛ржЧрж▓рж┐ржВ ржХрж░ржЫрзЗ
ЁЯСл => ЁЯСл, ржЬрзЛржбрж╝, ржзрж░рзЗ рж░рж╛ржЦрж╛, ржирж╛рж░рзА, ржкрзБрж░рзБрж╖, ржорж╣рж┐рж▓рж╛ ржУ ржкрзБрж░рзБрж╖ рж╣рж╛ржд ржзрж░рзЗ ржжрж╛ржбрж╝рж┐ржпрж╝рзЗ ржЖржЫрзЗ, рж╣рж╛ржд
ЁЯСм => ЁЯСм, ржЬрзЛржбрж╝, ржжрзБржЬржи ржкрзБрж░рзБрж╖ рж╣рж╛рж░ ржзрж░рзЗ ржжрж╛ржбрж╝рж┐ржпрж╝рзЗ ржЖржЫрзЗ, ржзрж░рзЗ рж░рж╛ржЦрж╛, ржкрзБрж░рзБрж╖, ржорж┐ржерзБржи, ржпржоржЬ, рж░рж╛рж╢рж┐ржЪржХрзНрж░, рж╣рж╛ржд
ЁЯСн => ЁЯСн, ржЬрзЛржбрж╝, ржжрзБржЬржи ржорж╣рж┐рж▓рж╛ рж╣рж╛ржд ржзрж░рзЗ ржжрж╛ржбрж╝рж┐ржпрж╝рзЗ ржЖржЫрзЗ, ржзрж░рзЗ рж░рж╛ржЦрж╛, ржирж╛рж░рзА, рж╣рж╛ржд
ЁЯТП => ЁЯТП, ржЪрзБржорзНржмржи, ржЬрзЛржбрж╝, рж░рзЛржорж╛ржирзНрж╕
ЁЯТС => ЁЯТС, ржЬрзЛржбрж╝, ржнрж╛рж▓ржмрж╛рж╕рж╛, рж░рзЛржорж╛ржирзНрж╕, рж╣рж╛рж░рзНржЯ, рж╣рж╛рж░рзНржЯ рж╕рж╣ ржжржорзНржкрждрж┐
ЁЯСк => ЁЯСк, ржкрж░рж┐ржмрж╛рж░, ржмрж╛ржмрж╛, ржорж╛, рж╢рж┐рж╢рзБ
ЁЯд│ => ЁЯд│, ржХрзНржпрж╛ржорзЗрж░рж╛, ржлрзЛржи, рж╕рзЗрж▓ржлрж┐
ЁЯТк => ЁЯТк, ржХржорж┐ржХ, ржкрзЗрж╢рзА, ржлрзНрж▓рзЗржХрзНрж╕, ржмрж╛ржЗрж╕рзЗржк, ржмрж╛ржБржХрж╛ржирзЛ ржмрж╛ржЗрж╕рзЗржкрж╕, рж╢рж░рзАрж░
ЁЯСИ => ЁЯСИ, ржЖржЩрзНржЧрзБрж▓, ржкржпрж╝рзЗржирзНржЯ, ржмрж╛ржорзЗ ржЗрж╢рж╛рж░рж╛ ржХрж░рж╛ ржЙрж▓рзНржЯрзЛ рж╣рж╛рждрзЗрж░ рждрж░рзНржЬржирзА, ржмрзНржпрж╛ржХрж╣рзНржпрж╛ржирзНржб, рж╢рж░рзАрж░, рж╕рзВржЪржХ, рж╣рж╛ржд
ЁЯСЙ => ЁЯСЙ, ржЖржЩрзНржЧрзБрж▓, ржбрж╛ржирзЗ ржЗрж╢рж╛рж░рж╛ ржХрж░рж╛ ржЙрж▓рзНржЯрзЛ рж╣рж╛рждрзЗрж░ рждрж░рзНржЬржирзА, ржкржпрж╝рзЗржирзНржЯ, ржмрзНржпрж╛ржХрж╣рзНржпрж╛ржирзНржб, рж╢рж░рзАрж░, рж╕рзВржЪржХ, рж╣рж╛ржд
тШЭ => тШЭ, ржЖржЩрзНржЧрзБрж▓, ржЖржк, ржЙржкрж░рзЗрж░ ржжрж┐ржХрзЗ ржЗрж╢рж╛рж░рж╛ ржХрж░рж╛, ржкржпрж╝рзЗржирзНржЯ, рж╢рж░рзАрж░, рж╕рзВржЪржХ, рж╣рж╛ржд
ЁЯСЖ => ЁЯСЖ, ржЖржЩрзБрж▓ ржжрж┐ржпрж╝рзЗ ржЙржкрж░рзЗрж░ ржжрж┐ржХрзЗ ржЗрж╢рж╛рж░рж╛ ржХрж░рж╛, ржЖржЩрзНржЧрзБрж▓, ржЖржк, ржкржпрж╝рзЗржирзНржЯ, ржмрзНржпрж╛ржХрж╣рзНржпрж╛ржирзНржб, рж╢рж░рзАрж░, рж╕рзВржЪржХ, рж╣рж╛ржд
ЁЯЦХ => ЁЯЦХ, ржЖржЩрзНржЧрзБрж▓, ржоржзрзНржпржорж╛, рж╢рж░рзАрж░, рж╣рж╛ржд
ЁЯСЗ => ЁЯСЗ, ржЖржЩрзБрж▓ ржжрж┐ржпрж╝рзЗ ржирзАржЪрзЗрж░ ржжрж┐ржХрзЗ ржЗрж╢рж╛рж░рж╛ ржХрж░рж╛, ржЖржЩрзНржЧрзБрж▓, ржЗржиржбрзЗржХрзНрж╕, ржирж┐ржЪрзЗрж░ ржжрж┐ржХрзЗ, ржкржпрж╝рзЗржирзНржЯ, ржмрзНржпрж╛ржХрж╣рзНржпрж╛ржирзНржб, рж╢рж░рзАрж░, рж╣рж╛ржд
тЬМ => тЬМ, ржЬржпрж╝, ржнрж┐ ржЖржХрж╛рж░, рж╢рж░рзАрж░, рж╣рж╛ржд, рж╣рж╛рждрзЗ ржЬржпрж╝рзЗрж░ ржЪрж┐рж╣рзНржи ржХрж░рж╛
ЁЯдЮ => ЁЯдЮ, ржЖржЩрзНржЧрзБрж▓, ржЖрж╢рж╛ ржХрж░рж┐, ржЖрж╢рж╛ ржХрж░рж┐ ржпрзЗржи рж╣ржпрж╝, ржнрж╛ржЧрзНржп
ЁЯЦЦ => ЁЯЦЦ, ржЖржХрж╛рж░ ржЗржЩрзНржЧрж┐ржд, ржЖржЩрзНржЧрзБрж▓, ржнрж╛рж▓ржХрж╛ржи, ржнрзНржпрж╛рж▓ржХрж╛ржи рж╕рзНржпрж╛рж▓рзБржЯ, рж╢рж░рзАрж░, рж╣рж╛ржд
ЁЯдШ => ЁЯдШ, ржЖржЩрзНржЧрзБрж▓, ржоржи ржорж╛рждрж╛ржи, рж╢рж░рзАрж░, рж╢рж┐ржВ, рж╣рж░рзНржг ржжрзЗржУржпрж╝рж╛рж░ ржЪрж┐рж╣рзНржи, рж╣рж╛ржд
ЁЯдЩ => ЁЯдЩ, ржХрж▓, ржлрзЛржи ржХрзЛрж░рзЛ, рж╣рж╛ржд
ЁЯЦР => ЁЯЦР, ржЖржЩрзНржЧрзБрж▓, ржЖржЩрзНржЧрзБрж▓ ржкрзНрж░рж╕рж╛рж░рж┐ржд ржХрж░рзЗ рж╣рж╛ржд рждрзЛрж▓рж╛, ржкрзНрж░рж╕рж╛рж░рж┐ржд ржХрж░рж╛, рж╢рж░рзАрж░, рж╣рж╛ржд
тЬЛ => тЬЛ, ржЕржирзБржЧрзНрж░рж╣ ржХрж░рзЗ ржерж╛ржорзБржи, рж╢рж░рзАрж░, рж╣рж╛ржд
ЁЯСМ => ЁЯСМ, ржарж┐ржХ ржЖржЫрзЗ, рж╢рж░рзАрж░, рж╣рж╛ржд
ЁЯСН => ЁЯСН, 1, ржЙрж░рзНржжрзНржзржорзБржЦрзА, ржмрзБржбрж╝рзЛ ржЖржЩрзНржЧрзБрж▓, ржнрж╛рж▓рзЛ ржХрж░рзЗржЫрзЛ, рж╢рж░рзАрж░, рж╣рж╛ржд
ЁЯСО => ЁЯСО, 1, ржирж┐ржорзНржиржорзБржЦрзА, ржмрзБржбрж╝рзЛ ржЖржЩрзНржЧрзБрж▓, ржнрж╛рж▓рзЛ ржХрж░рждрзЗ ржкрж╛рж░рзЛржирж┐, рж╢рж░рзАрж░, рж╣рж╛ржд
тЬК => тЬК, ржЖржЩрзНржЧрзБрж▓ рж╕рж╛ржоржирзЗрж░ ржжрж┐ржХрзЗ ржХрж░рзЗ ржорзБржбрж╝рзЗ рж░рж╛ржЦрж╛, ржХрж┐рж▓, ржорзБрж╖рзНржЯрж╛ржШрж╛ржд, ржорзБрж╖рзНржЯрж┐ржмржжрзНржз, рж╢рж░рзАрж░, рж╣рж╛ржд
ЁЯСК => ЁЯСК, ржХрж┐рж▓, ржШрзБржБрж╕рж┐, ржорзБрж╖рзНржЯрж╛ржШрж╛ржд, ржорзБрж╖рзНржЯрж┐ржмржжрзНржз, рж╢рж░рзАрж░, рж╣рж╛ржд
ЁЯдЫ => ЁЯдЫ, ржШрзБржБрж╖рж┐, ржмрж╛ржБржжрж┐ржХрзЗ, ржмрж╛ржБржжрж┐ржХрзЗ ржШрзБржБрж╖рж┐ ржорж╛рж░рж╛
ЁЯдЬ => ЁЯдЬ, ржШрзБржБрж╖рж┐, ржбрж╛ржиржжрж┐ржХрзЗ, ржбрж╛ржиржжрж┐ржХрзЗ ржШржБрж╖рж┐ ржорж╛рж░рж╛
ЁЯдЪ => ЁЯдЪ, рж╣рж╛ржд рждрзЛрж▓рж╛, рж╣рж╛рждрзЗрж░ ржкрзЗржЫржи ржжрж┐ржХ
ЁЯСЛ => ЁЯСЛ, ржжрзЛрж▓рж╛ржирзЛ, ржирж╛ржбрж╝рж╛ржирзЛ, рж╢рж░рзАрж░, рж╣рж╛ржд, рж╣рж╛ржд ржирж╛ржбрж╝рж╛ржирзЛ
ЁЯдЯ => ЁЯдЯ, ржнрж╛рж▓ржмрж╛рж╕рж╛, ржнрж╛рж▓ржмрж╛рж╕рж╛рж░ ржЗржЩрзНржЧрж┐ржд, рж╣рж╛ржд
тЬН => тЬН, рж▓рзЗржЦрж╛, рж▓рзЗржЦрж╛рж░ рж╣рж╛ржд, рж╢рж░рзАрж░, рж╣рж╛ржд
ЁЯСП => ЁЯСП, рж╢рж░рзАрж░, рж╣рж╛ржд, рж╣рж╛ржд ржЬрзЛржбрж╝ ржХрж░рзЗ рждрж╛рж▓рж┐ ржмрж╛ржЬрж╛ржирзЛ, рж╣рж╛рждрждрж╛рж▓рж┐
ЁЯСР => ЁЯСР, ржЦрзЛрж▓рж╛, ржЦрзЛрж▓рж╛ рж╣рж╛ржд, рж╢рж░рзАрж░, рж╣рж╛ржд
ЁЯЩМ => ЁЯЩМ, ржЕржЩрзНржЧржнржЩрзНржЧрж┐, ржЖржиржирзНржж ржзрзНржмржирж┐ ржХрж░рж╛, ржЙрждрзНржерж┐ржд, ржЙржжржпрж╛ржкржи ржХрж░рж╛, ржмрзНржпржХрзНрждрж┐ рж╣рж╛ржд рждрзБрж▓рзЗ ржЖржЫрзЗ, рж╢рж░рзАрж░, рж╣рж╛ржд
ЁЯд▓ => ЁЯд▓, ржкрзНрж░рж╛рж░рзНржержирж╛, рж╣рж╛рждрзЗрж░ рждрж╛рж▓рзБ ржПржХрж╕рж╛ржерзЗ ржУржкрж░рзЗрж░ ржжрж┐ржХрзЗ
ЁЯЩП => ЁЯЩП, ржЕржЩрзНржЧржнржЩрзНржЧрж┐, ржЕржирзБржЧрзНрж░рж╣ ржХрж░рзЗ, ржЬрж╛ржирждрзЗ ржЪрж╛ржУржпрж╝рж╛, ржзржирзНржпржмрж╛ржж, ржиржорж╕рзНржХрж╛рж░, ржнрж╛ржБржЬ ржХрж░рж╛, ржорж╛ржерж╛ ржиржд, рж╢рж░рзАрж░, рж╣рж╛ржд
ЁЯдЭ => ЁЯдЭ, ржХрж░ржорж░рзНржжржи, ржорж┐ржЯ ржХрж░рж╛, рж░рж╛ржЬрж┐, рж╣рж╛ржд, рж╣рж╛ржд ржорзЗрж▓рж╛ржирзЛ
ЁЯТЕ => ЁЯТЕ, ржиржЦ, ржирзЗрж▓ ржкрж▓рж┐рж╢, ржкрж╛рж▓рж┐рж╢, ржкрзНрж░рж╕рж╛ржзржирзА, ржорзНржпрж╛ржирж┐ржХрж┐ржЙрж░, ржпрждрзНржи, рж╢рж░рзАрж░
ЁЯСВ => ЁЯСВ, ржХрж╛ржи, рж╢рж░рзАрж░
ЁЯСГ => ЁЯСГ, ржирж╛ржХ, рж╢рж░рзАрж░
ЁЯСг => ЁЯСг, ржЫрж╛ржк, ржкрж╛ржпрж╝рзЗрж░ ржЫрж╛ржк, ржкрзЛрж╢рж╛ржХ, рж╢рж░рзАрж░
ЁЯСА => ЁЯСА, ржЪрзЛржЦ, ржЪрзЛржЦ ржЧрзБрж▓рж┐, ржорзБржЦ
ЁЯСБ => ЁЯСБ, ржЪрзЛржЦ, рж╢рж░рзАрж░
ЁЯСБтАНЁЯЧи => ЁЯСБтАНЁЯЧи, ржЪрзЛржЦ, ржЪрзЛржЦрзЗрж░ ржорждржи рж╕рзНржкрж┐ржЪ ржмрж╛ржмрж▓, рж╕рж╛ржХрзНрж╖рзА, рж╕рзНржкрж┐ржЪ ржмрж╛ржмрж▓
ЁЯза => ЁЯза, ржмрзБржжрзНржзрж┐ржорж╛ржи, ржорж╕рзНрждрж┐рж╖рзНржХ
ЁЯСЕ => ЁЯСЕ, ржЬрж┐ржн, рж╢рж░рзАрж░
ЁЯСД => ЁЯСД, ржарзЛржЯ, ржорзБржЦ
ЁЯТЛ => ЁЯТЛ, ржЪрзБржорзНржмржи, ржЪрзБржорзНржмржирзЗрж░ ржЪрж┐рж╣рзНржи, ржарзЛржЯ
ЁЯТШ => ЁЯТШ, ржХрж┐ржЙржкрж┐ржб, рждрзАрж░, рждрзАрж░ ржмрж┐ржжрзНржз рж╣рж╛рж░рзНржЯ
тЭд => тЭд, рж▓рж╛рж▓ рж╣рж╛рж░рзНржЯ, рж╣рзГржжржпрж╝
ЁЯТУ => ЁЯТУ, рж╕рзНржкржирзНржжржирж╢рзАрж▓, рж╕рзНржкржирзНржжрж┐ржд, рж╕рзНржкржирзНржжрж┐ржд рж╣рзГржжржпрж╝, рж╣рзГржжрж╕рзНржкржирзНржжржи
ЁЯТФ => ЁЯТФ, ржнрж╛ржЩрж╛, ржнрж╛ржЩрзНржЧрж╛ рж╣рж╛рж░рзНржЯ, ржнрзЗржЩрзЗ ржпрж╛ржУржпрж╝рж╛, рж╣рж╛рж░рзНржЯ
ЁЯТХ => ЁЯТХ, ржжрзБржЯрж┐ рж╣рж╛рж░рзНржЯ, ржнрж╛рж▓ржмрж╛рж╕рж╛, рж╣рзГржжржпрж╝
ЁЯТЦ => ЁЯТЦ, ржЙрждрзНрждрзЗржЬрж┐ржд, ржЬрзНржмрж▓ржЬрзНржмрж▓рзЗ рж╣рж╛рж░рзНржЯ, ржЭржХржоржХ ржХрж░рж╛, рж╣рзГржжржпрж╝
ЁЯТЧ => ЁЯТЧ, ржЙрждрзНрждрзЗржЬрж┐ржд, ржХрзНрж░ржоржмрж░рзНржзржорж╛ржи, ржмрж░рзНржзржирж╢рзАрж▓ рж╣рж╛рж░рзНржЯ, рж╕рзНржирж╛ржпрж╝рзБржмрзИржХрж▓рзНржп, рж╣рзГржжржпрж╝, рж╣рзГржжржпрж╝ ржзрзНржмржирж┐
ЁЯТЩ => ЁЯТЩ, ржирзАрж▓, ржирзАрж▓ рж╣рж╛рж░рзНржЯ, рж╣рзГржжржпрж╝
ЁЯТЪ => ЁЯТЪ, рж╕ржмрзБржЬ, рж╕ржмрзБржЬ рж╣рж╛рж░рзНржЯ, рж╣рзГржжржпрж╝
ЁЯТЫ => ЁЯТЫ, рж╣рж▓рзБржж, рж╣рж▓рзБржж рж╣рж╛рж░рзНржЯ, рж╣рж╛рж░рзНржЯ
ЁЯзб => ЁЯзб, ржХржорж▓рж╛, ржХржорж▓рж╛ рж╣рж╛рж░рзНржЯ
ЁЯТЬ => ЁЯТЬ, ржмрзЗржЧрзБржирж┐ рж╣рж╛рж░рзНржЯ, ржмрзЗржЧрзБржирзА, рж╣рж╛рж░рзНржЯ
ЁЯЦд => ЁЯЦд, ржХрж╛рж▓рзЛ, ржХрж╛рж▓рзЛ рж╣рж╛рж░рзНржЯ, ржжрзБрж╖рзНржЯ, ржмрж╛ржЬрзЗ, рж╣рж╛рж░рзНржЯ
ЁЯТЭ => ЁЯТЭ, ржлрж┐рждрж╛, ржнрзНржпрж╛рж▓рзЗржирзНржЯрж╛ржЗржи, рж░рж┐ржмржи ржмрж╛ржБржзрж╛ рж╣рж╛рж░рзНржЯ, рж╣рж╛рж░рзНржЯ
ЁЯТЮ => ЁЯТЮ, ржШрзБрж░ржкрж╛ржХ, ржШрзВрж░рзНржгржорж╛ржи рж╣рж╛рж░рзНржЯ, рж╣рзГржжржпрж╝
ЁЯТЯ => ЁЯТЯ, рж╣рж╛рж░рзНржЯ рж╕ржЬрзНржЬрж╛, рж╣рзГржжржпрж╝
тЭг => тЭг, ржЪрж┐рж╣рзНржи, ржмрж┐рж╕рзНржоржпрж╝ржмрзЛржзржХ, ржнрж╛рж░рзА рж╣рж╛рж░рзНржЯрзЗрж░ ржЖржХрж╛рж░рзЗрж░ ржмрж┐рж╕рзНржоржпрж╝рж╕рзВржЪржХ ржЪрж┐рж╣рзНржирзЗрж░ ржоржд ржЧржпрж╝ржирж╛, ржпрждрж┐ржЪрж┐рж╣рзНржи, рж╣рзГржжржпрж╝
ЁЯТМ => ЁЯТМ, ржЪрж┐ржарж┐, ржкрзНрж░рзЗржорзЗрж░ ржЪрж┐ржарж┐, ржнрж╛рж▓ржмрж╛рж╕рж╛, ржорзЗрж▓, рж░рзЛржорж╛ржирзНрж╕, рж╣рзГржжржпрж╝
ЁЯТд => ЁЯТд, ржХржорж┐ржХ, ржШрзБржо ржкрж╛ржЪрзНржЫрзЗ, ржШрзБржоржирзНржд ржЕржмрж╕рзНржерж╛
ЁЯТв => ЁЯТв, ржХржорж┐ржХ, ржХрзНрж░рзБржжрзНржз, ржХрзНрж░рзЛржзрзЗрж░ ржкрзНрж░рждрзАржХ, ржХрзНрж╖рж┐ржкрзНржд
ЁЯТг => ЁЯТг, ржХржорж┐ржХ, ржмрзЛржорж╛
ЁЯТе => ЁЯТе, ржХржорж┐ржХ, ржмрзБржо ржХрж░рзЗ рж╢ржмрзНржж рж╣ржУржпрж╝рж╛, рж╕ржВржШрж░рзНрж╖
ЁЯТж => ЁЯТж, ржХржорж┐ржХ, ржШрж░рзНржорж╛ржХрзНржд ржЕржмрж╕рзНржерж╛, ржШрж╛ржорзЗрж░ ржлрзЛржБржЯрж╛, ржЬрж▓рзЗрж░ ржлрзЛржЯрж╛
ЁЯТи => ЁЯТи, ржЙржжрзНржпржорзА, ржХржорж┐ржХ, ржжрзМржбрж╝рж░ржд, рж╣рж╛ржирж╛рж╣рж╛ржирж┐
ЁЯТл => ЁЯТл, ржХржорж┐ржХ, рждрж╛рж░рж╛, рж╣рждржмрзБржжрзНржзрж┐
ЁЯТм => ЁЯТм, ржХржорж┐ржХ, ржбрж╛ржпрж╝рж╛рж▓ржЧ, ржмржХрзНрждржмрзНржпрзЗрж░ ржмрзЗрж▓рзБржи, ржмржХрзНрждрзГрждрж╛, ржмрзБржжрзНржмрзБржж, ржмрзЗрж▓рзБржи
ЁЯЧи => ЁЯЧи, ржХржерж╛ ржмрж▓рж╛рж░ ржмрж╛ржоржжрж┐ржХрзЗрж░ ржмрзБржжржмрзБржж, ржбрж╛ржпрж╝рж╛рж▓ржЧ, ржмржХрзНрждрзГрждрж╛
ЁЯЧп => ЁЯЧп, ржХрзНрж░рзБржжрзНржз, ржХрзНрж╖рж┐ржкрзНржд, ржбрж╛ржирзЗ ржХрзНрж░рзЛржзрзЗрж░ ржмрзБржжрзНржмрзБржж, ржмрзБржжрзНржмрзБржж, ржмрзЗрж▓рзБржи
ЁЯТн => ЁЯТн, ржХржорж┐ржХ, ржержЯ ржмрзЗрж▓рзБржи, ржмрзБржжрзНржмрзБржж, ржмрзЗрж▓рзБржи, ржнрж╛ржмржирж╛
ЁЯХ│ => ЁЯХ│, ржЧрж░рзНржд
ЁЯСУ => ЁЯСУ, ржЪрж╢ржорж╛, ржЪрзЛржЦ, ржЪрзЛржЦрзЗ ржкрж░рж╛рж░, ржкрзЛрж╢рж╛ржХ
ЁЯХ╢ => ЁЯХ╢, ржЧрж╛ржврж╝, ржЪрж╢ржорж╛, ржЪрзЛржЦ, рж╕рж╛ржиржЧрзНрж▓рж╛рж╕
ЁЯСФ => ЁЯСФ, ржЧрж▓рж╛рж░ ржЯрж╛ржЗ, ржкрзЛрж╢рж╛ржХ
ЁЯСХ => ЁЯСХ, ржЯрж┐ рж╢рж╛рж░рзНржЯ, ржЯрж┐-рж╢рж╛рж░рзНржЯ, ржкрзЛрж╢рж╛ржХ, рж╢рж╛рж░рзНржЯ
ЁЯСЦ => ЁЯСЦ, ржЬрж┐ржирж╕, ржЯрзНрж░рж╛ржЙржЬрж╛рж░рзНрж╕, ржкрзЛрж╢рж╛ржХ, ржкрзНржпрж╛ржирзНржЯ
ЁЯзг => ЁЯзг, ржЧрж▓рж╛ржмржирзНржз, рж╕рзНржХрж╛рж░рзНржл
ЁЯзд => ЁЯзд, ржжрж╕рзНрждрж╛ржирж╛, рж╣рж╛ржд
ЁЯзе => ЁЯзе, ржХрзЛржЯ, ржЬрзНржпрж╛ржХрзЗржЯ
ЁЯзж => ЁЯзж, ржорзЛржЬрж╛, рж╕рзНржЯржХрж┐ржВ
ЁЯСЧ => ЁЯСЧ, ржЬрж╛ржорж╛, ржлрзНрж░ржХ
ЁЯСШ => ЁЯСШ, ржХрж┐ржорзЛржирзЛ, ржкрзЛрж╢рж╛ржХ
ЁЯСЩ => ЁЯСЩ, ржкрзЛрж╢рж╛ржХ, ржмрж┐ржХрж┐ржирж┐, рж╕рж╛ржБрждрж╛рж░ ржХрж╛ржЯрж╛
ЁЯСЪ => ЁЯСЪ, ржирж╛рж░рзА, ржкрзЛрж╢рж╛ржХ, ржорж╣рж┐рж▓рж╛ржжрзЗрж░ ржкрзЛрж╢рж╛ржХ
ЁЯСЫ => ЁЯСЫ, ржкрж╛рж░рзНрж╕, ржкрзЛрж╢рж╛ржХ, ржорзБржжрзНрж░рж╛
ЁЯСЬ => ЁЯСЬ, ржкрж╛рж░рзНрж╕, ржкрзЛрж╢рж╛ржХ, ржмрзНржпрж╛ржЧ, рж╣рж╛рждрзЗрж░ ржмрзНржпрж╛ржЧ
ЁЯСЭ => ЁЯСЭ, ржкрж╛ржЙржЪ, ржкрзЛрж╢рж╛ржХ, ржмрзНржпрж╛ржЧ
ЁЯЫН => ЁЯЫН, ржХрзЗржирж╛ржХрж╛ржЯрж╛, ржХрзЗржирж╛ржХрж╛ржЯрж╛рж░ ржмрзНржпрж╛ржЧ, ржмрзНржпрж╛ржЧ, рж╣рзЛржЯрзЗрж▓
ЁЯОТ => ЁЯОТ, ржмрзНржпрж╛ржЧ, рж╕рзНржХрзБрж▓, рж╕рзНржХрзБрж▓рзЗрж░ ржкрж┐ржарзЗ ржирзЗржУржпрж╝рж╛рж░ ржмрзНржпрж╛ржЧ, рж╕рзНржХрзБрж▓рзЗрж░ ржмрзНржпрж╛ржЧ
ЁЯСЮ => ЁЯСЮ, ржЬрзБрждрзЛ, ржкрзБрж░рзБрж╖, ржкрзБрж░рзБрж╖рзЗрж░ ржЬрзБрждрзЛ, ржкрзЛрж╢рж╛ржХ
ЁЯСЯ => ЁЯСЯ, ржХрзНрж░рзАржбрж╝рж╛ржмрж┐рж╖ржпрж╝ржХ, ржЬрзБрждрзЛ, ржжрзМржбрж╝рж╛ржирзЛрж░ ржЬрзБрждрзЛ, ржкрзЛрж╢рж╛ржХ, рж╕рзНржирзАржХрж╛рж░
ЁЯСа => ЁЯСа, ржЙржЪрзБ рж╣рж┐рж▓рзЗрж░ ржЬрзБрждрзЛ, ржЧрзЛржбрж╝рж╛рж▓рж┐, ржЬрзБрждрзЛ, ржирж╛рж░рзА, ржкрзЛрж╢рж╛ржХ
ЁЯСб => ЁЯСб, ржЬрзБрждрзЛ, ржирж╛рж░рзА, ржкрзЛрж╢рж╛ржХ, ржорж╣рж┐рж▓рж╛ржжрзЗрж░ ржЪржЯрж┐, рж╕рзНржпрж╛ржирзНржбрзЗрж▓
ЁЯСв => ЁЯСв, ржЬрзБрждрзЛ, ржирж╛рж░рзА, ржкрзЛрж╢рж╛ржХ, ржмрзБржЯ, ржорж╣рж┐рж▓рж╛ржжрзЗрж░ ржмрзБржЯ
ЁЯСС => ЁЯСС, ржкрзЛрж╢рж╛ржХ, ржорзБржХрзБржЯ, рж░рж╛ржЬрж╛, рж░рж╛ржгрзА
ЁЯСТ => ЁЯСТ, ржЯрзБржкрж┐, ржирж╛рж░рзА, ржкрзЛрж╢рж╛ржХ, ржорж╣рж┐рж▓рж╛ржжрзЗрж░ ржЯрзБржкрж┐
ЁЯОй => ЁЯОй, ржЙржБржЪрзБ ржЯрзБржкрж┐, ржЯржк, ржЯрзБржкрж┐, ржкрзЛрж╢рж╛ржХ
ЁЯОУ => ЁЯОУ, ржЙржжржпрж╛ржкржи, ржЧрзНрж░рж╛ржЬрзБржпрж╝рзЗрж╢ржирзЗрж░ ржЯрзБржкрж┐, ржЫрж┐ржкрж┐, ржЯрзБржкрж┐, ржкрзЛрж╢рж╛ржХ, рж╕рзНржирж╛рждржХ рж╣ржУржпрж╝рж╛
ЁЯзв => ЁЯзв, ржмрж┐рж▓рзНржб ржЯрзБржкрж┐, ржмрзЗрж╕ржмрж▓рзЗрж░ ржЯрзБржкрж┐
тЫС => тЫС, ржЙржжрзНржзрж╛рж░ржХрж╛рж░рзА ржХрж░рзНржорзАрж░ рж╣рзЗрж▓ржорзЗржЯ, ржХрзНрж░рж╕, ржЪрж┐ржХрж┐рзОрж╕рж╛, ржЯрзБржкрж┐, ржорзБржЦ, рж╣рзЗрж▓ржорзЗржЯ
ЁЯУ┐ => ЁЯУ┐, ржЬржкржорж╛рж▓рж╛, ржЬржкрзЗрж░ ржорж╛рж▓рж╛, ржзрж░рзНржо, ржирзЗржХрж▓рзЗрж╕, ржкрзЛрж╢рж╛ржХ, ржкрзНрж░рж╛рж░рзНржержирж╛
ЁЯТД => ЁЯТД, ржкрзНрж░рж╕рж╛ржзржирзА, ржорзЗржХржЖржк, рж▓рж┐ржкрж╕рзНржЯрж┐ржХ
ЁЯТН => ЁЯТН, ржЖржВржЯрж┐, рж░рзЛржорж╛ржирзНрж╕, рж╣рзАрж░рж╛
ЁЯТО => ЁЯТО, ржоржгрж┐, рж░рждрзНржи, рж░рждрзНржи ржкрж╛ржерж░, рж░рзЛржорж╛ржирзНрж╕, рж╣рзАрж░рж╛
ЁЯР╡ => ЁЯР╡, ржмрж╛ржБржжрж░рзЗрж░ ржорзБржЦ, ржмрж╛ржирж░, ржорзБржЦ
ЁЯРТ => ЁЯРТ, ржмрж╛ржБржжрж░, ржмрж╛ржирж░
ЁЯжН => ЁЯжН, ржЧрзЛрж░рж┐рж▓рж╛, ржкрж╢рзБ
ЁЯР╢ => ЁЯР╢, ржХрзБржХрзБрж░, ржХрзБржХрзБрж░рзЗрж░ ржорзБржЦ, ржкрзЛрж╖рзНржп, ржорзБржЦ
ЁЯРХ => ЁЯРХ, ржХрзБржХрзБрж░, ржкрзЛрж╖рзНржп
ЁЯРй => ЁЯРй, ржХрзБржХрзБрж░, ржкрзБржбрж▓
ЁЯР║ => ЁЯР║, ржирзЗржХржбрж╝рзЗ, ржорзБржЦ, рж╢рзЗржпрж╝рж╛рж▓рзЗрж░ ржорзБржЦ
ЁЯжК => ЁЯжК, ржкрж╢рзБ, ржорзБржЦрзЛ, рж╢рзЗржпрж╝рж╛рж▓
ЁЯР▒ => ЁЯР▒, ржкрзЛрж╖рзНржп, ржмрж┐ржбрж╝рж╛рж▓, ржмрж┐ржбрж╝рж╛рж▓рзЗрж░ ржорзБржЦ, ржорзБржЦ
ЁЯРИ => ЁЯРИ, ржкрзЛрж╖рзНржп, ржмрж┐ржбрж╝рж╛рж▓
ЁЯжБ => ЁЯжБ, ржорзБржЦ, рж░рж╛рж╢рж┐ржЪржХрзНрж░, рж╕рж┐ржВрж╣, рж╕рж┐ржВрж╣рж░рж╛рж╢рж┐, рж╕рж┐ржВрж╣рзЗрж░ ржорзБржЦ
ЁЯРп => ЁЯРп, ржмрж╛ржШ, ржмрж╛ржШрзЗрж░ ржорзБржЦ, ржорзБржЦ
ЁЯРЕ => ЁЯРЕ, ржмрж╛ржШ
ЁЯРЖ => ЁЯРЖ, ржЪрж┐рждрж╛ржмрж╛ржШ
ЁЯР┤ => ЁЯР┤, ржШрзЛржбрж╝рж╛, ржШрзЛржбрж╝рж╛рж░ ржорзБржЦ, ржорзБржЦ
ЁЯРО => ЁЯРО, ржШрзЛржбрж╝ржжрзМржбрж╝, ржШрзЛржбрж╝ржжрзМржбрж╝рзЗрж░ ржШрзЛржбрж╝рж╛, ржШрзЛржбрж╝рж╛
ЁЯжД => ЁЯжД, ржЗржЙржирж┐ржХрж░рзНржи, ржЗржЙржирж┐ржХрж░рзНржирзЗрж░ ржорзБржЦ, ржорзБржЦ
ЁЯжУ => ЁЯжУ, ржЬрзЗржмрзНрж░рж╛, ржбрзЛрж░рж╛ржХрж╛ржЯрж╛
ЁЯжМ => ЁЯжМ, ржЩрж░рж┐ржг, ржкрж╢рзБ, рж╣рж░рж┐ржг
ЁЯРо => ЁЯРо, ржЧрж░рзБ, ржЧрж░рзБрж░ ржорзБржЦ, ржорзБржЦ
ЁЯРВ => ЁЯРВ, ржмрзГрж╖рж░рж╛рж╢рж┐, рж░рж╛рж╢рж┐ржЪржХрзНрж░, рж╖рж╛ржбрж╝, рж╖рж╛ржБржбрж╝
ЁЯРГ => ЁЯРГ, ржЬрж▓, ржЬрж▓рж╣рж╕рзНрждрзА, ржорж╣рж┐рж╖
ЁЯРД => ЁЯРД, ржЧрж░рзБ
ЁЯР╖ => ЁЯР╖, ржорзБржЦ, рж╢рзВржХрж░, рж╢рзВржХрж░рзЗрж░ ржорзБржЦ
ЁЯРЦ => ЁЯРЦ, рж╢рзВржХрж░, рж╢рзВржХрж░рзА
ЁЯРЧ => ЁЯРЧ, ржмржирзНржп рж╢рзВржХрж░, рж╢рзВржХрж░
ЁЯР╜ => ЁЯР╜, ржирж╛ржХ, ржорзБржЦ, рж╢рзВржХрж░, рж╢рзВржХрж░рзЗрж░ ржирж╛ржХ
ЁЯРП => ЁЯРП, ржнрзЗржбрж╝рж╛, ржорзЗрж╖, рж░рж╛ржоржЫрж╛ржЧрж▓, рж░рж╛рж╢рж┐ржЪржХрзНрж░
ЁЯРС => ЁЯРС, ржнрзЗржбрж╝рж╛, ржнрзЗржбрж╝рзА
ЁЯРР => ЁЯРР, ржЫрж╛ржЧрж▓, ржоржХрж░ рж░рж╛рж╢рж┐, рж░рж╛рж╢рж┐ржЪржХрзНрж░
ЁЯРк => ЁЯРк, ржЖрж░ржмрзА ржЙржЯ, ржЙржЯ, ржХрзБржБржЬ
ЁЯРл => ЁЯРл, ржЙржЯ, ржХрзБржБржЬ, ржжрзБржЗ ржХрзБржБржЬржмрж┐рж╢рж┐рж╖рзНржЯ ржЙржЯ
ЁЯжТ => ЁЯжТ, ржЬрж┐рж░рж╛ржл, ржбржЯ ржбржЯ
ЁЯРШ => ЁЯРШ, рж╣рж╛рждрж┐
ЁЯжП => ЁЯжП, ржЧржгрзНржбрж╛рж░, ржкрж╢рзБ
ЁЯРн => ЁЯРн, ржЗржБржжрзБрж░рзЗрж░ ржорзБржЦ, ржирзЗржВржЯрж┐ ржЗржБржжрзБрж░, ржорзБржЦ
ЁЯРБ => ЁЯРБ, ржЗржБржжрзБрж░, ржирзЗржВржЯрж┐ ржЗржБржжрзБрж░
ЁЯРА => ЁЯРА, ржЗржБржжрзБрж░, ржЗржБржжрзБрж░,ржорж╛ржЙрж╕
ЁЯР╣ => ЁЯР╣, ржзрзЗржбрж╝рзЗ ржЗржБржжрзБрж░рзЗрж░ ржорждрзЛ ржкрзНрж░рж╛ржгрзА, ржкрзЛрж╖рзНржп, ржорзБржЦ, рж╣рзНржпрж╛ржорж╕рзНржЯрж╛рж░рзЗрж░ ржорзБржЦ
ЁЯР░ => ЁЯР░, ржЦрж░ржЧрзЛрж╢, ржЦрж░ржЧрзЛрж╕рзЗрж░ ржорзБржЦ, ржкрзЛрж╖рзНржп, ржорзБржЦ
ЁЯРЗ => ЁЯРЗ, ржЦрж░ржЧрзЛрж╢, ржЦрж░ржЧрзЛрж╕, ржкрзЛрж╖рзНржп
ЁЯР┐ => ЁЯР┐, ржХрж╛ржаржмрж┐ржбрж╝рж╛рж▓, ржХрж╛ржаржмрж┐ржбрж╝рж╛рж▓рж┐
ЁЯжФ => ЁЯжФ, ржХржирзНржЯржХржоржпрж╝, рж╢ржЬрж╛рж░рзБ
ЁЯжЗ => ЁЯжЗ, ржкрж╢рзБ, ржмрж╛ржжрзБрж░, ржмрж╛ржБржжрзБрж░, рж░ржХрзНрждржЪрзЛрж╖рж╛
ЁЯР╗ => ЁЯР╗, ржнрж▓рзНрж▓рзБржХрзЗрж░ ржорзБржЦ, ржнрж╛рж▓рзБржХ, ржорзБржЦ
ЁЯРи => ЁЯРи, ржХрзЛржпрж╝рж╛рж▓рж╛, ржнрж╛рж▓рзБржХ
ЁЯР╝ => ЁЯР╝, ржкрж╛ржирзНржбрж╛, ржкрж╛ржирзНржбрж╛рж░ ржорзБржЦ, ржорзБржЦ
ЁЯР╛ => ЁЯР╛, ржЫрж╛ржк, ржерж╛ржмрж╛, ржк ржкрзНрж░рж┐ржирзНржЯ, ржкрж╛
ЁЯжГ => ЁЯжГ, ржЯрж╛рж░рзНржХрж┐ ,ржЯрж╛рж░рзНржХрж┐ ржорзЛрж░ржЧ, ржЯрж╛рж░рзНржХрж┐ ржорзБрж░ржЧрзА
ЁЯРФ => ЁЯРФ, ржЪрж┐ржХрзЗржи, ржорзБрж░ржЧрж┐
ЁЯРУ => ЁЯРУ, ржорзЛрж░ржЧ
ЁЯРг => ЁЯРг, ржмрж╛ржЪрзНржЪрж╛, ржмрж╛ржЪрзНржЪрж╛ ржорзБрж░ржЧрж┐, рж╣рзНржпрж╛ржЪрж┐ржВ, рж╣рзНржпрж╛ржЪрж┐ржВ ржЪрж┐ржХ
ЁЯРд => ЁЯРд, ржмрж╛ржЪрзНржЪрж╛, ржмрж╛ржЪрзНржЪрж╛ ржорзБрж░ржЧрж┐, ржмрзЗржмрж┐ ржЪрж┐ржХ
ЁЯРе => ЁЯРе, ржмрж╛ржЪрзНржЪрж╛, ржмрж╛ржЪрзНржЪрж╛ ржорзБрж░ржЧрж┐, рж╕рж╛ржоржирзЗрж░ ржжрж┐ржХрзЗ ржорзБржЦ ржХрж░рж╛ ржмрзЗржмрж┐ ржЪрж┐ржХ
ЁЯРж => ЁЯРж, ржкрж╛ржЦрж┐
ЁЯРз => ЁЯРз, ржкрзЗржВржЧрзБржЗржи, ржкрзЗржЩрзНржЧрзБржЗржи
ЁЯХК => ЁЯХК, ржУржбрж╝рж╛, ржкрж╛ржЦрж┐, ржкрж╛ржпрж╝рж░рж╛, рж╢рж╛ржирзНрждрж┐
ЁЯжЕ => ЁЯжЕ, ржИржЧрж▓, ржкрж╛ржЦрж┐
ЁЯжЖ => ЁЯжЖ, ржкрж╛ржЦрж┐, рж╣рж╛ржБрж╕
ЁЯжЙ => ЁЯжЙ, ржкрж╛ржЦрж┐, ржкрзЗржБржЪрж╛, ржмрж┐ржЬрзНржЮ
ЁЯР╕ => ЁЯР╕, ржмрзНржпрж╛ржВ, ржмрзНржпрж╛ржЩрзЗрж░ ржорзБржЦ, ржорзБржЦ
ЁЯРК => ЁЯРК, ржХрзБржорж┐рж░
ЁЯРв => ЁЯРв, ржХржЪрзНржЫржк
ЁЯжО => ЁЯжО, ржЯрж┐ржХржЯрж┐ржХрж┐, рж╕рж░рзАрж╕рзГржк
ЁЯРН => ЁЯРН, ржЕржлрж┐ржЙржХрж╛рж╕, ржмрж╛рж╣ржХ, рж░рж╛рж╢рж┐ржЪржХрзНрж░, рж╕рж╛ржк
ЁЯР▓ => ЁЯР▓, ржбрзНрж░рж╛ржЧржи, ржбрзНрж░рж╛ржЧржирзЗрж░ ржорзБржЦ, ржорзБржЦ, рж░рзВржкржХржерж╛
ЁЯРЙ => ЁЯРЙ, ржбрзНрж░рж╛ржЧржи, рж░рзВржкржХржерж╛
ЁЯжХ => ЁЯжХ, ржбрж┐ржкрзНрж▓рзЛржХрж╛рж╕, ржмрзНрж░ржирзНржЯрзЛрж╕рж░рж╛рж╕, ржмрзНрж░рж╛ржХрж┐ржпрж╝рзЛрж╕рж░рж╛рж╕, рж╕рж░рзЛржкржб
ЁЯжЦ => ЁЯжЦ, ржЯрж┐-рж░рзЗржХрзНрж╕, ржЯрж┐рж░рж╛ржирзЛрж╕рж░рж╛рж╕ рж░рзЗржХрзНрж╕
ЁЯР│ => ЁЯР│, ржЙрзОрж╕рж╛рж░рж┐ржд рждрж┐ржорж┐, ржЬрж▓ ржЫрзЛржбрж╝рж╛, рждрж┐ржорж┐, ржорзБржЦ
ЁЯРЛ => ЁЯРЛ, рждрж┐ржорж┐
ЁЯРм => ЁЯРм, ржбрж▓ржлрж┐ржи, рж╕рж╛ржорзБржжрзНрж░рж┐ржХ ржкрзНрж░рж╛ржгрзАрж░ рж╕рж╛ржБрждрж╛рж░
ЁЯРЯ => ЁЯРЯ, ржорж╛ржЫ, ржорзАржи, рж░рж╛рж╢рж┐ржЪржХрзНрж░
ЁЯРа => ЁЯРа, ржХрзНрж░рж╛ржирзНрждрзАржпрж╝, ржЯрзНрж░ржкрж┐ржХрзНржпрж╛рж▓ ржорж╛ржЫ, ржорж╛ржЫ
ЁЯРб => ЁЯРб, ржмрзНрж▓рзЛржлрж┐рж╢, ржорж╛ржЫ
ЁЯжИ => ЁЯжИ, ржорж╛ржЫ, рж╣рж╛ржЩрзНржЧрж░
ЁЯРЩ => ЁЯРЩ, ржЕржХрзНржЯрзЛржкрж╛рж╕
ЁЯРЪ => ЁЯРЪ, ржЭрж┐ржирзБржХ, ржЭрж┐ржирзБржХрзЗрж░ ржЦрзЛрж▓рж╕, рж╕рж░рзНржкрж┐рж▓
ЁЯжА => ЁЯжА, ржХрж░рзНржХржЯ, ржХрж╛ржБржХржбрж╝рж╛, рж░рж╛рж╢рж┐ржЪржХрзНрж░
ЁЯжР => ЁЯжР, ржЦрж╛ржмрж╛рж░, ржЦрзЛрж▓рж╛ржУржпрж╝рж╛рж▓рж╛ ржорж╛ржЫ, ржЪрж┐ржВржбрж╝рж┐, ржЫрзЛржЯ
ЁЯжС => ЁЯжС, ржЦрж╛ржмрж╛рж░, рж╢ржорзНржмрзБржХ ржХрзЛржорж▓рж╛ржЩрзНржЧ ржЬржирзНрждрзБ, рж╕рзНржХрзБржЗржб
ЁЯРМ => ЁЯРМ, рж╢рж╛ржорзБржХ
ЁЯжЛ => ЁЯжЛ, ржкрждржЩрзНржЧ, ржкрзНрж░ржЬрж╛ржкрждрж┐, рж╕рзБржирзНржжрж░
ЁЯРЫ => ЁЯРЫ, ржХрзНрж╖рзБржжрзНрж░ ржХрзАржЯ, ржкрзЛржХрж╛
ЁЯРЬ => ЁЯРЬ, ржкрж┐ржкржбрж╝рзЗ, ржкрзЛржХрж╛
ЁЯРЭ => ЁЯРЭ, ржкрзЛржХрж╛, ржорзМржорж╛ржЫрж┐
ЁЯРЮ => ЁЯРЮ, ржЧрзБржмрж░рзЗ ржкрзЛржХрж╛, ржкрзЛржХрж╛, рж▓рзЗржбрж┐ ржмрзНржпрж╛ржЯрзЗрж▓, рж▓рзЗржбрж┐ржмрж╛ржЧ, рж▓рзЗржбрж┐ржмрж╛рж░рзНржб
ЁЯжЧ => ЁЯжЧ, ржЭрж┐ржБржЭрж┐ ржкрзЛржХрж╛, ржлржбрж╝рж┐ржВ
ЁЯХ╖ => ЁЯХ╖, ржкрзЛржХрж╛, ржорж╛ржХржбрж╝рж╕рж╛
ЁЯХ╕ => ЁЯХ╕, ржЬрж╛рж▓, ржорж╛ржХржбрж╝рж╕рж╛, ржорж╛ржХржбрж╝рж╕рж╛рж░ ржЬрж╛рж▓
ЁЯжВ => ЁЯжВ, ржмрзГрж╢рзНржЪрж┐ржХ рж░рж╛рж╢рж┐, ржмрзГрж╢рзНржЪрж┐ржХрж░рж╛рж╢рж┐, рж░рж╛рж╢рж┐ржЪржХрзНрж░
ЁЯТР => ЁЯТР, ржЧрж╛ржЫ, ржлрзБрж▓, ржлрзБрж▓рзЗрж░ рждрзЛржбрж╝рж╛, рж░рзЛржорж╛ржирзНрж╕
ЁЯМ╕ => ЁЯМ╕, ржЧрж╛ржЫ, ржЪрзЗрж░рж┐, ржЪрзЗрж░рж┐ ржмрзНрж▓ржЬржо, ржлрзБрж▓, ржмрж┐ржХрж╢рж┐ржд рж╣ржУржпрж╝рж╛
ЁЯТо => ЁЯТо, ржлрзБрж▓, рж╕рж╛ржжрж╛ ржлрзБрж▓
ЁЯП╡ => ЁЯП╡, ржЧрж╛ржЫ, ржлрж┐рждрзЗ ржжрж┐ржпрж╝рзЗ рждрзИрж░рж┐ ржЧрзЛрж▓рж╛ржкрзЗрж░ ржмрзНржпрж╛ржЬ
ЁЯМ╣ => ЁЯМ╣, ржЧрж╛ржЫ, ржЧрзЛрж▓рж╛ржк, ржлрзБрж▓
ЁЯеА => ЁЯеА, ржирзЗрждрж╛ржирзЛ, ржирзЗрждрж╛ржирзЛ ржлрзБрж▓, ржлрзБрж▓
ЁЯМ║ => ЁЯМ║, ржЧрж╛ржЫ, ржЬржмрж╛, ржлрзБрж▓
ЁЯМ╗ => ЁЯМ╗, ржЧрж╛ржЫ, ржлрзБрж▓, рж╕рзВрж░рзНржп, рж╕рзВрж░рзНржпржорзБржЦрж┐
ЁЯМ╝ => ЁЯМ╝, ржЧрж╛ржЫ, ржлрзБрж▓
ЁЯМ╖ => ЁЯМ╖, ржЧрж╛ржЫ, ржЯрж┐ржЙрж▓рж┐ржк, ржлрзБрж▓
ЁЯМ▒ => ЁЯМ▒, ржЧрж╛ржЫ, ржЪрж╛рж░рж╛ ржЧрж╛ржЫ, ржиржмрзАржи
ЁЯМ▓ => ЁЯМ▓, ржЧрж╛ржЫ, ржЪрж┐рж░рж╣рж░рж┐рзО
ЁЯМ│ => ЁЯМ│, ржЧрж╛ржЫ, ржЫрж╛ржБржЯрж╛, ржкрж░рзНржгржорзЛржЪрзА, ржкрж░рзНржгржорзЛржЪрзА ржЧрж╛ржЫ
ЁЯМ┤ => ЁЯМ┤, ржЧрж╛ржЫ, ржкрж╛ржо, ржкрж╛ржо ржЧрж╛ржЫ
ЁЯМ╡ => ЁЯМ╡, ржХрзНржпрж╛ржХржЯрж╛рж╕, ржЧрж╛ржЫ
ЁЯМ╛ => ЁЯМ╛, ржЧрж╛ржЫ, ржзрж╛ржи, ржзрж╛ржирзЗрж░ ржЖржБржЯрж┐, рж╢рзАрж╖
ЁЯМ┐ => ЁЯМ┐, ржФрж╖ржзрж┐, ржЧрж╛ржЫ, ржкрж╛рждрж╛
тШШ => тШШ, ржЧрж╛ржЫ, рж╢рж╛ржорж░ржХ
ЁЯНА => ЁЯНА, 4, ржХрзНрж▓рзЛржнрж╛рж░, ржЧрж╛ржЫ, ржЪрж╛рж░, ржЪрж╛рж░ржЯрж┐ ржкрж╛рждрж╛рж░ рждрзНрж░рж┐ржкрждрзНрж░ржмрж┐рж╢рзЗрж╖, ржкрж╛рждрж╛
ЁЯНБ => ЁЯНБ, ржЧрж╛ржЫ, ржкрждржирж╢рзАрж▓, ржкрж╛рждрж╛, ржорзНржпрж╛ржкрзЗрж▓, ржорзНржпрж╛ржкрзЗрж▓ ржкрж╛рждрж╛
ЁЯНВ => ЁЯНВ, ржЧрж╛ржЫ, ржкрждржирж╢рзАрж▓, ржкрж╛рждрж╛, ржкрж╛рждрж╛ ржкржбрж╝рж╛
ЁЯНГ => ЁЯНГ, ржЧрж╛ржЫ, ржЭрж╛ржкржЯрж╛ржирж┐, ржкрж╛рждрж╛, ржмрж╛рждрж╛рж╕рзЗрж░ ржоржзрзНржпрзЗ ржкрж╛рждрж╛ ржУржбрж╝рж╛, рж╣рж╛ржУржпрж╝рж╛, рж╣рж╛рж▓рзНржХрж╛ рж╣рж╛ржУржпрж╝рж╛
ЁЯНЗ => ЁЯНЗ, ржЖржЩрзБрж░, ржЖржЩрзНржЧрзБрж░, ржЧрж╛ржЫ, ржлрж▓
ЁЯНИ => ЁЯНИ, ржЧрж╛ржЫ, ржлрж▓, ржлрзБржЯрж┐
ЁЯНЙ => ЁЯНЙ, ржЧрж╛ржЫ, рждрж░ржорзБржЬ, ржлрж▓
ЁЯНК => ЁЯНК, ржХржорж▓рж╛, ржХржорж▓рж╛ рж▓рзЗржмрзБ, ржЧрж╛ржЫ, ржлрж▓
ЁЯНЛ => ЁЯНЛ, ржЧрж╛ржЫ, ржлрж▓, рж▓рзЗржмрзБ
ЁЯНМ => ЁЯНМ, ржХрж▓рж╛, ржЧрж╛ржЫ, ржлрж▓
ЁЯНН => ЁЯНН, ржЖржирж╛рж░рж╕, ржЧрж╛ржЫ, ржлрж▓
ЁЯНО => ЁЯНО, ржЖржкрзЗрж▓, ржЧрж╛ржЫ, ржлрж▓, рж▓рж╛рж▓, рж▓рж╛рж▓ ржЖржкрзЗрж▓
ЁЯНП => ЁЯНП, ржЖржкрзЗрж▓, ржЧрж╛ржЫ, ржлрж▓, рж╕ржмрзБржЬ, рж╕ржмрзБржЬ ржЖржкрзЗрж▓
ЁЯНР => ЁЯНР, ржЧрж╛ржЫ, ржирж╛рж╢ржкрж╛рждрж┐, ржлрж▓
ЁЯНС => ЁЯНС, ржЧрж╛ржЫ, ржкрж┐ржЪ, ржлрж▓
ЁЯНТ => ЁЯНТ, ржЧрж╛ржЫ, ржЪрзЗрж░рж┐, ржлрж▓
ЁЯНУ => ЁЯНУ, ржЧрж╛ржЫ, ржлрж▓, ржмрзЗрж░рж┐, рж╕рзНржЯрзНрж░ржмрзЗрж░рж┐
ЁЯеЭ => ЁЯеЭ, ржХрж┐ржЙржЗ, ржХрж┐ржЙржЗ ржлрж▓, ржЦрж╛ржмрж╛рж░, ржлрж▓
ЁЯНЕ => ЁЯНЕ, ржЧрж╛ржЫ, ржЯржорзЗржЯрзЛ, рж╕ржмрзНржЬрж┐
ЁЯее => ЁЯее, ржирж╛рж░ржХрзЗрж▓, ржкрж╛ржо, ржкрж┐ржирж╛ ржХрзЛрж▓рж╛ржбрж╛
ЁЯеС => ЁЯеС, ржЕрзНржпрж╛ржнрзЛржХрзНржпрж╛ржбрзЛ, ржЦрж╛ржмрж╛рж░, ржлрж▓
ЁЯНЖ => ЁЯНЖ, ржЧрж╛ржЫ, ржмрзЗржЧрзБржи, рж╕ржмрзНржЬрж┐
ЁЯеФ => ЁЯеФ, ржЖрж▓рзБ, ржЦрж╛ржмрж╛рж░, рж╕ржмржЬрж┐
ЁЯеХ => ЁЯеХ, ржЦрж╛ржмрж╛рж░, ржЧрж╛ржЬрж░, рж╕ржмржЬрж┐
ЁЯМ╜ => ЁЯМ╜, ржЧрж╛ржЫ, ржзрж╛ржБржзрж╛, ржнрзБржЯрзНржЯрж╛, ржнрзБржЯрзНржЯрж╛рж░ ржХрж╛ржи, ржнрзВржЯрзНржЯрж╛, рж╢рзАрж╖
ЁЯМ╢ => ЁЯМ╢, ржЧрж░ржо, ржЧрж╛ржЫ, ржЭрж╛рж▓ рж▓ржЩрзНржХрж╛, рж▓ржЩрзНржХрж╛
ЁЯеТ => ЁЯеТ, ржЖржЪрж╛рж░, ржЦрж╛ржмрж╛рж░, рж╢рж╕рж╛, рж╕ржмржЬрж┐
ЁЯеж => ЁЯеж, ржУржпрж╝рж╛ржЗрж▓рзНржб ржХрзНржпрж╛ржмрзЗржЬ, ржлрзБрж▓ржХржкрж┐
ЁЯНД => ЁЯНД, ржЧрж╛ржЫ, ржорж╛рж╢рж░рзБржо
ЁЯеЬ => ЁЯеЬ, ржЦрж╛ржмрж╛рж░, ржЪрж┐ржирж╛ржмрж╛ржжрж╛ржо, ржмрж╛ржжрж╛ржо, рж╕ржмржЬрж┐
ЁЯМ░ => ЁЯМ░, ржПржХржкрзНрж░ржХрж╛рж░рзЗрж░ ржмрж╛ржжрж╛ржо, ржЧрж╛ржЫ
ЁЯНЮ => ЁЯНЮ, ржкрж╛ржЙрж░рзБржЯрж┐, ржкрж╛ржБрж░рзБржЯрж┐
ЁЯеР => ЁЯеР, ржХрзНрж░рж┐рж╕рзЗржирзНржЯ рж░рзЛрж▓, ржХрзНрж░рзЛрж╕рж┐ржпрж╝рж╛ржирзНржЯ, ржХрзНрж░рзЛрж╕рзЗржирзНржЯ, ржЦрж╛ржмрж╛рж░, ржкрж╛ржЙрж░рзБржЯрж┐, ржлрж░рж╛рж╕рж┐
ЁЯеЦ => ЁЯеЦ, ржЦрж╛ржмрж╛рж░, ржкрж╛ржЙрж░рзБржЯрж┐, ржлрж░рж╛рж╕рж┐, ржмрзНржпрж╛ржЧрж╛ржЯ, ржмрзНржпрж╛ржЧрзНржпрж╛ржЯ
ЁЯеи => ЁЯеи, ржкрзНрж░рзЗржЯржЬрзЗрж▓, ржорзЛржбрж╝рж╛ржирзЛ
ЁЯеЮ => ЁЯеЮ, ржХрзНрж░рзЗржк, ржЦрж╛ржмрж╛рж░, ржкрзНржпрж╛ржиржХрзЗржХ, рж╣ржЯржХрзЗржХ
ЁЯзА => ЁЯзА, ржЪрж┐ржЬ, ржЪрзАржЬ ржУржпрж╝рзЗржЬ
ЁЯНЦ => ЁЯНЦ, ржорж╛ржВрж╕, рж╣рж╛ржбрж╝, рж╣рж╛ржбрж╝рзЗрж░ ржЙржкрж░ ржорж╛ржВрж╕
ЁЯНЧ => ЁЯНЧ, ржЪрж┐ржХрзЗржи, ржкрзЛрж▓рзНржЯрзНрж░рж┐, ржкрзЛрж▓рзНржЯрзНрж░рж┐рж░ ржкрж╛, рж▓рзЗржЧ, рж╣рж╛ржбрж╝
ЁЯей => ЁЯей, ржЪржк, ржкрж░рзНржХржЪржк, ржорж╛ржВрж╢рзЗрж░ ржЯрзБржХрж░рзЛ, рж▓рзНржпрж╛ржорзНржмржЪржк, рж╕рзНржЯрж┐ржХ
ЁЯеУ => ЁЯеУ, ржЦрж╛ржмрж╛рж░, ржмрзЗржХржи, ржорж╛ржВрж╢
ЁЯНФ => ЁЯНФ, ржмрж╛рж░рзНржЧрж╛рж░, рж╣рзНржпрж╛ржоржмрж╛рж░рзНржЧрж╛рж░
ЁЯНЯ => ЁЯНЯ, ржлрзНрж░рж╛ржЗ, ржлрзНрж░рзЗржЮрзНржЪ, ржлрзНрж░рзЗржЮрзНржЪ ржлрзНрж░рж╛ржЗ
ЁЯНХ => ЁЯНХ, ржЪрж┐ржЬ, ржкрж┐ржЬрж╛, ржлрж╛рж▓рж┐
ЁЯМн => ЁЯМн, ржлрзНрж░рзНржпрж╛ржЩрзНржХржлрж╛рж░рзНржЯрж╛рж░, рж╕рж╕рзЗржЬ, рж╣ржЯ ржбржЧ
ЁЯек => ЁЯек, рж░рзБржЯрж┐, рж╕рзНржпрж╛ржирзНржбржЙржЗржЪ
ЁЯМо => ЁЯМо, ржЯрзНржпрж╛ржХрзЛ, ржорзЗржХрзНрж╕рж┐ржХрж╛ржи
ЁЯМп => ЁЯМп, ржмрзБрж░рж┐ржЯрзЛ, ржорзЗржХрзНрж╕рж┐ржХрж╛ржи
ЁЯеЩ => ЁЯеЩ, ржХрж╛ржмрж╛ржм, ржЦрж╛ржмрж╛рж░, ржЧрж╛ржЗрж░рзЛ, ржЪрзЗржкрзНржЯрж╛рж░рзБржЯрж┐, ржкрзБрж░ ржнрж░рж╛ ржкрж╛ржЙрж░рзБржЯрж┐, ржкрзБрж░ржнрж░рж╛, ржлрж▓рж╛ржлрзЗрж▓
ЁЯеЪ => ЁЯеЪ, ржЦрж╛ржмрж╛рж░, ржбрж┐ржо
ЁЯН│ => ЁЯН│, ржЪрж╛ржЯрзБ, ржбрж┐ржо, ржнрж╛ржЬрж╛, рж░рж╛ржирзНржирж╛ ржХрж░рж╛
ЁЯеШ => ЁЯеШ, ржХржбрж╝рж╛, ржХржбрж╝рж╛ржЗ, ржХрзНржпрж╛рж╕рж░рзЛрж▓, ржЦрж╛ржмрж╛рж░, ржкрзЗржи
ЁЯН▓ => ЁЯН▓, ржЦрж╛ржжрзНржпрзЗрж░ ржкрж╛рждрзНрж░, ржкрж╛рждрзНрж░, рж╕рзНржЯрзНржпрзБ
ЁЯег => ЁЯег, ржХрж░рзНржгржлрзНрж▓рзЗржХрзНрж╕, ржкрзЛрж░рж┐ржЬ, ржмрж╛ржЯрж┐ ржЖрж░ ржЪрж╛ржоржЪ, ржмрзНрж░рзЗржХржлрж╛рж╕рзНржЯ
ЁЯеЧ => ЁЯеЧ, ржЦрж╛ржмрж╛рж░, ржЧрзНрж░рж┐ржи, ржЧрзНрж░рж┐ржи рж╕рзНржпрж╛рж▓рж╛ржж, рж╕рзНржпрж╛рж▓рж╛ржж
ЁЯН┐ => ЁЯН┐, ржкржкржХрж░рзНржг
ЁЯел => ЁЯел, ржХрзНржпрж╛ржи, ржХрзНржпрж╛ржиржЬрж╛ржд ржЦрж╛ржжрзНржп
ЁЯН▒ => ЁЯН▒, ржмрж╛ржХрзНрж╕, ржмрзЗржирзНржЯрзЛ, ржмрзЗржирзНрждрзЛ ржмрж╛ржХрзНрж╕
ЁЯНШ => ЁЯНШ, ржХрзНрж░рзНржпрж╛ржХрж╛рж░, ржЪрж╛рж▓, ржЪрж╛рж▓рзЗрж░ ржкрж╛ржкржбрж╝
ЁЯНЩ => ЁЯНЩ, ржЪрж╛рж▓, ржЬрж╛ржкрж╛ржирж┐, ржмрж▓, ржнрж╛рждрзЗрж░ ржмрж▓
ЁЯНЪ => ЁЯНЪ, ржЪрж╛рж▓, рж░рж╛ржирзНржирж╛ ржХрж░рж╛, рж░рж╛ржирзНржирж╛ ржХрж░рж╛ ржнрж╛ржд
ЁЯНЫ => ЁЯНЫ, ржЪрж╛рж▓, рждрж░ржХрж╛рж░рж┐, ржнрж╛ржд рждрж░ржХрж╛рж░рж┐
ЁЯНЬ => ЁЯНЬ, ржирзБржбрж▓, ржмрж╛ржЯрж┐, ржнрж╛ржкрж╛ржирзЛ, рж░рж╛ржорзЗржи, рж╕рзНржЯрж┐ржо ржХрж░рж╛рж░ ржмрж╛ржЯрж┐
ЁЯНЭ => ЁЯНЭ, ржкрж╛рж╕рзНрждрж╛, рж╕рзНржкрзНржпрж╛ржЧрзЗржЯрж┐
ЁЯНа => ЁЯНа, ржЖрж▓рзБ, ржорж┐рж╖рзНржЯрж┐, рж░рзЛрж╕рзНржЯ ржХрж░рж╛, рж░рзЛрж╕рзНржЯ ржХрж░рж╛ ржорж┐рж╖рзНржЯрж┐ ржЖрж▓рзБ
ЁЯНв => ЁЯНв, ржУржбрзЗржи, ржХрж╛ржарж┐, ржХрж╛ржмрж╛ржм, ржмрж┐ржжрзНржз ржХрж░рж╛, рж╕рж╛ржорзБржжрзНрж░рж┐ржХ ржЦрж╛ржмрж╛рж░
ЁЯНг => ЁЯНг, рж╕рзБрж╢рж┐
ЁЯНд => ЁЯНд, ржЧрж▓ржжрж╛ ржЪрж┐ржВржбрж╝рж┐, ржЯрзЗржорзНржкрзБрж░рж╛, ржмрж╛ржЧржжрж╛ ржЪрж┐ржВржбрж╝рж┐, ржнрж╛ржЬрж╛, ржнрж╛ржЬрж╛ ржЪрж┐ржВржбрж╝рж┐
ЁЯНе => ЁЯНе, ржХрзЗржХ, ржШрзВрж░рзНржгрж┐ржд рж╣ржУржпрж╝рж╛ ржлрж┐рж╢ ржХрзЗржХ, ржШрзЛрж░рж╛ржирзЛ, ржкрзНржпрж╛рж╕рзНржЯрзНрж░рж┐, ржорж╛ржЫ
ЁЯНб => ЁЯНб, ржХрж╛ржарж┐, ржЬрж╛ржкрж╛ржирж┐, ржбрж╛ржЩрзНржЧрзЛ, ржбрзЗржЬрж╛рж░рзНржЯ, ржмрж┐ржжрзНржз ржХрж░рж╛, ржорж┐рж╖рзНржЯрж┐
ЁЯеЯ => ЁЯеЯ, ржПржоржкрзНржпрж╛ржирзНржбрж╛, ржЧржпрж╝рзЛржЬрж╛, ржЬрж┐ржпрж╝рж╛ржпрж╝рзЛржЬрж┐, ржкржЯрж╕рзНржЯрж┐ржХрж╛рж░, ржкрж┐ржпрж╝рзЗрж░рзЛржЧрж┐, ржорзЛржорзЛ
ЁЯеа => ЁЯеа, ржкрзНрж░рзЛржлрзЗрж╕рж┐, ржлрж░ржЪрзБржи ржХрзБржХрж┐
ЁЯеб => ЁЯеб, ржУржпрж╝рзЗрж╕рзНржЯрж╛рж░ ржкрзЗрж▓, ржЦрж╛ржмрж╛рж░ ржирж┐ржпрж╝рзЗ ржпрж╛ржУржпрж╝рж╛рж░ ржмржХрзНрж╕
ЁЯНж => ЁЯНж, ржЖржЗрж╕ржХрзНрж░рж┐ржо, ржХрзНрж░рж┐ржо, ржбрзЗржЬрж╛рж░рзНржЯ, ржирж░ржо, ржмрж░ржл, ржорж┐рж╖рзНржЯрж┐, рж╕ржлрзНржЯ ржЖржЗрж╕ ржХрзНрж░рж┐ржо
ЁЯНз => ЁЯНз, ржЪрж╛ржБржЪрж╛, ржбрзЗржЬрж╛рж░рзНржЯ, ржмрж░ржл, ржорж┐рж╖рзНржЯрж┐, рж╢рзЗржнржб ржЖржЗрж╕
ЁЯНи => ЁЯНи, ржЖржЗрж╕ ржХрзНрж░рж┐ржо, ржХрзНрж░рж┐ржо, ржбрзЗржЬрж╛рж░рзНржЯ, ржмрж░ржл, ржорж┐рж╖рзНржЯрж┐
ЁЯНй => ЁЯНй, ржбрзЗржЬрж╛рж░рзНржЯ, ржбрзЛржирж╛ржЯ, ржорж┐рж╖рзНржЯрж┐
ЁЯНк => ЁЯНк, ржХрзБржХрж┐, ржбрзЗржЬрж╛рж░рзНржЯ, ржорж┐рж╖рзНржЯрж┐
ЁЯОВ => ЁЯОВ, ржЙржжржпрж╛ржкржи, ржХрзЗржХ, ржЬржирзНржоржжрж┐ржи, ржЬржирзНржоржжрж┐ржирзЗрж░ ржХрзЗржХ, ржбрзЗржЬрж╛рж░рзНржЯ, ржкрзНржпрж╛рж╕рзНржЯрзНрж░рж┐, ржорж┐рж╖рзНржЯрж┐
ЁЯН░ => ЁЯН░, ржХрзЗржХ, ржбрзЗржЬрж╛рж░рзНржЯ, ржкрзНржпрж╛рж╕рзНржЯрзНрж░рж┐, ржлрж╛рж▓рж┐, ржорж┐рж╖рзНржЯрж┐, рж╢рж░рзНржЯ ржХрзЗржХ
ЁЯез => ЁЯез, ржкрж╛ржЗ, ржкрзЗрж╕рзНржЯрзНрж░рж┐, ржлрж┐рж▓рж┐ржВ
ЁЯНл => ЁЯНл, ржЪржХрж▓рзЗржЯ, ржЪржХрж▓рзЗржЯ ржмрж╛рж░, ржбрзЗржЬрж╛рж░рзНржЯ, ржмрж╛рж░, ржорж┐рж╖рзНржЯрж┐
ЁЯНм => ЁЯНм, ржХрзНржпрж╛ржирзНржбрж┐, ржбрзЗржЬрж╛рж░рзНржЯ, ржорж┐рж╖рзНржЯрж┐
ЁЯНн => ЁЯНн, ржХрзНржпрж╛ржирзНржбрж┐, ржбрзЗржЬрж╛рж░рзНржЯ, ржорж┐рж╖рзНржЯрж┐, рж▓рж▓рж┐ржкржк
ЁЯНо => ЁЯНо, ржХрж╛рж╕рзНржЯрж╛рж░рзНржб, ржбрзЗржЬрж╛рж░рзНржЯ, ржкрзБржбрж┐ржВ, ржорж┐рж╖рзНржЯрж┐
ЁЯНп => ЁЯНп, ржкрж╛рждрзНрж░, ржоржзрзБ, ржоржзрзБрж░ ржкрж╛рждрзНрж░, ржорж┐рж╖рзНржЯрж┐
ЁЯН╝ => ЁЯН╝, ржжрзБржз, ржкрж╛ржи ржХрж░рж╛, ржмрж╛ржЪрзНржЪрж╛, ржмрзЛрждрж▓, рж╢рж┐рж╢рзБржжрзЗрж░ ржмрзЛрждрж▓
ЁЯеЫ => ЁЯеЫ, ржЧрзНрж▓рж╛рж╕, ржерж╛ржУржпрж╝рж╛, ржжрзБржз, ржжрзБржзрзЗрж░ ржЧрзНрж▓рж╛рж╕
тШХ => тШХ, ржХржлрж┐, ржЧрж░ржо, ржЧрж░ржо ржкрж╛ржирзАржпрж╝, ржЪрж╛, ржкрж╛ржи ржХрж░рж╛, ржкрж╛ржирзАржпрж╝, ржнрж╛ржкрж╛ржирзЛ
ЁЯН╡ => ЁЯН╡, ржХрж╛ржк, ржЪрж╛, ржЪрж╛ржпрж╝рзЗрж░ ржкрзЗржпрж╝рж╛рж▓рж╛, ржкрж╛ржи ржХрж░рж╛, ржкрж╛ржирзАржпрж╝, рж╣рзНржпрж╛ржирзНржбрзЗрж▓ ржЫрж╛ржбрж╝рж╛ржЗ ржЪрж╛ржпрж╝рзЗрж░ ржХрж╛ржк
ЁЯН╢ => ЁЯН╢, ржХрж╛ржк, ржкрж╛ржи ржХрж░рж╛, ржкрж╛ржирзАржпрж╝, ржмрж╛рж░, ржмрзЛрждрж▓, рж╕рзЗржЗржХ
ЁЯН╛ => ЁЯН╛, ржХрж░рзНржХ, ржкржкрж┐ржВ, ржкржкрж┐ржВ ржХрж░рзНржХрзЗрж░ рж╕рж╛ржерзЗ ржмрзЛрждрж▓, ржкрж╛ржи ржХрж░рж╛, ржмрж╛рж░, ржмрзЛрждрж▓
ЁЯН╖ => ЁЯН╖, ржУржпрж╝рж╛ржЗржи, ржЧрзНрж▓рж╛рж╕, ржкрж╛ржи ржХрж░рж╛, ржкрж╛ржирзАржпрж╝, ржмрж╛рж░, ржоржжрзЗрж░ ржЧрзНрж▓рж╛рж╕
ЁЯН╕ => ЁЯН╕, ржХржХржЯрзЗрж▓, ржХржХржЯрзЗрж▓рзЗрж░ ржЧрзНрж▓рж╛рж╕, ржЧрзНрж▓рж╛рж╕, ржкрж╛ржи ржХрж░рж╛, ржмрж╛рж░
ЁЯН╣ => ЁЯН╣, ржХрзНрж░рж╛ржирзНрждрзАржпрж╝, ржЯрзНрж░ржкрж┐ржХрзНржпрж╛рж▓ ржбрзНрж░рж┐ржЩрзНржХ, ржкрж╛ржи ржХрж░рж╛, ржмрж╛рж░
ЁЯН║ => ЁЯН║, ржкрж╛ржи ржХрж░рж╛, ржмрж╛рж░, ржмрж┐ржпрж╝рж╛рж░, ржмрж┐ржпрж╝рж╛рж░рзЗрж░ ржоржЧ, ржоржЧ
ЁЯН╗ => ЁЯН╗, ржЙрждрзНрждржо ржзрж░ржгрзЗрж░ ржмрж┐ржпрж╝рж╛рж░рзЗрж░ ржоржЧ, ржарзБржВ ржарзБржВ ржЖржУржпрж╝рж╛ржЬ ржХрж░рж╛, ржкрж╛ржи ржХрж░рж╛, ржмрж╛рж░, ржмрж┐ржпрж╝рж╛рж░, ржоржЧ
ЁЯеВ => ЁЯеВ, ржЙржжржпрж╛ржкржи, ржЦрж╛ржУржпрж╝рж╛, ржЧрзНрж▓рж╛рж╕, ржЪрж┐рж╕рж╛рж░рзНрж╕рзЗрж░ ржЬржирзНржп ржЧрзНрж▓рж╛рж╕рзЗ ржарзЛржХрж╛, ржарзБржВржарж╛ржВ
ЁЯеГ => ЁЯеГ, ржЧрзНрж▓рж╛рж╕, ржЪржУржбрж╝рж╛ ржЧрзНрж▓рж╛рж╕, ржкрж╛ржирзАржпрж╝, рж╢ржЯ, рж╣рзБржЗрж╕рзНржХрж┐
ЁЯед => ЁЯед, ржЬрзБрж╕, рж╕рзЛржбрж╛, рж╕рзНржЯрзНрж░ ржжрзЗржУржпрж╝рж╛ ржХрж╛ржк
ЁЯев => ЁЯев, ржЪржкрж╕рзНржЯрж┐ржХ, рж╣рж╛рж╢рж┐
ЁЯН╜ => ЁЯН╜, ржХрж╛ржБржЯрж╛ржЪрж╛ржоржЪ, ржЫрзБрж░рж┐, ржкрзНрж▓рзЗржЯ, ржкрзНрж▓рзЗржЯрзЗрж░ рж╕ржЩрзНржЧрзЗ ржХрж╛ржБржЯрж╛ржЪрж╛ржоржЪ ржУ ржЫрзБрж░рж┐, рж░ржирзНржзржи
ЁЯН┤ => ЁЯН┤, ржХрж╛ржБржЯрж╛ржЪрж╛ржоржЪ, ржХрж╛ржБржЯрж╛ржЪрж╛ржоржЪ ржУ ржЫрзБрж░рж┐, ржЫрзБрж░рж┐, рж░ржирзНржзржи
ЁЯеД => ЁЯеД, ржХрж╛ржБржЯрж╛ ржЪрж╛ржоржЪ, ржЪрж╛ржоржЪ
ЁЯФк => ЁЯФк, ржЕрж╕рзНрждрзНрж░, ржЫрзБрж░рж┐, рж░ржирзНржзржи, рж░рж╛ржирзНржирж╛ ржШрж░рзЗрж░ ржЫрзБрж░рж┐, рж╕рж░ржЮрзНржЬрж╛ржо, рж╣рзЛржХрзЛ
ЁЯП║ => ЁЯП║, ржЕрж╕рзНрждрзНрж░, ржЕрзНржпрж╛ржорзНржлрзЛрж░рж╛, ржХрзБржорзНржнрж░рж╛рж╢рж┐, ржЬрж╛ржЧ, ржкрж╛ржи ржХрж░рж╛, рж░ржирзНржзржи, рж░рж╛рж╢рж┐ржЪржХрзНрж░, рж╕рж░ржЮрзНржЬрж╛ржо
ЁЯМН => ЁЯМН, ржЖржлрзНрж░рж┐ржХрж╛, ржЗржЙрж░рзЛржк, ржЧрзНрж▓рзЛржм, ржЧрзНрж▓рзЛржм ржЗржЙрж░рзЛржк ржЖржлрзНрж░рж┐ржХрж╛ ржжрзЗржЦрж╛ржЪрзНржЫрзЗ, ржкрзГржерж┐ржмрзА, ржмрж┐рж╢рзНржм
ЁЯМО => ЁЯМО, ржЖржорзЗрж░рж┐ржХрж╛, ржЧрзНрж▓рзЛржм, ржЧрзНрж▓рзЛржм ржЖржорзЗрж░рж┐ржХрж╛ ржжрзЗржЦрж╛ржЪрзНржЫрзЗ, ржкрзГржерж┐ржмрзА, ржмрж┐рж╢рзНржм
ЁЯМП => ЁЯМП, ржЕрж╕рзНржЯрзНрж░рзЗрж▓рж┐ржпрж╝рж╛, ржПрж╢рж┐ржпрж╝рж╛, ржЧрзНрж▓рзЛржм, ржЧрзНрж▓рзЛржм ржПрж╢рж┐ржпрж╝рж╛-ржЕрж╕рзНржЯрзНрж░рзЗрж▓рж┐ржпрж╝рж╛ ржжрзЗржЦрж╛ржЪрзНржЫрзЗ, ржкрзГржерж┐ржмрзА, ржмрж┐рж╢рзНржм
ЁЯМР => ЁЯМР, ржЧрзНрж▓рзЛржм, ржЧрзНрж▓рзЛржмрзЗ ржорзЗрж░рж┐ржбрж┐ржпрж╝рж╛ржи, ржкрзГржерж┐ржмрзА, ржкрзГржерж┐ржмрзАрж░ ржоржзрзНржпрж░рзЗржЦрж╛, ржмрж┐рж╢рзНржм
ЁЯЧ║ => ЁЯЧ║, ржмрж┐рж╢рзНржм, ржмрж┐рж╢рзНржмрзЗрж░ ржорж╛ржиржЪрж┐рждрзНрж░, ржорж╛ржиржЪрж┐рждрзНрж░
ЁЯЧ╛ => ЁЯЧ╛, ржЬрж╛ржкрж╛ржи, ржЬрж╛ржкрж╛ржирзЗрж░ ржорзНржпрж╛ржк, ржорж╛ржиржЪрж┐рждрзНрж░
ЁЯПФ => ЁЯПФ, ржарж╛ржирзНржбрж╛, рждрзБрж╖рж╛рж░, рждрзБрж╖рж╛рж░рж╛ржмрзГржд ржкрж░рзНржмржд, ржкрж░рзНржмржд
тЫ░ => тЫ░, ржкрж░рзНржмржд, ржкрж╛рж╣рж╛ржбрж╝
ЁЯМЛ => ЁЯМЛ, ржЕржЧрзНржирзНржпрзБрзОржкрж╛ржд, ржЖржЧрзНржирзЗржпрж╝ржЧрж┐рж░рж┐, ржЖржмрж╣рж╛ржУржпрж╝рж╛, ржкрж░рзНржмржд
ЁЯЧ╗ => ЁЯЧ╗, ржкрж░рзНржмржд, ржлрзБржЬрж┐, ржорж╛ржЙржирзНржЯ ржлрзБржЬрж┐
ЁЯПХ => ЁЯПХ, рждрж╛ржмрзБ ржЦрж╛ржБржЯрж╛ржирзЛ
ЁЯПЦ => ЁЯПЦ, ржЫрж╛рждрж╛, рж╕ржорзБржжрзНрж░ рж╕рзИржХрждрзЗ ржЫрж╛рждрж╛, рж╕рзИржХржд
ЁЯПЬ => ЁЯПЬ, ржорж░рзБржнрзБржорж┐
ЁЯПЭ => ЁЯПЭ, ржжрзНржмрзАржк, ржорж░рзБржнрзВржорж┐, ржорж░рзБржнрзВржорж┐рж░ ржжрзНржмрзАржк
ЁЯПЮ => ЁЯПЮ, ржЬрж╛рждрзАржпрж╝ ржЙржжрзНржпрж╛ржи, ржкрж╛рж░рзНржХ
ЁЯПЯ => ЁЯПЯ, рж╕рзНржЯрзЗржбрж┐ржпрж╝рж╛ржо
ЁЯПЫ => ЁЯПЫ, ржХрзНрж▓рж╛рж╕рж┐ржХрзНржпрж╛рж▓, ржХрзНрж▓рж╛рж╕рж┐ржХрзНржпрж╛рж▓ ржмрж┐рж▓рзНржбрж┐ржВ, ржмрж┐рж▓рзНржбрж┐ржВ
ЁЯПЧ => ЁЯПЧ, ржирж┐рж░рзНржорж╛ржг, ржмрж┐рж▓рзНржбрж┐ржВ, ржмрж┐рж▓рзНржбрж┐ржВ ржирж┐рж░рзНржорж╛ржг
ЁЯПШ => ЁЯПШ, ржмрж╛ржбрж╝рж┐, ржмрж╛ржбрж╝рж┐ржЧрзБрж▓рж┐ рждрзИрж░рж┐ ржХрж░рж╛, ржмрж┐рж▓рзНржбрж┐ржВ
ЁЯПЩ => ЁЯПЩ, ржмрж┐рж▓рзНржбрж┐ржВ, рж╢рж╣рж░, рж╕рж┐ржЯрж┐рж╕рзНржХрзЗржк
ЁЯПЪ => ЁЯПЪ, ржкрж░рж┐рждрзНржпржХрзНржд, ржкрж░рж┐рждрзНржпржХрзНржд ржЧрзГрж╣ржирж┐рж░рзНржорж╛ржг, ржмрж╛ржбрж╝рж┐, ржмрж┐рж▓рзНржбрж┐ржВ
ЁЯПа => ЁЯПа, ржЧрзГрж╣ ржирж┐рж░рзНржорж╛ржг, ржмрж╛ржбрж╝рж┐, ржмрж┐рж▓рзНржбрж┐ржВ
ЁЯПб => ЁЯПб, ржмрж╛ржЧрж╛ржи, ржмрж╛ржЧрж╛ржи ржмрж╛ржбрж╝рж┐, ржмрж╛ржбрж╝рж┐, ржмрж┐рж▓рзНржбрж┐ржВ
ЁЯПв => ЁЯПв, ржЕржлрж┐рж╕ ржмрж┐рж▓рзНржбрж┐ржВ, ржмрж┐рж▓рзНржбрж┐ржВ
ЁЯПг => ЁЯПг, ржЬрж╛ржкрж╛ржирж┐, ржЬрж╛ржкрж╛ржирж┐ ржкрзЛрж╕рзНржЯ ржЕржлрж┐рж╕, ржкрзЛрж╕рзНржЯ, ржмрж┐рж▓рзНржбрж┐ржВ
ЁЯПд => ЁЯПд, ржЗржЙрж░рзЛржкрзАржпрж╝, ржкрзЛрж╕рзНржЯ, ржкрзЛрж╕рзНржЯ ржЕржлрж┐рж╕, ржмрж┐рж▓рзНржбрж┐ржВ
ЁЯПе => ЁЯПе, ржУрж╖рзБржз, ржбрж╛ржХрзНрждрж╛рж░, ржмрж┐рж▓рзНржбрж┐ржВ, рж╣рж╛рж╕ржкрж╛рждрж╛рж▓
ЁЯПж => ЁЯПж, ржмрж┐рж▓рзНржбрж┐ржВ, ржмрзНржпрж╛ржЩрзНржХ
ЁЯПи => ЁЯПи, ржмрж┐рж▓рзНржбрж┐ржВ, рж╣рзЛржЯрзЗрж▓
ЁЯПй => ЁЯПй, ржмрж┐рж▓рзНржбрж┐ржВ, ржнрж╛рж▓ржмрж╛рж╕рж╛, рж▓рж╛ржн рж╣рзЛржЯрзЗрж▓, рж╣рзЛржЯрзЗрж▓
ЁЯПк => ЁЯПк, ржХржиржнрзЗржирж┐ржпрж╝рж╛ржирзНрж╕ рж╕рзНржЯрзЛрж░, ржжрзЛржХрж╛ржи, ржмрж┐рж▓рзНржбрж┐ржВ, рж╕рзБржмрж┐ржзрж╛
ЁЯПл => ЁЯПл, ржмрж┐рж▓рзНржбрж┐ржВ, рж╕рзНржХрзБрж▓
ЁЯПм => ЁЯПм, ржбрж┐ржкрж╛рж░рзНржЯржоржорзЗржирзНржЯ рж╕рзНржЯрзЛрж░, ржбрж┐ржкрж╛рж░рзНржЯржорзЗржирзНржЯ, ржжрзЛржХрж╛ржи, ржмрж┐рж▓рзНржбрж┐ржВ
ЁЯПн => ЁЯПн, ржлрзНржпрж╛ржХрзНржЯрж░рж┐, ржмрж┐рж▓рзНржбрж┐ржВ
ЁЯПп => ЁЯПп, ржЬрж╛ржкрж╛ржирж┐, ржЬрж╛ржкрж╛ржирж┐ ржжрзБрж░рзНржЧ, ржжрзБрж░рзНржЧ, ржмрж┐рж▓рзНржбрж┐ржВ
ЁЯП░ => ЁЯП░, ржЗржЙрж░рзЛржкрзАржпрж╝, ржжрзБрж░рзНржЧ, ржмрж┐рж▓рзНржбрж┐ржВ
ЁЯТТ => ЁЯТТ, ржЪрзНржпрж╛ржкрзЗрж▓, ржмрж┐ржмрж╛рж╣, рж░рзЛржорж╛ржирзНрж╕
ЁЯЧ╝ => ЁЯЧ╝, ржЯрж╛ржУржпрж╝рж╛рж░, ржЯрзЛржХрж┐ржУ, ржЯрзЛржХрж┐ржУ ржЯрж╛ржУржпрж╝рж╛рж░
ЁЯЧ╜ => ЁЯЧ╜, ржорзВрж░рзНрждрж┐, рж▓рж┐ржмрж╛рж░рзНржЯрж┐, рж╕рзНржЯрзНржпрж╛ржЪрзБ ржЕржл рж▓рж┐ржмрж╛рж░рзНржЯрж┐
тЫк => тЫк, ржХрзНрж░рж╕, ржЦрзГрж╕рзНржЯрж╛ржи, ржЪрж╛рж░рзНржЪ, ржзрж░рзНржо, ржмрж┐рж▓рзНржбрж┐ржВ
ЁЯХМ => ЁЯХМ, ржЗрж╕рж▓рж╛ржо, ржзрж░рзНржо, ржорж╕ржЬрж┐ржж, ржорзБрж╕рж▓рж┐ржо
ЁЯХН => ЁЯХН, ржЗрж╣рзБржжрж┐, ржЗрж╣рзБржжрж┐ ржзрж░рзНржо, ржЗрж╣рзБржжрж┐ржжрзЗрж░ ржзрж░рзНржорж╕рзНржерж╛ржи, ржзрж░рзНржо, ржоржирзНржжрж┐рж░
тЫй => тЫй, ржзрж░рзНржо, ржоржа, рж╢рж┐ржирзНржЯрзЛ, рж╢рж┐ржирзНрждрзЛ ржоржирзНржжрж┐рж░
ЁЯХЛ => ЁЯХЛ, ржЗрж╕рж▓рж╛ржо, ржХрж╛ржмрж╛, ржзрж░рзНржо, ржорзБрж╕рж▓рж┐ржо
тЫ▓ => тЫ▓, ржлрзЛржпрж╝рж╛рж░рж╛
тЫ║ => тЫ║, рждрж╛ржмрзБ, рждрж╛ржмрзБ ржЦрж╛ржБржЯрж╛ржирзЛ
ЁЯМБ => ЁЯМБ, ржЖржмрж╣рж╛ржУржпрж╝рж╛, ржХрзБржпрж╝рж╛рж╢рж╛, ржХрзБржпрж╝рж╛рж╢рж╛ржЪрзНржЫржирзНржи
ЁЯМГ => ЁЯМГ, ржЖржмрж╣рж╛ржУржпрж╝рж╛, рждрж╛рж░рж╛, рждрж╛рж░рж╛ ржнрж░рж╛ рж░рж╛ржд, рж░рж╛ржд
ЁЯМД => ЁЯМД, ржЖржмрж╣рж╛ржУржпрж╝рж╛, ржкрж░рзНржмржд, ржкрж░рзНржмрждрзЗрж░ ржЙржкрж░ рж╕рзВрж░рзНржпрзЛржжржпрж╝, рж╕ржХрж╛рж▓, рж╕рзВрж░рзНржп, рж╕рзВрж░рзНржпрзЛржжржпрж╝
ЁЯМЕ => ЁЯМЕ, ржЖржмрж╣рж╛ржУржпрж╝рж╛, рж╕ржХрж╛рж▓, рж╕рзВрж░рзНржп, рж╕рзВрж░рзНржпрзЛржжржпрж╝
ЁЯМЖ => ЁЯМЖ, ржЖржмрж╣рж╛ржУржпрж╝рж╛, ржЧрзЛржзрзВрж▓рж┐, ржЧрзЛржзрзВрж▓рж┐рждрзЗ рж╢рж╣рж░рзЗрж░ ржжрзГрж╢рзНржп, ржмрж┐рж▓рзНржбрж┐ржВ, ржнрзВржжрзГрж╢рзНржп, рж╢рж╣рж░, рж╕ржирзНржзрзНржпрж╛, рж╕рзВрж░рзНржп, рж╕рзВрж░рзНржпрж╛рж╕рзНржд
ЁЯМЗ => ЁЯМЗ, ржЖржмрж╣рж╛ржУржпрж╝рж╛, ржЧрзЛржзрзВрж▓рж┐, ржмрж┐рж▓рзНржбрж┐ржВ, рж╕рзВрж░рзНржп, рж╕рзВрж░рзНржпрж╛рж╕рзНржд
ЁЯМЙ => ЁЯМЙ, ржЖржмрж╣рж╛ржУржпрж╝рж╛, рж░рж╛ржд, рж░рж╛рждрзЗ рж╕рзЗрждрзБ, рж╕рзЗрждрзБ
тЩи => тЩи, ржЙрж╖рзНржг ржкрзНрж░рж╕рзНрж░ржмржг, ржЧрж░ржо, ржкрзНрж░рж╕рзНрж░ржмржг, ржнрж╛ржкрж╛ржирзЛ
ЁЯММ => ЁЯММ, ржЖржХрж╛рж╢ржЧржЩрзНржЧрж╛, ржЖржмрж╣рж╛ржУржпрж╝рж╛, ржорж╣рж╛ржХрж╛рж╢
ЁЯОа => ЁЯОа, ржШрзЛржбрж╝рж╛, ржирж╛ржЧрж░ржжрзЛрж▓ржирж╛, ржирж╛ржЧрж░ржжрзЛрж▓ржирж╛ ржШрзЛржбрж╝рж╛
ЁЯОб => ЁЯОб, ржЪрж╛ржХрж╛, ржЪрж┐рждрзНрждржмрж┐ржирзЛржжржи ржкрж╛рж░рзНржХ, ржлрзЗрж░рж┐рж╕, ржмржбрж╝рзЛ ржирж╛ржЧрж░ржжрзЛрж▓рж╛
ЁЯОв => ЁЯОв, ржХрзЛрж╕рзНржЯрж╛рж░, ржЪрж┐рждрзНрждржмрж┐ржирзЛржжржи ржкрж╛рж░рзНржХ, рж░рзЛрж▓рж╛рж░, рж░рзЛрж▓рж╛рж░ ржХрзЛрж╕рзНржЯрж╛рж░
ЁЯТИ => ЁЯТИ, ржЪрзБрж▓ ржХрж╛ржЯрж╛, ржирж╛ржкрж┐ржд, ржирж╛ржкрж┐рждрзЗрж░ ржкрзЛрж▓, ржкрзЛрж▓
ЁЯОк => ЁЯОк, рждрж╛ржБржмрзБ, рж╕рж╛рж░рзНржХрж╛рж╕, рж╕рж╛рж░рзНржХрж╛рж╕рзЗрж░ рждрж╛ржмрзБ
ЁЯОн => ЁЯОн, ржХрж▓рж╛, ржХрж▓рж╛ рж╕ржорзНржкрж╛ржжржи, ржерж┐ржпрж╝рзЗржЯрж╛рж░, ржкрж╛рж░ржлрж░рзНржо ржХрж░рж╛, ржорзБржЦрзЛрж╢
ЁЯЦ╝ => ЁЯЦ╝, ржХрж▓рж╛, ржЫржмрж┐, ржкрзЗржирзНржЯрж┐ржВ, ржлрзНрж░рзЗржо, ржлрзНрж░рзЗржорзЗрж░ рж╕рж╛ржерзЗ ржЫржмрж┐, ржорж┐ржЙржЬрж┐ржпрж╝рж╛ржо
ЁЯОи => ЁЯОи, ржХрж▓рж╛, ржкрзЗржирзНржЯрж┐ржВ, ржкрзНржпрж╛рж▓рзЗржЯ, ржорж┐ржЙржЬрж┐ржпрж╝рж╛ржо, рж╢рж┐рж▓рзНржкрзА ржкрзНржпрж╛рж▓рзЗржЯ
ЁЯО░ => ЁЯО░, ржЦрзЗрж▓рж╛, рж╕рзНрж▓ржЯ, рж╕рзНрж▓ржЯ ржорзЗрж╢рж┐ржи
ЁЯЪВ => ЁЯЪВ, ржЗржЮрзНржЬрж┐ржи, ржЯрзНрж░рзЗржи, ржмрж╛рж╖рзНржк, ржпрж╛ржиржмрж╛рж╣ржи, рж░рзЗрж▓ржУржпрж╝рзЗ, рж▓рзЛржХрзЛржорзЛржЯрж┐ржн
ЁЯЪГ => ЁЯЪГ, ржЯрзНрж░рж▓рж┐ржмрж╛рж╕, ржЯрзНрж░рж╛ржо, ржЯрзНрж░рзЗржи, ржмрзИржжрзНржпрзБрждрж┐ржХ, ржорзЛржЯрж░ржЧрж╛ржбрж╝рж┐, ржпрж╛ржиржмрж╛рж╣ржи, рж░рзЗрж▓ржУржпрж╝рзЗ, рж░рзЗрж▓ржУржпрж╝рзЗрж░ ржЧрж╛ржбрж╝рж┐
ЁЯЪД => ЁЯЪД, ржЙржЪрзНржЪ-ржЧрждрж┐рж░ ржЯрзНрж░рзЗржи, ржЧрждрж┐, ржЯрзНрж░рзЗржи, ржпрж╛ржиржмрж╛рж╣ржи, рж░рзЗрж▓ржУржпрж╝рзЗ, рж╢рж┐ржиржХрж╛ржирж╕рзЗржи
ЁЯЪЕ => ЁЯЪЕ, ржЧрждрж┐, ржЯрзНрж░рзЗржи, ржмрзБрж▓рзЗржЯ, ржмрзБрж▓рзЗржЯ ржирж╛ржо ржпрзБржХрзНржд ржЙржЪрзНржЪ-ржЧрждрж┐рж░ ржЯрзНрж░рзЗржи, ржпрж╛ржиржмрж╛рж╣ржи, рж░рзЗрж▓ржУржпрж╝рзЗ, рж╢рж┐ржиржХрж╛ржирж╕рзЗржи
ЁЯЪЖ => ЁЯЪЖ, ржЯрзНрж░рзЗржи, ржпрж╛ржиржмрж╛рж╣ржи, рж░рзЗрж▓ржУржпрж╝рзЗ
ЁЯЪЗ => ЁЯЪЗ, ржорзЗржЯрзНрж░рзЛ, ржпрж╛ржиржмрж╛рж╣ржи, рж╕рж╛ржмржУржпрж╝рзЗ
ЁЯЪИ => ЁЯЪИ, ржпрж╛ржиржмрж╛рж╣ржи, рж░рзЗрж▓ржУржпрж╝рзЗ, рж░рзЗрж▓рзЗрж░ рж▓рж╛ржЗржЯ
ЁЯЪЙ => ЁЯЪЙ, ржЯрзНрж░рзЗржи, ржпрж╛ржиржмрж╛рж╣ржи, рж░рзЗрж▓ржУржпрж╝рзЗ, рж╕рзНржЯрзЗрж╢ржи
ЁЯЪК => ЁЯЪК, ржЯрзНрж░рж▓рж┐ржмрж╛рж╕, ржЯрзНрж░рж╛ржо, ржпрж╛ржиржмрж╛рж╣ржи
ЁЯЪЭ => ЁЯЪЭ, ржорзЛржирзЛрж░рзЗрж▓, ржпрж╛ржиржмрж╛рж╣ржи
ЁЯЪЮ => ЁЯЪЮ, ржкрж░рзНржмржд, ржкрж░рзНржмрждрзЗрж░ рж░рзЗрж▓ржУржпрж╝рзЗ, ржорзЛржЯрж░ржЧрж╛ржбрж╝рж┐, ржпрж╛ржиржмрж╛рж╣ржи, рж░рзЗрж▓ржУржпрж╝рзЗ
ЁЯЪЛ => ЁЯЪЛ, ржЯрзНрж░рж▓рж┐ржмрж╛рж╕, ржЯрзНрж░рж╛ржо, ржЯрзНрж░рж╛ржо ржЧрж╛ржбрж╝рж┐, ржорзЛржЯрж░ржЧрж╛ржбрж╝рж┐, ржпрж╛ржиржмрж╛рж╣ржи
ЁЯЪМ => ЁЯЪМ, ржмрж╛рж╕, ржпрж╛ржиржмрж╛рж╣ржи
ЁЯЪН => ЁЯЪН, ржЕржЧрзНрж░рж╕рж░ржорж╛ржи, ржЕржЧрзНрж░рж╕рж░ржорж╛ржи ржмрж╛рж╕, ржмрж╛рж╕, ржпрж╛ржиржмрж╛рж╣ржи
ЁЯЪО => ЁЯЪО, ржЯрзНрж░рж▓рж┐, ржЯрзНрж░рж▓рж┐ ржмрж╛рж╕, ржЯрзНрж░рж╛ржо, ржмрж╛рж╕, ржпрж╛ржиржмрж╛рж╣ржи
ЁЯЪР => ЁЯЪР, ржмрж╛рж╕, ржорж┐ржирж┐ржмрж╛рж╕, ржпрж╛ржиржмрж╛рж╣ржи
ЁЯЪС => ЁЯЪС, ржЕрзНржпрж╛ржорзНржмрзБрж▓рзЗржирзНрж╕, ржпрж╛ржиржмрж╛рж╣ржи
ЁЯЪТ => ЁЯЪТ, ржЖржЧрзБржи, ржЖржЧрзБржирзЗрж░ ржЗржЮрзНржЬрж┐ржи, ржЗржЮрзНржЬрж┐ржи, ржЯрзНрж░рж╛ржХ, ржпрж╛ржиржмрж╛рж╣ржи
ЁЯЪУ => ЁЯЪУ, ржЯрж╣рж▓ржжрж╛рж░рзА, ржкрзБрж▓рж┐рж╢, ржкрзБрж▓рж┐рж╢рзЗрж░ ржЧрж╛ржбрж╝рж┐, ржорзЛржЯрж░ржЧрж╛ржбрж╝рж┐, ржпрж╛ржиржмрж╛рж╣ржи
ЁЯЪФ => ЁЯЪФ, ржЕржЧрзНрж░рж╕рж░ржорж╛ржи, ржЕржЧрзНрж░рж╕рж░ржорж╛ржи ржкрзБрж▓рж┐рж╢рзЗрж░ ржЧрж╛ржбрж╝рж┐, ржкрзБрж▓рж┐рж╢, ржорзЛржЯрж░ржЧрж╛ржбрж╝рж┐, ржпрж╛ржиржмрж╛рж╣ржи
ЁЯЪХ => ЁЯЪХ, ржЯрзНржпрж╛ржХрзНрж╕рж┐, ржпрж╛ржиржмрж╛рж╣ржи
ЁЯЪЦ => ЁЯЪЦ, ржЕржЧрзНрж░рж╕рж░ржорж╛ржи, ржЕржЧрзНрж░рж╕рж░ржорж╛ржи ржЯрзНржпрж╛ржХрзНрж╕рж┐, ржЯрзНржпрж╛ржХрзНрж╕рж┐, ржпрж╛ржиржмрж╛рж╣ржи
ЁЯЪЧ => ЁЯЪЧ, ржЕржЯрзЛржорзЛржмрж╛ржЗрж▓, ржЧрж╛ржбрж╝рж┐, ржпрж╛ржиржмрж╛рж╣ржи
ЁЯЪШ => ЁЯЪШ, ржЕржЧрзНрж░рж╕рж░ржорж╛ржи, ржЕржЧрзНрж░рж╕рж░ржорж╛ржи ржЕржЯрзЛржорзЛржмрж╛ржЗрж▓, ржЕржЯрзЛржорзЛржмрж╛ржЗрж▓, ржорзЛржЯрж░ржЧрж╛ржбрж╝рж┐, ржпрж╛ржиржмрж╛рж╣ржи
ЁЯЪЩ => ЁЯЪЩ, ржЖрж░ржнрж┐, ржмрж┐ржирзЛржжржиржорзВрж▓ржХ, ржмрж┐ржирзЛржжржиржорзВрж▓ржХ ржпрж╛ржиржмрж╛рж╣ржи, ржпрж╛ржиржмрж╛рж╣ржи
ЁЯЪЪ => ЁЯЪЪ, ржЯрзНрж░рж╛ржХ, ржпрж╛ржиржмрж╛рж╣ржи, рж╕рж░ржмрж░рж╛рж╣, рж╕рж░ржмрж░рж╛рж╣рзЗрж░ ржЯрзНрж░рзНржпрж╛ржХ
ЁЯЪЫ => ЁЯЪЫ, ржЖрж░рзНржЯрж┐ржХрзБрж▓рзЗржЯ рж▓рж░рж┐, ржЯрзНрж░рж╛ржХ, ржпрж╛ржиржмрж╛рж╣ржи, рж▓рж░рж┐, рж╕рзЗржорж┐
ЁЯЪЬ => ЁЯЪЬ, ржЯрзНрж░рзНржпрж╛ржХрзНржЯрж░, ржпрж╛ржиржмрж╛рж╣ржи
ЁЯЪ▓ => ЁЯЪ▓, ржмрж╛ржЗржХ, ржмрж╛ржЗрж╕рж╛ржЗржХрзЗрж▓, ржпрж╛ржиржмрж╛рж╣ржи
ЁЯЫ┤ => ЁЯЫ┤, ржХрж┐ржХ, ржХрж┐ржХ рж╕рзНржХрзБржЯрж╛рж░, рж╕рзНржХрзБржЯрж╛рж░
ЁЯЫ╡ => ЁЯЫ╡, ржоржЯрж░, ржорзЛржЯрж░ рж╕рзНржХрзБржЯрж╛рж░, рж╕рзНржХрзБржЯрж╛рж░
ЁЯЪП => ЁЯЪП, ржерж╛ржорж╛, ржмрж╛рж╕, ржмрж╛рж╕ рж╕рзНржЯржк, ржмрж╛рж╕рзНржЯрзЗрж░ рж╕рзНржЯржк
ЁЯЫг => ЁЯЫг, ржорзЛржЯрж░ ржУржпрж╝рзЗ, рж░рж╛рж╕рзНрждрж╛, рж╣рж╛ржЗржУржпрж╝рзЗ
ЁЯЫд => ЁЯЫд, ржЯрзНрж░рзЗржи, рж░рзЗрж▓ржУржпрж╝рзЗ, рж░рзЗрж▓ржУржпрж╝рзЗ ржЯрзНрж░рзНржпрж╛ржХ
тЫ╜ => тЫ╜, ржЧрзНржпрж╛рж╕, ржЬрзНржмрж╛рж▓рж╛ржирзА, ржЬрзНржмрж╛рж▓рж╛ржирзА ржкрж╛ржорзНржк, ржкрж╛ржорзНржк, рж╕рзНржЯрзЗрж╢ржи
ЁЯЪи => ЁЯЪи, ржЖрж▓рзЛ, ржЧрж╛ржбрж╝рж┐, ржШрзВрж░рзНржгрж╛ржпрж╝ржорж╛ржи, ржкрзБрж▓рж┐рж╢, ржкрзБрж▓рж┐рж╢рзЗрж░ ржЧрж╛ржбрж╝рж┐рж░ ржЖрж▓рзЛ, ржмрж╛рждрж┐, ржпрж╛ржиржмрж╛рж╣ржи
ЁЯЪе => ЁЯЪе, ржЕржирзБржнрзВржорж┐ржХ ржЯрзНрж░рж╛ржлрж┐ржХ рж▓рж╛ржЗржЯ, ржЖрж▓рзЛ, ржЯрзНрж░рж╛ржлрж┐ржХ, рж╕рж┐ржЧржирзНржпрж╛рж▓
ЁЯЪж => ЁЯЪж, ржЖрж▓рзЛ, ржЙрж▓рзНрж▓ржорзНржм ржЯрзНрж░рж╛ржлрж┐ржХ рж▓рж╛ржЗржЯ, ржЯрзНрж░рж╛ржлрж┐ржХ, рж╕рж┐ржЧржирзНржпрж╛рж▓
ЁЯЪз => ЁЯЪз, ржирж┐рж░рзНржорж╛ржг, ржмрж╛ржзрж╛
ЁЯЫС => ЁЯЫС, ржЕрж╖рзНржЯржХрзЛржгрзА, ржЪрж┐рж╣рзНржи, ржерж╛ржорж╛рж░ ржЪрж┐рж╣рзНржи, ржерж╛ржорзБржи
тЪУ => тЪУ, ржЬрж╛рж╣рж╛ржЬ, ржирзЛржЩрж░, рж╕рж░ржЮрзНржЬрж╛ржо
тЫ╡ => тЫ╡, ржЗржпрж╝ржЯ, ржирзМржХрж╛, ржкрж╛рж▓ рждрзЛрж▓рж╛ ржирзМржХрж╛, ржпрж╛ржиржмрж╛рж╣ржи, рж░рж┐рж╕рзЛрж░рзНржЯ, рж╕рж╛ржЧрж░
ЁЯЫ╢ => ЁЯЫ╢, ржбрзЛржЩрзНржЧрж╛, ржирзМржХрж╛
ЁЯЪд => ЁЯЪд, ржирзМржХрж╛, ржпрж╛ржиржмрж╛рж╣ржи, рж╕рзНржкрзАржбржмрзЛржЯ
ЁЯЫ│ => ЁЯЫ│, ржЬрж╛рж╣рж╛ржЬ, ржпрж╛рждрзНрж░рзА, ржпрж╛рждрзНрж░рзАржмрж╛рж╣рзА ржЬрж╛рж╣рж╛ржЬ, ржпрж╛ржиржмрж╛рж╣ржи
тЫ┤ => тЫ┤, ржЦрзЗржпрж╝рж╛, ржирзМржХрж╛
ЁЯЫе => ЁЯЫе, ржирзМржХрж╛, ржорзЛржЯрж░ржмрзЛржЯ, ржпрж╛ржиржмрж╛рж╣ржи
ЁЯЪв => ЁЯЪв, ржЬрж╛рж╣рж╛ржЬ, ржпрж╛ржиржмрж╛рж╣ржи
тЬИ => тЬИ, ржмрж┐ржорж╛ржи, ржпрж╛ржиржмрж╛рж╣ржи
ЁЯЫй => ЁЯЫй, ржЫрзЛржЯ ржмрж┐ржорж╛ржи, ржмрж┐ржорж╛ржи, ржпрж╛ржиржмрж╛рж╣ржи
ЁЯЫл => ЁЯЫл, ржЪрзЗржХ ржЗржи, ржкрзНрж░рж╕рзНржерж╛ржи, ржмрж┐ржорж╛ржи, ржмрж┐ржорж╛ржи ржЫрж╛ржбрж╝рж╛, ржпрж╛ржиржмрж╛рж╣ржи
ЁЯЫм => ЁЯЫм, ржЕржмрждрж░ржг, ржЖржЧржд, ржЖржЧржоржи, ржмрж┐ржорж╛ржи, ржмрж┐ржорж╛ржи ржЖрж╕рж╛, ржпрж╛ржиржмрж╛рж╣ржи
ЁЯТ║ => ЁЯТ║, ржЪрзЗржпрж╝рж╛рж░, ржмрж╕рж╛рж░ ржЬрж╛ржпрж╝ржЧрж╛
ЁЯЪБ => ЁЯЪБ, ржпрж╛ржиржмрж╛рж╣ржи, рж╣рзЗрж▓рж┐ржХржкрзНржЯрж╛рж░
ЁЯЪЯ => ЁЯЪЯ, ржпрж╛ржиржмрж╛рж╣ржи, рж░рзЗрж▓ржУржпрж╝рзЗ, рж░рзЗрж▓ржУржпрж╝рзЗ рж╕рзНржержЧрж┐рждрж╛ржжрзЗрж╢, рж╕рзНржержЧрж┐рждрж╛ржжрзЗрж╢
ЁЯЪа => ЁЯЪа, ржХрзЗржмрж▓, ржЧржирзНржбрзЛрж▓рж╛, ржкрж░рзНржмржд, ржорж╛ржЙржирзНржЯрзЗржи ржХрзЗржмрж▓ржУржпрж╝рзЗ, ржпрж╛ржиржмрж╛рж╣ржи
ЁЯЪб => ЁЯЪб, ржХрзЗржмрж▓, ржЧржирзНржбрзЛрж▓рж╛, ржЯрзНрж░рж╛ржоржУржпрж╝рзЗ, ржмрж╛ржпрж╝ржмрзАржпрж╝ ржЯрзНрж░рж╛ржо, ржнрж╛рж╕ржорж╛ржи, ржорзЛржЯрж░ржЧрж╛ржбрж╝рж┐, ржпрж╛ржиржмрж╛рж╣ржи, рж░рзЛржкржУржпрж╝рзЗ
ЁЯЫ░ => ЁЯЫ░, ржЙржкржЧрзНрж░рж╣, ржорж╣рж╛ржХрж╛рж╢, ржпрж╛ржиржмрж╛рж╣ржи
ЁЯЪА => ЁЯЪА, ржорж╣рж╛ржХрж╛рж╢, ржпрж╛ржиржмрж╛рж╣ржи, рж░ржХрзЗржЯ
ЁЯЫ╕ => ЁЯЫ╕, ржЗржЙржПржлржУ, ржЙржбрж╝ржирзНржд ржЪрж╛ржХрждрж┐
ЁЯЫО => ЁЯЫО, ржШржгрзНржЯрж╛, ржмрзЗрж▓рж╣ржк, ржмрзЗрж▓рж╣ржк ржмрзЗрж▓, рж╣рзЛржЯрзЗрж▓
ЁЯЪк => ЁЯЪк, ржжрж░ржЬрж╛
ЁЯЫП => ЁЯЫП, ржмрж┐ржЫрж╛ржирж╛, рж╢рзЛржУржпрж╝рж╛, рж╣рзЛржЯрзЗрж▓
ЁЯЫЛ => ЁЯЫЛ, ржХрж╛ржЙржЪ, ржкрж╛рж▓ржЩрзНржХ ржУ ржмрж╛рждрж┐, рж▓рзНржпрж╛ржорзНржк, рж╣рзЛржЯрзЗрж▓
ЁЯЪ╜ => ЁЯЪ╜, ржЯржпрж╝рж▓рзЗржЯ, рж╢рзМржЪрж╛ржЧрж╛рж░
ЁЯЪ┐ => ЁЯЪ┐, ржЬрж▓, рж╢рж╛ржУржпрж╝рж╛рж░
ЁЯЫБ => ЁЯЫБ, ржмрж╛ржержЯржм, рж╕рзНржирж╛ржи
тМЫ => тМЫ, ржЯрж╛ржЗржорж╛рж░, ржмрж╛рж▓рж┐, ржмрж╛рж▓рж┐ржШржбрж╝рж┐
тП│ => тП│, ржЯрж╛ржЗржорж╛рж░, ржкрзНрж░ржмрж╛рж╣рж┐ржд ржмрж╛рж▓рж┐ ржжрж┐ржпрж╝рзЗ ржмрж╛рж▓рж┐ржШржбрж╝рж┐, ржмрж╛рж▓рж┐, ржмрж╛рж▓рж┐ржШржбрж╝рж┐
тМЪ => тМЪ, ржШржбрж╝рж┐
тП░ => тП░, ржЕрзНржпрж╛рж▓рж╛рж░рзНржо, ржЕрзНржпрж╛рж▓рж╛рж░рзНржо ржШржбрж╝рж┐, ржШржбрж╝рж┐
тП▒ => тП▒, ржШржбрж╝рж┐, рж╕рзНржЯржкржУржпрж╝рж╛ржЪ
тП▓ => тП▓, ржШржбрж╝рж┐, ржЯрж╛ржЗржорж╛рж░, ржЯрж╛ржЗржорж╛рж░ ржШржбрж╝рж┐
ЁЯХ░ => ЁЯХ░, ржШржбрж╝рж┐, ржорзНржпрж╛ржирзНржЯрзЗрж▓ржкрж┐рж╕ ржШржбрж╝рж┐
ЁЯХЫ => ЁЯХЫ, 00, 12, 12:00, ржШржбрж╝рж┐, ржЯрж╛, ржмрж╛рж░рзЛ, ржмрж╛рж░рзЛржЯрж╛
ЁЯХз => ЁЯХз, 12, 12:30, 30, ржШржбрж╝рж┐, рждрж┐рж░рж┐рж╢, ржмрж╛рж░рзЛ, рж╕рж╛ржбрж╝рзЗ ржмрж╛рж░рзЛржЯрж╛
ЁЯХР => ЁЯХР, 00, 1, 1:00, ржПржХ, ржПржХржЯрж╛, ржШржбрж╝рж┐, ржЯрж╛
ЁЯХЬ => ЁЯХЬ, 1, 1:30, 30, ржПржХ, ржШржбрж╝рж┐, рждрж┐рж░рж┐рж╢, ржжрзЗржбрж╝ржЯрж╛
ЁЯХС => ЁЯХС, 00, 2, 2:00, ржШржбрж╝рж┐, ржЯрзЛ, ржжрзБ, ржжрзБржЯрзЛ
ЁЯХЭ => ЁЯХЭ, 2, 2:30, 30, ржЖржбрж╝рж╛ржЗржЯрж╛, ржШржбрж╝рж┐, рждрж┐рж░рж┐рж╢, ржжрзБржЯрзЛ
ЁЯХТ => ЁЯХТ, 00, 3, 3:00, ржШржбрж╝рж┐, ржЯрзЗ, рждрж┐ржи, рждрж┐ржиржЯрзЗ
ЁЯХЮ => ЁЯХЮ, 3, 3:30, 30, ржШржбрж╝рж┐, рждрж┐ржиржЯрзЗ, рждрж┐рж░рж┐рж╢, рж╕рж╛ржбрж╝рзЗ рждрж┐ржиржЯрзЗ
ЁЯХУ => ЁЯХУ, 00, 4, 4:00, ржШржбрж╝рж┐, ржЪрж╛рж░, ржЪрж╛рж░ржЯрзЗ, ржЯрзЗ
ЁЯХЯ => ЁЯХЯ, 30, 4, 4:30, ржШржбрж╝рж┐, ржЪрж╛рж░ржЯрзЗ, рждрж┐рж░рж┐рж╢, рж╕рж╛ржбрж╝рзЗ ржЪрж╛рж░ржЯрзЗ
ЁЯХФ => ЁЯХФ, 00, 5, 5:00, ржШржбрж╝рж┐, ржЯрж╛, ржкрж╛ржБржЪ, ржкрж╛ржБржЪржЯрж╛
ЁЯХа => ЁЯХа, 30, 5, 5:30, ржШржбрж╝рж┐, рждрж┐рж░рж┐рж╢, ржкрж╛ржБржЪржЯрж╛, рж╕рж╛ржбрж╝рзЗ ржкрж╛ржБржЪржЯрж╛
ЁЯХХ => ЁЯХХ, 00, 6, 6:00, ржШржбрж╝рж┐, ржЫржЯрж╛, ржЫржпрж╝, ржЯрж╛
ЁЯХб => ЁЯХб, 30, 6, 6:30, ржШржбрж╝рж┐, ржЫржпрж╝ржЯрж╛, рждрж┐рж░рж┐рж╢, рж╕рж╛ржбрж╝рзЗ ржЫржЯрж╛
ЁЯХЦ => ЁЯХЦ, 00, 7, 7:00, ржШржбрж╝рж┐, ржЯрж╛, рж╕рж╛ржд, рж╕рж╛рждржЯрж╛
ЁЯХв => ЁЯХв, 30, 7, 7:30, ржШржбрж╝рж┐, рждрж┐рж░рж┐рж╢, рж╕рж╛ржбрж╝рзЗ рж╕рж╛рждржЯрж╛, рж╕рж╛рждржЯрж╛
ЁЯХЧ => ЁЯХЧ, 00, 8, 8:00, ржЖржЯ, ржЖржЯржЯрж╛, ржШржбрж╝рж┐, ржЯрж╛
ЁЯХг => ЁЯХг, 30, 8, 8:30, ржЖржЯржЯрж╛, ржШржбрж╝рж┐, рждрж┐рж░рж┐рж╢, рж╕рж╛ржбрж╝рзЗ ржЖржЯржЯрж╛
ЁЯХШ => ЁЯХШ, 00, 9, 9:00, ржШржбрж╝рж┐, ржЯрж╛, ржи, ржиржЯрж╛
ЁЯХд => ЁЯХд, 30, 9, 9:30, ржШржбрж╝рж┐, рждрж┐рж░рж┐рж╢, ржиржпрж╝ржЯрж╛, рж╕рж╛ржбрж╝рзЗ ржиржЯрж╛
ЁЯХЩ => ЁЯХЩ, 00, 10, 10:00, ржШржбрж╝рж┐, ржЯрж╛, ржжрж╢, ржжрж╢ржЯрж╛
ЁЯХе => ЁЯХе, 10, 10:30, 30, ржШржбрж╝рж┐, рждрж┐рж░рж┐рж╢, ржжрж╢ржЯрж╛, рж╕рж╛ржбрж╝рзЗ ржжрж╢ржЯрж╛
ЁЯХЪ => ЁЯХЪ, 00, 11, 11:00, ржПржЧрж╛рж░рзЛ, ржПржЧрж╛рж░рзЛржЯрж╛, ржШржбрж╝рж┐, ржЯрж╛
ЁЯХж => ЁЯХж, 11, 11:30, 30, ржПржЧрж╛рж░рзЛржЯрж╛, ржШржбрж╝рж┐, рждрж┐рж░рж┐рж╢, рж╕рж╛ржбрж╝рзЗ ржПржЧрж╛рж░рзЛржЯрж╛
ЁЯМС => ЁЯМС, ржЕржирзНржзржХрж╛рж░, ржЖржмрж╣рж╛ржУржпрж╝рж╛, ржЖржорж╛ржмрж╕рзНржпрж╛, ржЪрж╛ржБржж, ржорж╣рж╛ржХрж╛рж╢
ЁЯМТ => ЁЯМТ, ржЕрж░рзНржзржЪржирзНржжрзНрж░, ржЖржмрж╣рж╛ржУржпрж╝рж╛, ржУржпрж╝рж╛ржХрзНрж╕рж┐ржВ, ржЪрж╛ржБржж, ржмрзГржжрзНржзрж┐ржкрзНрж░рж╛ржкрзНржд ржЕрж░рзНржзржЪржирзНржжрзНрж░, ржорж╣рж╛ржХрж╛рж╢
ЁЯМУ => ЁЯМУ, ржЖржмрж╣рж╛ржУржпрж╝рж╛, ржЪрждрзБрж░рзНржерж╛ржВрж╢, ржЪрж╛ржБржж, ржЪрж╛ржБржжрзЗрж░ ржкрзНрж░ржержо ржЪрждрзБрж░рзНржерж╛ржВрж╢, ржорж╣рж╛ржХрж╛рж╢
ЁЯМФ => ЁЯМФ, ржЕрж░рзНржзрж╛ржзрж┐ржХ, ржЖржмрж╣рж╛ржУржпрж╝рж╛, ржУржпрж╝рж╛ржХрзНрж╕рж┐ржВ, ржЪрж╛ржБржж, ржмрзГржжрзНржзрж┐ржкрзНрж░рж╛ржкрзНржд ржЕрж░рзНржзрж╛ржзрж┐ржХ ржЪрж╛ржБржж, ржорж╣рж╛ржХрж╛рж╢
ЁЯМХ => ЁЯМХ, ржЖржмрж╣рж╛ржУржпрж╝рж╛, ржЪрж╛ржБржж, ржкрзВрж░рзНржг, ржкрзВрж░рзНржгрж┐ржорж╛, ржорж╣рж╛ржХрж╛рж╢
ЁЯМЦ => ЁЯМЦ, ржЕрж░рзНржзрж╛ржзрж┐ржХ, ржЖржмрж╣рж╛ржУржпрж╝рж╛, ржХрзНрж╖рзАржпрж╝ржорж╛ржг, ржХрзНрж╖рзАржпрж╝ржорж╛ржг ржЕрж░рзНржзрж╛ржзрж┐ржХ ржЪрж╛ржБржж, ржЪрж╛ржБржж, ржорж╣рж╛ржХрж╛рж╢
ЁЯМЧ => ЁЯМЧ, ржЖржмрж╣рж╛ржУржпрж╝рж╛, ржЪрждрзБрж░рзНржерж╛ржВрж╢, ржЪрж╛ржБржж, ржЪрж╛ржБржжрзЗрж░ рж╢рзЗрж╖ ржЪрждрзБрж░рзНржерж╛ржВрж╢, ржорж╣рж╛ржХрж╛рж╢
ЁЯМШ => ЁЯМШ, ржЕрж░рзНржзржЪржирзНржжрзНрж░, ржЖржмрж╣рж╛ржУржпрж╝рж╛, ржХрзНрж╖рзАржпрж╝ржорж╛ржг, ржХрзНрж╖рзАржпрж╝ржорж╛ржг ржЕрж░рзНржзржЪржирзНржжрзНрж░, ржЪрж╛ржБржж, ржорж╣рж╛ржХрж╛рж╢
ЁЯМЩ => ЁЯМЩ, ржЕрж░рзНржзржЪржирзНржжрзНрж░, ржЖржмрж╣рж╛ржУржпрж╝рж╛, ржЪрж╛ржБржж, ржорж╣рж╛ржХрж╛рж╢
ЁЯМЪ => ЁЯМЪ, ржЖржмрж╣рж╛ржУржпрж╝рж╛, ржЪрж╛ржБржж, ржЪрж╛ржБржжрзЗрж░ ржирждрзБржи ржорзБржЦ, ржорж╣рж╛ржХрж╛рж╢, ржорзБржЦ
ЁЯМЫ => ЁЯМЫ, ржЖржмрж╣рж╛ржУржпрж╝рж╛, ржЪрждрзБрж░рзНржерж╛ржВрж╢, ржЪрж╛ржБржж, ржорж╣рж╛ржХрж╛рж╢, ржорзБржЦ, ржорзБржЦрзЗрж░ рж╕рж╛ржерзЗ ржЪрж╛ржБржжрзЗрж░ ржкрзНрж░ржержо ржПржХ ржЪрждрзБрж░рзНржерж╛ржВрж╢
ЁЯМЬ => ЁЯМЬ, ржЖржмрж╣рж╛ржУржпрж╝рж╛, ржЪрждрзБрж░рзНржерж╛ржВрж╢, ржЪрж╛ржБржж, ржорж╣рж╛ржХрж╛рж╢, ржорзБржЦ, ржорзБржЦрзЗрж░ рж╕рж╛ржерзЗ ржЪрж╛ржБржжрзЗрж░ рж╢рзЗрж╖ ржПржХ ржЪрждрзБрж░рзНржерж╛ржВрж╢
ЁЯМб => ЁЯМб, ржЖржмрж╣рж╛ржУржпрж╝рж╛, ржерж╛рж░рзНржорзЛржорж┐ржЯрж╛рж░
тША => тША, ржЖржмрж╣рж╛ржУржпрж╝рж╛, ржЙржЬрзНржЬрзНржмрж▓, ржорж╣рж╛ржХрж╛рж╢, рж░рж╢рзНржорж┐, рж░рзЛржж, рж╕рзВрж░рзНржп
ЁЯМЭ => ЁЯМЭ, ржЖржмрж╣рж╛ржУржпрж╝рж╛, ржЙржЬрзНржЬрзНржмрж▓, ржЪрж╛ржБржж, ржкрзВрж░рзНржг, ржорж╣рж╛ржХрж╛рж╢, ржорзБржЦ, ржорзБржЦрзЗрж░ рж╕рж╛ржерзЗ ржкрзВрж░рзНржг ржЪрж╛ржБржж
ЁЯМЮ => ЁЯМЮ, ржЖржмрж╣рж╛ржУржпрж╝рж╛, ржЙржЬрзНржЬрзНржмрж▓, ржорж╣рж╛ржХрж╛рж╢, ржорзБржЦ, ржорзБржЦрзЗрж░ рж╕рж╛ржерзЗ рж╕рзВрж░рзНржп, рж╕рзВрж░рзНржп
тнР => тнР, рждрж╛рж░рж╛, рж╕рж╛ржжрж╛ ржорж╛ржЭрж╛рж░рж┐ рждрж╛рж░рж╛
ЁЯМЯ => ЁЯМЯ, ржЙржЬрзНржЬрзНржмрж▓ рждрж╛рж░рж╛, ржЙржжрзНржнрж╛рж╕, ржЬрзНржмрж▓ржЬрзНржмрж▓рзЗ, ржЭржХржоржХ, рждрж╛рж░рж╛, ржжрзНржпрзБрждрж┐
ЁЯМа => ЁЯМа, ржЙрж▓рзНржХрж╛, рждрж╛рж░рж╛, ржкрждрж┐ржд, ржорж╣рж╛ржХрж╛рж╢, рж╢рзБржЯрж┐ржВ
тШБ => тШБ, ржЖржмрж╣рж╛ржУржпрж╝рж╛, ржорзЗржШ
тЫЕ => тЫЕ, ржЖржмрж╣рж╛ржУржпрж╝рж╛, ржорзЗржШ, ржорзЗржШрзЗрж░ ржкрж┐ржЫржирзЗ рж╕рзВрж░рзНржп, рж╕рзВрж░рзНржп
тЫИ => тЫИ, ржЖржмрж╣рж╛ржУржпрж╝рж╛, ржмрзГрж╖рзНржЯрж┐, ржорзЗржШ, ржорзЗржШрзЗрж░ ржЧрж░рзНржЬржи, ржорзЗржШрзЗрж░ рж╕рж╛ржерзЗ ржмрж┐ржжрзНржпрзБрждрзЗрж░ ржЭрж▓ржХ ржУ ржмрзГрж╖рзНржЯрж┐
ЁЯМд => ЁЯМд, ржЕрж▓рзНржк ржорзЗржШрзЗрж░ ржкрж┐ржЫржирзЗ рж╕рзВрж░рзНржп, ржЖржмрж╣рж╛ржУржпрж╝рж╛, ржорзЗржШ, рж╕рзВрж░рзНржп
ЁЯМе => ЁЯМе, ржЖржмрж╣рж╛ржУржпрж╝рж╛, ржмрзЗрж╢рж┐ ржорзЗржШрзЗрж░ ржкрж┐ржЫржирзЗ рж╕рзВрж░рзНржп, ржорзЗржШ, рж╕рзВрж░рзНржп
ЁЯМж => ЁЯМж, ржЖржмрж╣рж╛ржУржпрж╝рж╛, ржмрзГрж╖рзНржЯрж┐, ржорзЗржШ, ржорзЗржШрзЗрж░ рж╕рж╛ржерзЗ ржмрзГрж╖рзНржЯрж┐рж░ ржкрж┐ржЫржирзЗ рж╕рзВрж░рзНржп, рж╕рзВрж░рзНржп
ЁЯМз => ЁЯМз, ржЖржмрж╣рж╛ржУржпрж╝рж╛, ржмрзГрж╖рзНржЯрж┐, ржмрзГрж╖рзНржЯрж┐рж░ рж╕рж╛ржерзЗ ржорзЗржШ, ржорзЗржШ
ЁЯМи => ЁЯМи, ржЖржмрж╣рж╛ржУржпрж╝рж╛, ржарж╛ржирзНржбрж╛, рждрзБрж╖рж╛рж░ржкрж╛ржд, ржмрж░ржлрзЗрж░ рж╕рж╛ржерзЗ ржорзЗржШ, ржорзЗржШ
ЁЯМй => ЁЯМй, ржЖржмрж╣рж╛ржУржпрж╝рж╛, ржмрж┐ржжрзНржпрзБрждрзЗрж░ ржЭрж▓ржХрзЗрж░ рж╕рж╛ржерзЗ ржорзЗржШ, ржмрж┐ржжрзНржпрзБрзО ржЪржоржХ, ржорзЗржШ
ЁЯМк => ЁЯМк, ржЖржмрж╣рж╛ржУржпрж╝рж╛, ржШрзВрж░рзНржгрж┐ржЭржбрж╝, ржорзЗржШ
ЁЯМл => ЁЯМл, ржЖржмрж╣рж╛ржУржпрж╝рж╛, ржХрзБржпрж╝рж╛рж╢рж╛, ржорзЗржШ
ЁЯМм => ЁЯМм, ржЖржмрж╣рж╛ржУржпрж╝рж╛, ржорзБржЦ, ржорзЗржШ, рж╣рж╛ржУржпрж╝рж╛, рж╣рж╛ржУржпрж╝рж╛рж░ ржорзБржЦ, рж╣рж╛рж▓рзНржХрж╛ рж╣рж╛ржУржпрж╝рж╛
ЁЯМА => ЁЯМА, ржЖржмрж╣рж╛ржУржпрж╝рж╛, ржЯрж╛ржЗржлрзБржи, ржмрж┐ржнрзНрж░рж╛ржирзНрждрж┐ржХрж░, рж╕рж╛ржЗржХрзНрж▓рзЛржи, рж╣рждржмрзБржжрзНржзрж┐
ЁЯМИ => ЁЯМИ, ржЖржмрж╣рж╛ржУржпрж╝рж╛, ржмрзГрж╖рзНржЯрж┐, рж░рж╛ржоржзржирзБ
ЁЯМВ => ЁЯМВ, ржЖржмрж╣рж╛ржУржпрж╝рж╛, ржЫрж╛рждрж╛, ржкрзЛрж╢рж╛ржХ, ржмржирзНржз ржЫрж╛рждрж╛, ржмрзГрж╖рзНржЯрж┐
тШВ => тШВ, ржЖржмрж╣рж╛ржУржпрж╝рж╛, ржЫрж╛рждрж╛, ржкрзЛрж╢рж╛ржХ, ржмрзГрж╖рзНржЯрж┐
тШФ => тШФ, ржЖржмрж╣рж╛ржУржпрж╝рж╛, ржЫрж╛рждрж╛, ржЫрж╛рждрж╛рждрзЗ ржмрзГрж╖рзНржЯрж┐рж░ ржлрзЛржБржЯрж╛ рж▓рж╛ржЧрж╛, ржкрзЛрж╢рж╛ржХ, ржлрзЛржБржЯрж╛, ржмрзГрж╖рзНржЯрж┐
тЫ▒ => тЫ▒, ржЖржмрж╣рж╛ржУржпрж╝рж╛, ржЫрж╛рждрж╛, ржмрзГрж╖рзНржЯрж┐, ржорж╛ржЯрж┐рждрзЗ ржЫрж╛рждрж╛, рж╕рзВрж░рзНржп
тЪб => тЪб, ржЭржЯржХрж╛, ржмрж┐ржжрзНржпрзБрзО, ржмрж┐ржжрзНржпрзБрзО ржЪржоржХ, ржмрж┐ржкржж, ржмрзЗрж╢рж┐ ржнрзЛрж▓рзНржЯрзЗржЬ, ржмрзИржжрзНржпрзБрждрж┐ржХ, ржнрзЛрж▓рзНржЯрзЗржЬ
тЭД => тЭД, ржЖржмрж╣рж╛ржУржпрж╝рж╛, ржарж╛ржирзНржбрж╛, рждрзБрж╖рж╛рж░ржХржгрж╛, рждрзБрж╖рж╛рж░ржкрж╛ржд
тШГ => тШГ, ржЖржмрж╣рж╛ржУржпрж╝рж╛, ржарж╛ржирзНржбрж╛, рждрзБрж╖рж╛рж░ржкрж╛ржд, рждрзБрж╖рж╛рж░ржорж╛ржиржм
тЫД => тЫД, ржЖржмрж╣рж╛ржУржпрж╝рж╛, ржарж╛ржирзНржбрж╛, рждрзБрж╖рж╛рж░ ржЫрж╛ржбрж╝рж╛ржЗ рждрзБрж╖рж╛рж░ржорж╛ржиржм, рждрзБрж╖рж╛рж░ржкрж╛ржд, рждрзБрж╖рж╛рж░ржорж╛ржиржм
тШД => тШД, ржзрзВржоржХрзЗрждрзБ, ржорж╣рж╛ржХрж╛рж╢
ЁЯФе => ЁЯФе, ржЖржЧрзБржи, рж╢рж┐ржЦрж╛, рж╕рж░ржЮрзНржЬрж╛ржо
ЁЯТз => ЁЯТз, ржЖржмрж╣рж╛ржУржпрж╝рж╛, ржХржорж┐ржХ, ржШрж╛ржо, ржарж╛ржирзНржбрж╛, ржлрзЛржБржЯрж╛
ЁЯМК => ЁЯМК, ржЖржмрж╣рж╛ржУржпрж╝рж╛, ржЬрж▓, ржЬрж▓ рждрж░ржЩрзНржЧ, ржврзЗржЙ, ржорж╣рж╛рж╕рж╛ржЧрж░
ЁЯОГ => ЁЯОГ, ржЙржжржпрж╛ржкржи, ржЬрзНржпрж╛ржХ, ржЬрзНржпрж╛ржХрзЛ рж▓ржгрзНржаржи, рж▓ржгрзНржаржи, рж╣рзНржпрж╛рж▓рзЛржЗржи
ЁЯОД => ЁЯОД, ржЙржжржпрж╛ржкржи, ржХрзНрж░рж┐рж╕ржорж╛рж╕, ржХрзНрж░рж┐рж╕ржорж╛рж╕ ржЯрзНрж░рзА, ржЧрж╛ржЫ
ЁЯОЖ => ЁЯОЖ, ржЖрждрж╕ ржмрж╛ржЬрж┐, ржЙржжржпрж╛ржкржи
ЁЯОЗ => ЁЯОЗ, ржЙржжржпрж╛ржкржи, ржжрзНржпрзБрждрж┐, ржлрзБрж▓ржЭрзБржбрж╝рж┐, ржмрж╛ржЬрж┐
тЬи => тЬи, рждрж╛рж░рж╛, ржжрзНржпрзБрждрж┐
ЁЯОИ => ЁЯОИ, ржЙржжржпрж╛ржкржи, ржмрзЗрж▓рзБржи
ЁЯОЙ => ЁЯОЙ, ржЕржирзБрж╖рзНржарж╛ржи, ржЙржжржпрж╛ржкржи, ржЯрж╛ржбрж╛, ржкржкрж╛рж░, ржкрж╛рж░рзНржЯрж┐ ржкржкрж╛рж░
ЁЯОК => ЁЯОК, ржЙржжржпрж╛ржкржи, ржХржиржлрзЗржЯрзНржЯрж┐, ржХржиржлрзЗржЯрзНржЯрж┐ ржмрж▓, ржмрж▓
ЁЯОЛ => ЁЯОЛ, ржЙржжржпрж╛ржкржи, ржЧрж╛ржЫ, ржЬрж╛ржкрж╛ржирж┐, рждрж╛ржирж╛ржмрж╛рждрж╛ ржЯрзНрж░рзА, ржмрзНржпрж╛ржирж╛рж░
ЁЯОН => ЁЯОН, ржЙржжржпрж╛ржкржи, ржЧрж╛ржЫ, ржЬрж╛ржкрж╛ржирж┐, ржкрж╛ржЗржи, ржкрж╛ржЗржирзЗрж░ рж╕ржЬрзНржЬрж╛, ржмрж╛ржБрж╢
ЁЯОО => ЁЯОО, ржЙрзОрж╕ржм, ржЙржжржпрж╛ржкржи, ржЬрж╛ржкрж╛ржирж┐, ржЬрж╛ржкрж╛ржирж┐ ржкрзБрждрзБрж▓, ржкрзБрждрзБрж▓
ЁЯОП => ЁЯОП, ржЖрж▓рзЛржХрж░рж╢рзНржорж┐, ржЙржжржпрж╛ржкржи, ржХрж╛рж░рзНржк, ржХрж╛рж░рзНржк рж╕рзНржЯрзНрж░рж┐ржорж╛рж░
ЁЯОР => ЁЯОР, ржЙржЗржирзНржб ржЪрж╛ржЗржо, ржЙржжржпрж╛ржкржи, ржРржХрждрж╛ржи, ржШржгрзНржЯрж╛, рж╣рж╛ржУржпрж╝рж╛
ЁЯОС => ЁЯОС, ржЕржирзБрж╖рзНржарж╛ржи, ржЙржжржпрж╛ржкржи, ржЪрж╛ржБржж, ржЪрж╛ржБржж ржжрзЗржЦрж╛рж░ ржЙрзОрж╕ржм
ЁЯОА => ЁЯОА, ржЙржжржпрж╛ржкржи, рж░рж┐ржмржи
ЁЯОБ => ЁЯОБ, ржЙржжржпрж╛ржкржи, ржЙржкрж╣рж╛рж░, ржЬржбрж╝рж╛ржи, ржмрж╛ржХрзНрж╕, ржорзЛржбрж╝ржХрзЗ ржерж╛ржХрж╛ ржЙржкрж╣рж╛рж░
ЁЯОЧ => ЁЯОЧ, ржЕржирзБрж╕рзНржорж╛рж░ржХ, ржЕржирзБрж╕рзНржорж╛рж░ржХ рж░рж┐ржмржи, ржЙржжржпрж╛ржкржи, ржлрж┐рждрж╛
ЁЯОЯ => ЁЯОЯ, ржЯрж┐ржХрзЗржЯ, ржкрзНрж░ржмрзЗрж╢, ржкрзНрж░ржмрзЗрж╢рзЗрж░ ржЯрж┐ржХрж┐ржЯ
ЁЯОл => ЁЯОл, ржЯрж┐ржХрж┐ржЯ, ржкрзНрж░ржмрзЗрж╢
ЁЯОЦ => ЁЯОЦ, ржЙржжржпрж╛ржкржи, ржкржжржХ, ржорж┐рж▓рж┐ржЯрж╛рж░рж┐ ржкржжржХ, рж╕рж╛ржорж░рж┐ржХ
ЁЯПЖ => ЁЯПЖ, ржЯрзНрж░ржлрж┐, ржкрзБрж░рж╕рзНржХрж╛рж░
ЁЯПЕ => ЁЯПЕ, ржЦрзЗрж▓рж╛рж░ ржкржжржХ, ржкржжржХ
ЁЯеЗ => ЁЯеЗ, ржкрзНрж░ржержо, ржкрзНрж░ржержо рж╕рзНржерж╛ржирзЗрж░ ржкржжржХ, ржорзЗржбрзЗрж▓, ржорзЛржирж╛рж░
ЁЯеИ => ЁЯеИ, ржжрзНржмрж┐рждрзАржпрж╝, ржжрзНржмрж┐рждрзАржпрж╝ рж╕рзНржерж╛ржирзЗрж░ ржкржжржХ, ржорзЗржбрзЗрж▓, рж░рзБржкрзЛ
ЁЯеЙ => ЁЯеЙ, рждрзГрждрзАржпрж╝, рждрзГрждрзАржпрж╝ рж╕рзНржерж╛ржирзЗрж░ ржкржжржХ, ржмрзНрж░рзЛржЮрзНржЬ, ржорзЗржбрзЗрж▓
тЪ╜ => тЪ╜, ржлрзБржЯржмрж▓, ржмрж▓
тЪ╛ => тЪ╛, ржмрж▓, ржмрзЗрж╕ржмрж▓
ЁЯПА => ЁЯПА, ржмрж▓, ржмрж╛рж╕рзНржХрзЗржЯржмрж▓, рж╣рзБржк
ЁЯПР => ЁЯПР, ржЦрзЗрж▓рж╛, ржмрж▓, ржнрж▓рж┐ржмрж▓
ЁЯПИ => ЁЯПИ, ржЖржорзЗрж░рж┐ржХрж╛ржи, ржЖржорзЗрж░рж┐ржХрж╛ржи ржлрзБржЯржмрж▓, ржлрзБржЯржмрж▓, ржмрж▓
ЁЯПЙ => ЁЯПЙ, ржлрзБржЯржмрж▓, ржмрж▓, рж░рж╛ржЧржмрж┐, рж░рж╛ржЧржмрж┐ ржлрзБржЯржмрж▓
ЁЯО╛ => ЁЯО╛, ржЯрзЗржирж┐рж╕, ржЯрзЗржирж┐рж╕ ржЦрзЗрж▓рж╛рж░ ржмрзНржпрж╛ржЯ, ржмрж▓
ЁЯО▒ => ЁЯО▒, 8, 8 ржмрж▓, 8 ржмрж▓рзЗрж░ ржкрзБрж▓, ржЖржЯ, ржЦрзЗрж▓рж╛, ржмрж▓, ржмрж┐рж▓рж┐ржпрж╝рж╛рж░рзНржб
ЁЯО│ => ЁЯО│, ржЦрзЗрж▓рж╛, ржмрж▓, ржмрзЛрж▓рж┐ржВ
ЁЯПП => ЁЯПП, ржХрзНрж░рж┐ржХрзЗржЯ, ржЦрзЗрж▓рж╛, ржмрж▓, ржмрзНржпрж╛ржЯ
ЁЯПС => ЁЯПС, ржЦрзЗрж▓рж╛, ржмрж▓, ржорж╛ржа, ржорж╛ржарзЗ рж╣ржХрж┐, рж▓рж╛ржарж┐, рж╣ржХрж┐
ЁЯПТ => ЁЯПТ, ржЖржЗрж╕ рж╣ржХрж┐ рж╕рзНржЯрж┐ржХ ржПржмржВ ржкрзБржХ, ржЦрзЗрж▓рж╛, ржкрж╛ржХ, ржмрж░ржл, рж▓рж╛ржарж┐, рж╣ржХрж┐
ЁЯПУ => ЁЯПУ, ржЦрзЗрж▓рж╛, ржЯрзЗржмрж┐рж▓ ржЯрзЗржирж┐рж╕, ржкрж┐ржВ ржкржЩрзНржЧ, ржкрзНржпрж╛ржбрзЗрж▓, ржмрж▓, ржмрзНржпрж╛ржЯ
ЁЯП╕ => ЁЯП╕, ржЦрзЗрж▓рж╛, ржЯрзЗржирж┐рж╕ ржЦрзЗрж▓рзЗрж░ ржмрзНржпрж╛ржЯ, ржмрж╛рж░рзНржбржЖржЗ, ржмрзНржпрж╛ржбржорж┐ржирзНржЯржи, рж╢рж╛ржЯрж▓ржХржХ
ЁЯеК => ЁЯеК, ржЦрзЗрж▓рж╛, ржЧрзНрж▓рж╛ржмрзНрж╕, ржмржХрзНрж╕рж┐ржВ, ржмржХрзНрж╕рж┐ржВ ржЧрзНрж▓рж╛ржнрж╕
ЁЯеЛ => ЁЯеЛ, ржЙржЗржирж┐ржлрж░рзНржо, ржХрж╛рж░рж╛ржЯрзЗ, ржЦрзЗрж▓рж╛, ржЬрзБржбрзЛ, рждрж╛ржЗржХрзБржирзНржбрзЛ, ржорж╛рж░рзНрж╢рж╛рж▓ ржЖрж░рзНржЯрзЗрж░, ржорж╛рж░рзНрж╢рж╛рж▓ ржЖрж░рзНржЯрзЗрж░ ржЙржЗржирж┐ржлрж░рзНржо
ЁЯеЕ => ЁЯеЕ, ржЦрзЗрж▓рж╛, ржЧрзЛрж▓, ржЧрзЛрж▓ ржирзЗржЯ, ржирзЗржЯ
ЁЯОп => ЁЯОп, ржЦрзЗрж▓рж╛, ржЪрзЛржЦ, ржбрж╛рж░рзНржЯ, ржмрзБрж▓, ржмрзБрж▓рзНрж╕ржЖржЗ, рж▓ржХрзНрж╖рзНржп, рж╕рж░рж╛рж╕рж░рж┐ рж╣рж┐ржЯ ржХрж░рж╛, рж╣рж┐ржЯ
тЫ│ => тЫ│, ржЧрж░рзНржд, ржЧрж░рзНрждрзЗрж░ ржоржзрзНржпрзЗ ржкрждрж╛ржХрж╛, ржЧрж▓ржл
тЫ╕ => тЫ╕, ржмрж░ржл, ржмрж░ржлрзЗ рж╕рзНржХрзЗржЯ ржХрж░рж╛, рж╕рзНржХрзЗржЯ
ЁЯОг => ЁЯОг, ржорж╛ржЫ, ржорж╛ржЫ ржзрж░рж╛рж░ ржмрж░рзНрж╢рж┐, ржорзЗрж░рзБ
ЁЯО╜ => ЁЯО╜, ржЙрждрзНрждрж░рзАржпрж╝, ржЪрж▓ржорж╛ржи, ржЬрж╛ржорж╛, ржжрзМржбрж╝рж╛ржирзЛрж░ ржЬрж╛ржорж╛
ЁЯО┐ => ЁЯО┐, рждрзБрж╖рж╛рж░ржкрж╛ржд, рж╕рзНржХрж┐
ЁЯЫ╖ => ЁЯЫ╖, рж╕рзНрж▓рзЗржЬ ржЧрж╛ржбрж╝рж┐
ЁЯеМ => ЁЯеМ, ржХрж╛рж░рзНрж▓рж┐ржВ рж╕рзНржЯрзЛржи, ржЧрзЗржо, рж░ржХ
ЁЯОо => ЁЯОо, ржЦрзЗрж▓рж╛, ржирж┐ржпрж╝ржирзНрждрзНрж░ржХ, ржнрж┐ржбрж┐ржУ ржЧрзЗржо
ЁЯХ╣ => ЁЯХ╣, ржЦрзЗрж▓рж╛, ржЬржпрж╝рж╕рзНржЯрж┐ржХ, ржнрж┐ржбрж┐ржУ ржЧрзЗржо
ЁЯО▓ => ЁЯО▓, ржЦрзЗрж▓рж╛, ржЦрзЗрж▓рж╛рж░ ржЫржХрзНржХрж╛, ржбрж╛ржЗ, ржкрж╛рж╢рж╛
тЩа => тЩа, ржХрж╛рж░рзНржб, ржЦрзЗрж▓рж╛, рж╕рзНржкрзЗржб, рж╕рзНржкрзЗржб рж╕рзНржпрзБржЯ, рж╕рзНржпрзБржЯ
тЩе => тЩе, ржХрж╛рж░рзНржб, ржЦрзЗрж▓рж╛, рж╕рзНржпрзБржЯ, рж╣рж╛рж░рзНржЯ, рж╣рж╛рж░рзНржЯ рж╕рзНржпрзБржЯ, рж╣рж╛рж░рзНржЯрж╕
тЩж => тЩж, ржХрж╛рж░рзНржб, ржЦрзЗрж▓рж╛, ржбрж╛ржпрж╝ржоржирзНржб, ржбрж╛ржпрж╝ржоржирзНржб рж╕рзНржпрзБржЯ, ржбрж╛ржпрж╝ржоржирзНржбрж╕, рж╕рзНржпрзБржЯ
тЩг => тЩг, ржХрж╛рж░рзНржб, ржХрзНрж▓рж╛ржм, ржХрзНрж▓рж╛ржм рж╕рзНржпрзБржЯ, ржХрзНрж▓рж╛ржмрж╕, ржЧрзЗржо, рж╕рзНржпрзБржЯ
ЁЯГП => ЁЯГП, ржХрж╛рж░рзНржб, ржЦрзЗрж▓рж╛, ржЬрзЛржХрж╛рж░, рждрж╛рж╕
ЁЯАД => ЁЯАД, ржЦрзЗрж▓рж╛, ржорж╛рж╣ржЬржЩрзНржЧ, ржорж╛рж╣ржЬржЩрзНржЧ рж▓рж╛рж▓ ржбрзНрж░рж╛ржЧржи, рж▓рж╛рж▓
ЁЯО┤ => ЁЯО┤, ржХрж╛рж░рзНржб, ржЦрзЗрж▓рж╛, ржЬрж╛ржкрж╛ржирж┐, рждрж╛рж╕, ржлрзБрж▓, ржлрзБрж▓ ржмрж╛ржЬрж╛ржирзЛрж░ ржХрж╛рж░рзНржб
ЁЯФЗ => ЁЯФЗ, ржЖржУржпрж╝рж╛ржЬ, ржирж┐ржГрж╢ржмрзНржж, ржирзАрж░ржм, рж╢рж╛ржирзНржд, рж╕рзНржкрж┐ржХрж╛рж░, рж╕рзНржкрж┐ржХрж╛рж░ ржирж┐рж░ржм
ЁЯФИ => ЁЯФИ, ржЖржУржпрж╝рж╛ржЬ, ржХржо ржЖржУржпрж╝рж╛ржЬрзЗ рж╕рзНржкрж┐ржХрж╛рж░
ЁЯФЙ => ЁЯФЙ, ржЖрж╕рзНрждрзЗ, рждрж░ржЩрзНржЧрзЗрж░, ржнрж▓рж┐ржЙржо, рж╕рзНржкрж┐ржХрж╛рж░, рж╕рзНржкрж┐ржХрж╛рж░ ржорж╛ржЭрж╛рж░рж┐ ржЖржУржпрж╝рж╛ржЬ
ЁЯФК => ЁЯФК, 3, ржЖржпрж╝рждржи, ржЦрзБржм ржЬрзЛрж░рзЗ, ржЬрзЛрж░рзЗ, рждрж┐ржиржЯрж┐, рж╕рзНржкрж┐ржХрж╛рж░, рж╕рзНржкрж┐ржХрж╛рж░ ржЬрзЛрж░рзЗ
ЁЯУв => ЁЯУв, ржЕржЯрзНржЯ, ржЬржиржЧржгрзЗрж░ ржЙржжрзНржжрзЗрж╢рзНржпрзЗ, рж▓рж╛ржЙржб рж╕рзНржкрж┐ржХрж╛рж░
ЁЯУг => ЁЯУг, ржорзЗржЧрж╛ржлрзЛржи, рж╣рж░рзНрж╖ржзрзНржмржирж┐
ЁЯУп => ЁЯУп, ржбрж╛ржХ, ржкрзЛрж╕рзНржЯ, ржкрзЛрж╕рзНржЯрж╛рж▓ рж╣рж░рзНржг, рж╢рж┐ржЩрж╛
ЁЯФФ => ЁЯФФ, ржШржгрзНржЯрж╛, ржмрзЗрж▓
ЁЯФХ => ЁЯФХ, ржШржгрзНржЯрж╛, ржиржпрж╝, ржирж╛, ржирж┐ржГрж╢ржмрзНржж, ржирж┐рж╖рж┐ржжрзНржз, ржирж┐рж╖рж┐ржжрзНржз ржерж╛ржХрж╛, ржирзАрж░ржм, рж╢рж╛ржирзНржд, рж╕рзНрж▓рзНржпрж╛рж╢рзЗрж░ рж╕рж╛ржерзЗ ржмрзЗрж▓
ЁЯО╝ => ЁЯО╝, рж╕ржЩрзНржЧрзАржд, рж╕ржЩрзНржЧрзАрждрзЗрж░ рж╕рзНржХрзЛрж░, рж╕рзНржХрзЛрж░
ЁЯО╡ => ЁЯО╡, ржЧрж╛ржирзЗрж░ рж╕рзНржмрж░рж▓рж┐ржкрж┐, ржирзЛржЯ, рж╕ржЩрзНржЧрзАржд
ЁЯО╢ => ЁЯО╢, ржирзЛржЯ, ржирзЛржЯрж╕, рж╕ржЩрзНржЧрзАржд, рж╕ржЩрзНржЧрзАрждрзЗрж░ ржирзЛржЯ
ЁЯОЩ => ЁЯОЩ, ржорж╛ржЗржХ, ржорж╛ржЗржХрзНрж░рзЛржлрзЛржи, рж╕ржЩрзНржЧрзАржд, рж╕рзНржЯрзБржбрж┐ржУ, рж╕рзНржЯрзБржбрж┐ржУ ржорж╛ржЗржХрзНрж░рзЛржлрзЛржи
ЁЯОЪ => ЁЯОЪ, ржорж╛рждрзНрж░рж╛, рж▓рзЗржмрзЗрж▓ рж╕рзНрж▓рж╛ржЗржбрж╛рж░, рж╕ржЩрзНржЧрзАржд, рж╕рзНрж▓рж╛ржЗржбрж╛рж░
ЁЯОЫ => ЁЯОЫ, ржиржм, ржирж┐ржпрж╝ржирзНрждрзНрж░ржг, ржирж┐ржпрж╝ржирзНрждрзНрж░ржг ржмрзЛрждрж╛ржо, рж╕ржЩрзНржЧрзАржд
ЁЯОд => ЁЯОд, ржХрж╛рж░рж╛ржУржХрзЗ, ржорж╛ржЗржХ, ржорж╛ржЗржХрзНрж░рзЛржлрзЛржи
ЁЯОз => ЁЯОз, ржЗржпрж╝рж╛рж░ржмрж╛ржб, рж╣рзЗржбржлрзЛржи
ЁЯУ╗ => ЁЯУ╗, ржнрж┐ржбрж┐ржУ, рж░рзЗржбрж┐ржУ
ЁЯО╖ => ЁЯО╖, рж╕ржЩрзНржЧрзАржд, рж╕ржЩрзНржЧрзАржд ржпржирзНрждрзНрж░, рж╕рзНржпрж╛ржХрзНрж╕рзЛржлрзЛржи
ЁЯО╕ => ЁЯО╕, ржЧрж┐ржЯрж╛рж░, рж╕ржЩрзНржЧрзАржд, рж╕ржЩрзНржЧрзАржд ржпржирзНрждрзНрж░
ЁЯО╣ => ЁЯО╣, ржХрзАржмрзЛрж░рзНржб, ржкрж┐ржпрж╝рж╛ржирзЛ, ржорж┐ржЙржЬрж┐ржХрзНржпрж╛рж▓ ржХрзАржмрзЛрж░рзНржб, рж╕ржЩрзНржЧрзАржд, рж╕ржЩрзНржЧрзАржд ржпржирзНрждрзНрж░
ЁЯО║ => ЁЯО║, ржнрзЗржБржкрзБ, рж╕ржЩрзНржЧрзАржд, рж╕ржЩрзНржЧрзАржд ржпржирзНрждрзНрж░
ЁЯО╗ => ЁЯО╗, ржмрзЗрж╣рж╛рж▓рж╛, рж╕ржЩрзНржЧрзАржд, рж╕ржЩрзНржЧрзАржд ржпржирзНрждрзНрж░
ЁЯеБ => ЁЯеБ, ржбрзНрж░рж╛ржо, ржбрзНрж░рж╛ржорж╕рзНржЯрж┐ржХ, рж╕ржВржЧрзАржд
ЁЯУ▒ => ЁЯУ▒, ржЯрзЗрж▓рж┐ржлрзЛржи, ржлрзЛржи, ржорзЛржмрж╛ржЗрж▓, ржорзЛржмрж╛ржЗрж▓ ржлрзЛржи, рж╕рзЗрж▓
ЁЯУ▓ => ЁЯУ▓, ржХрж▓, ржЧрзНрж░рж╣ржг, ржЯрзЗрж▓рж┐ржлрзЛржи, рждрзАрж░, рждрзАрж░ рж╕рж╣ ржорзЛржмрж╛ржЗрж▓ ржлрзЛржи, ржлрзЛржи, ржорзЛржмрж╛ржЗрж▓, рж╕рзЗрж▓
тШО => тШО, ржЯрзЗрж▓рж┐ржлрзЛржи, ржлрзЛржи
ЁЯУЮ => ЁЯУЮ, ржЯрзЗрж▓рж┐ржлрзЛржи, ржЯрзЗрж▓рж┐ржлрзЛржи рж░рж┐рж╕рж┐ржнрж╛рж░, ржлрзЛржи, рж░рж┐рж╕рж┐ржнрж╛рж░
ЁЯУЯ => ЁЯУЯ, ржкрзЗржЬрж╛рж░
ЁЯУа => ЁЯУа, ржлрзНржпрж╛ржХрзНрж╕, ржлрзНржпрж╛ржХрзНрж╕ ржорзЗрж╢рж┐ржи
ЁЯФЛ => ЁЯФЛ, ржмрзНржпрж╛ржЯрж╛рж░рж┐
ЁЯФМ => ЁЯФМ, ржЗрж▓рзЗржХржЯрзНрж░рж┐ржХ ржкрзНрж▓рзНржпрж╛ржЧ, ржкрзНрж▓рж╛ржЧ, ржмрж┐ржжрзНржпрзБрзО, ржмрзИржжрзНржпрзБрждрж┐ржХ
ЁЯТ╗ => ЁЯТ╗, ржХржорзНржкрж┐ржЙржЯрж╛рж░, ржкрж┐рж╕рж┐, ржмрзНржпржХрзНрждрж┐ржЧржд, рж▓рзНржпрж╛ржкржЯржк ржХржорзНржкрж┐ржЙржЯрж╛рж░
ЁЯЦе => ЁЯЦе, ржХржорзНржкрж┐ржЙржЯрж╛рж░, ржбрзЗрж╕рзНржХржЯржк, ржбрзЗрж╕рзНржХржЯржк ржХржорзНржкрж┐ржЙржЯрж╛рж░
ЁЯЦи => ЁЯЦи, ржХржорзНржкрж┐ржЙржЯрж╛рж░, ржкрзНрж░рж┐ржирзНржЯрж╛рж░
тМи => тМи, ржХржорзНржкрж┐ржЙржЯрж╛рж░, ржХрж┐ржмрзЛрж░рзНржб
ЁЯЦ▒ => ЁЯЦ▒, 3, ржХржорзНржкрж┐ржЙржЯрж╛рж░, ржХржорзНржкрж┐ржЙржЯрж╛рж░рзЗрж░ ржорж╛ржЙрж╕, рждрж┐ржиржЯрж┐, ржмрзЛрждрж╛ржо, ржорж╛ржЙрж╕
ЁЯЦ▓ => ЁЯЦ▓, ржХржорзНржкрж┐ржЙржЯрж╛рж░, ржЯрзНрж░рзНржпрж╛ржХржмрж▓
ЁЯТ╜ => ЁЯТ╜, ржЕржкржЯрж┐ржХрзНржпрж╛рж▓, ржХржорзНржкрж┐ржЙржЯрж╛рж░, ржХржорзНржкрж┐ржЙржЯрж╛рж░ ржбрж┐рж╕рзНржХ, ржбрж┐рж╕рзНржХ, ржорж┐ржирж┐ ржбрж┐рж╕рзНржХ
ЁЯТ╛ => ЁЯТ╛, ржХржорзНржкрж┐ржЙржЯрж╛рж░, ржбрж┐рж╕рзНржХ, ржлрзНрж▓ржкрж┐, ржлрзНрж▓ржкрж┐ ржбрж┐рж╕рзНржХ
ЁЯТ┐ => ЁЯТ┐, ржЕржкржЯрж┐ржХрзНржпрж╛рж▓, ржЕржкрзНржЯрж┐ржХрзНржпрж╛рж▓ ржбрж┐рж╕рзНржХ, ржХржорзНржкрж┐ржЙржЯрж╛рж░, ржбрж┐ржнрж┐ржбрж┐, ржбрж┐рж╕рзНржХ, ржирзАрж▓ рж░рж╢рзНржорж┐, рж╕рж┐ржбрж┐
ЁЯУА => ЁЯУА, ржЕржкржЯрж┐ржХрзНржпрж╛рж▓, ржХржорзНржкрж┐ржЙржЯрж╛рж░, ржбрж┐ржнрж┐ржбрж┐, ржбрж┐рж╕рзНржХ, ржирзАрж▓ рж░рж╢рзНржорж┐, рж╕рж┐ржбрж┐
ЁЯОе => ЁЯОе, ржХрзНржпрж╛ржорзЗрж░рж╛, ржорзБржнрж┐, ржорзБржнрж┐ ржХрзНржпрж╛ржорзЗрж░рж╛, рж╕рж┐ржирзЗржорж╛
ЁЯОЮ => ЁЯОЮ, ржлрж┐рж▓рзНржо, ржлрж┐рж▓рзНржорзЗрж░ ржлрзНрж░рзЗржо, ржлрзНрж░рзЗржо, ржорзБржнрж┐, рж╕рж┐ржирзЗржорж╛
ЁЯУ╜ => ЁЯУ╜, ржкрзНрж░ржЬрзЗржХрзНржЯрж░, ржлрж┐рж▓рзНржо, ржлрж┐рж▓рзНржо ржкрзНрж░ржЬрзЗржХрзНржЯрж░, ржнрж┐ржбрж┐ржУ, ржорзБржнрж┐, рж╕рж┐ржирзЗржорж╛
ЁЯОм => ЁЯОм, ржХрзНрж▓рзНржпрж╛ржкрж╛рж░, ржХрзНрж▓рзНржпрж╛ржкрж╛рж░ ржмрзЛрж░рзНржб, ржорзБржнрж┐
ЁЯУ║ => ЁЯУ║, ржЯрж┐ржнрж┐, ржЯрзЗрж▓рж┐ржнрж┐рж╢ржи, ржнрж┐ржбрж┐ржУ
ЁЯУ╖ => ЁЯУ╖, ржХрзНржпрж╛ржорзЗрж░рж╛, ржнрж┐ржбрж┐ржУ
ЁЯУ╕ => ЁЯУ╕, ржХрзНржпрж╛ржорзЗрж░рж╛, ржлрзНрж▓рзНржпрж╛рж╢, ржлрзНрж▓рзНржпрж╛рж╢ржпрзБржХрзНржд ржХрзНржпрж╛ржорзЗрж░рж╛, ржнрж┐ржбрж┐ржУ
ЁЯУ╣ => ЁЯУ╣, ржХрзНржпрж╛ржорзЗрж░рж╛, ржнрж┐ржбрж┐ржУ, ржнрж┐ржбрж┐ржУ ржХрзНржпрж╛ржорзЗрж░рж╛
ЁЯУ╝ => ЁЯУ╝, ржЯрзЗржк, ржнрж┐ржПржЪржЗржПрж╕, ржнрж┐ржбрж┐ржУ, ржнрж┐ржбрж┐ржУ ржХрзНржпрж╛рж╕рзЗржЯ
ЁЯФН => ЁЯФН, ржЕржирзБрж╕ржирзНржзрж╛ржи, ржЖрждрж╕, ржХрж╛ржЪ, ржмрж╛ржБржжрж┐ржХрзЗ рж╣рзЗрж▓рж╛ржирзЛ ржЖрждрж╕ ржХрж╛ржБржЪ, рж╕рж░ржЮрзНржЬрж╛ржо
ЁЯФО => ЁЯФО, ржЕржирзБрж╕ржирзНржзрж╛ржи, ржЖрждрж╕, ржХрж╛ржЪ, ржбрж╛ржиржжрж┐ржХрзЗ рж╣рзЗрж▓рж╛ржирзЛ ржЖрждрж╕ ржХрж╛ржБржЪ, рж╕рж░ржЮрзНржЬрж╛ржо
ЁЯФм => ЁЯФм, ржорж╛ржЗржХрзНрж░рзЛрж╕рзНржХрзЛржк, рж╕рж░ржЮрзНржЬрж╛ржо
ЁЯФн => ЁЯФн, ржЯрзЗрж▓рж┐рж╕рзНржХрзЛржк, рж╕рж░ржЮрзНржЬрж╛ржо
ЁЯУб => ЁЯУб, ржЕрзНржпрж╛ржирзНржЯрзЗржирж╛, ржЙржкржЧрзНрж░рж╣, ржбрж┐рж╢, рж╕рзНржпрж╛ржЯрзЗрж▓рж╛ржЗржЯ ржЕрзНржпрж╛ржирзНржЯрзЗржирж╛
ЁЯХп => ЁЯХп, ржЖрж▓рзЛ, ржорзЛржоржмрж╛рждрж┐
ЁЯТб => ЁЯТб, ржЖрж▓рзЛ, ржЖрж▓рзЛрж░ ржмрж╛рж▓рзНржм, ржХржорж┐ржХ, ржзрж╛рж░ржгрж╛, ржмрж╛рж▓рзНржм, ржмрзИржжрзНржпрзБрждрж┐ржХ
ЁЯФж => ЁЯФж, ржЖрж▓рзЛ, ржлрзНрж▓рзНржпрж╛рж╢ рж▓рж╛ржЗржЯ, ржмрзИржжрзНржпрзБрждрж┐ржХ, ржорж╢рж╛рж▓, рж╕рж░ржЮрзНржЬрж╛ржо
ЁЯПо => ЁЯПо, ржЖрж▓рзЛ, ржЬрж╛ржкрж╛ржирж┐, ржмрж╛рж░, рж▓ржгрзНржаржи, рж▓рж╛рж▓, рж▓рж╛рж▓ ржХрж╛ржЧржЬрзЗрж░ рж▓ржгрзНржаржи
ЁЯУФ => ЁЯУФ, ржЖржмрж░ржг, ржирзЛржЯржмржЗ, ржмржЗ, рж╕ржЬрзНржЬрж┐ржд, рж╕ржЬрзНржЬрж┐ржд ржорж▓рж╛ржЯржпрзБржХрзНржд ржирзЛржЯржмржЗ
ЁЯУХ => ЁЯУХ, ржмржЗ, ржмржирзНржз, ржмржирзНржз ржмржЗ
ЁЯУЦ => ЁЯУЦ, ржЦрзЛрж▓рж╛, ржЦрзЛрж▓рж╛ ржмржЗ, ржмржЗ
ЁЯУЧ => ЁЯУЧ, ржмржЗ, рж╕ржмрзБржЬ, рж╕ржмрзБржЬ ржмржЗ
ЁЯУШ => ЁЯУШ, ржирзАрж▓, ржирзАрж▓ ржмржЗ, ржмржЗ
ЁЯУЩ => ЁЯУЩ, ржХржорж▓рж╛, ржХржорж▓рж╛ ржмржЗ, ржмржЗ
ЁЯУЪ => ЁЯУЪ, ржмржЗ
ЁЯУУ => ЁЯУУ, ржирзЛржЯржмржЗ, ржирзЛржЯржмрзБржХ
ЁЯУТ => ЁЯУТ, ржЦрж╛рждрж╛, ржирзЛржЯржмржЗ
ЁЯУГ => ЁЯУГ, ржХрзБржирзНржбрж▓рзА ржкрж╛ржХрж╛ржирзЛ, ржиржерж┐, ржкрзГрж╖рзНржарж╛, ржорзЛржбрж╝рж╛ржирзЛ ржкрзГрж╖рзНржарж╛
ЁЯУЬ => ЁЯУЬ, ржХрж╛ржЧржЬ, ржкрж╛ржХрж╛ржирзЛ
ЁЯУД => ЁЯУД, ржиржерж┐, ржкрзГрж╖рзНржарж╛, ржкрзГрж╖рзНржарж╛ржЯрж┐рж░ ржорзБржЦ ржЙржкрж░рзЗрж░ ржжрж┐ржХрзЗ
ЁЯУ░ => ЁЯУ░, ржХрж╛ржЧржЬ, рж╕ржВржмрж╛ржж, рж╕ржВржмрж╛ржжржкрждрзНрж░
ЁЯЧЮ => ЁЯЧЮ, ржХрж╛ржЧржЬ, ржкрж╛ржХрж╛ржирзЛ, рж░рзЛрж▓ ржХрж░рж╛ рж╕ржВржмрж╛ржжржкрждрзНрж░, рж╕ржВржмрж╛ржж, рж╕ржВржмрж╛ржжржкрждрзНрж░
ЁЯУС => ЁЯУС, ржЪрж┐рж╣рзНржи, ржЯрзНржпрж╛ржм, ржмрзБржХржоржорж╛рж░рзНржХ ржЯрзНржпрж╛ржм, ржмрзБржХржорж╛рж░рзНржХ, ржорж╛рж░рзНржХрж╛рж░
ЁЯФЦ => ЁЯФЦ, ржЪрж┐рж╣рзНржи, ржмрзБржХржорж╛рж░рзНржХ
ЁЯП╖ => ЁЯП╖, рж▓рзЗржмрзЗрж▓
ЁЯТ░ => ЁЯТ░, ржЯрж╛ржХрж╛, ржЯрж╛ржХрж╛ ржмрзНржпрж╛ржЧ, ржЯрж╛ржХрж╛рж░ ржмрзНржпрж╛ржЧ, ржбрж▓рж╛рж░, ржмрзНржпрж╛ржЧ
ЁЯТ┤ => ЁЯТ┤, ржЗржпрж╝рзЗржи, ржЗржпрж╝рзЗржи ржмрзНржпрж╛ржЩрзНржХржирзЛржЯ, ржХрж╛ржЧржЬрзЗрж░ ржорзБржжрзНрж░рж╛, ржЯрж╛ржХрж╛, ржирзЛржЯ, ржмрж┐рж▓, ржмрзНржпрж╛ржВржХ, ржорзБржжрзНрж░рж╛
ЁЯТ╡ => ЁЯТ╡, ржХрж╛ржЧржЬрзЗрж░ ржорзБржжрзНрж░рж╛, ржЯрж╛ржХрж╛, ржбрж▓рж╛рж░, ржбрж▓рж╛рж░ ржмрзНржпрж╛ржЩрзНржХржирзЛржЯ, ржирзЛржЯ, ржмрж┐рж▓, ржмрзНржпрж╛ржВржХ, ржорзБржжрзНрж░рж╛
ЁЯТ╢ => ЁЯТ╢, ржЗржЙрж░рзЛ, ржЗржЙрж░рзЛ ржмрзНржпрж╛ржЩрзНржХржирзЛржЯ, ржХрж╛ржЧржЬрзЗрж░ ржорзБржжрзНрж░рж╛, ржЯрж╛ржХрж╛, ржирзЛржЯ, ржмрж┐рж▓, ржмрзНржпрж╛ржВржХ, ржорзБржжрзНрж░рж╛
ЁЯТ╖ => ЁЯТ╖, ржХрж╛ржЧржЬрзЗрж░ ржорзБржжрзНрж░рж╛, ржЯрж╛ржХрж╛, ржирзЛржЯ, ржкрж╛ржЙржирзНржб, ржкрж╛ржЙржирзНржб ржмрзНржпрж╛ржЩрзНржХржирзЛржЯ, ржмрж┐рж▓, ржмрзНржпрж╛ржВржХ, ржорзБржжрзНрж░рж╛
ЁЯТ╕ => ЁЯТ╕, ржУржбрж╝рж╛, ржХрж╛ржЧржЬрзЗрж░ ржорзБржжрзНрж░рж╛, ржЯрж╛ржХрж╛, ржЯрж╛ржХрж╛рж░ рж╕рж╛ржерзЗ ржкрж╛ржЦрж╛, ржбрж▓рж╛рж░, ржбрж╛ржирж╛, ржирзЛржЯ, ржмрж┐рж▓, ржмрзНржпрж╛ржВржХ
ЁЯТ│ => ЁЯТ│, ржЛржг, ржХрж╛рж░рзНржб, ржХрзНрж░рзЗржбрж┐ржЯ ржХрж╛рж░рзНржб, ржЯрж╛ржХрж╛, ржмрзНржпрж╛ржВржХ
ЁЯТ╣ => ЁЯТ╣, ржЗржпрж╝рзЗржи, ржЗржпрж╝рзЗржирзЗрж░ рж╕рж╛ржерзЗ ржХрзНрж░ржоржмрж░рзНржзржорж╛ржи ржЪрж╛рж░рзНржЯ, ржЙрж░рзНржзрзНржмржЧрж╛ржорзА, ржЧрзНрж░рж╛ржл, ржЪрж╛рж░рзНржЯ, ржЯрж╛ржХрж╛, ржкрзНрж░ржмржгрждрж╛, ржмрж╛ржЬрж╛рж░, ржмрзГржжрзНржзрж┐, ржмрзНржпрж╛ржВржХ, ржорзБржжрзНрж░рж╛
ЁЯТ▒ => ЁЯТ▒, ржЯрж╛ржХрж╛, ржмрж┐ржирж┐ржоржпрж╝, ржмрзНржпрж╛ржВржХ, ржорзБржжрзНрж░рж╛, ржорзБржжрзНрж░рж╛ ржмрж┐ржирж┐ржоржпрж╝
ЁЯТ▓ => ЁЯТ▓, ржЦрзБржм ржмржбрж╝ ржбрж▓рж╛рж░рзЗрж░ ржЪрж┐рж╣рзНржи, ржЯрж╛ржХрж╛, ржбрж▓рж╛рж░, ржорзБржжрзНрж░рж╛
тЬЙ => тЬЙ, ржЗ-ржорзЗрж▓, ржЗржорзЗрж▓, ржЦрж╛ржо
ЁЯУз => ЁЯУз, ржЗ-ржорзЗрж▓, ржЗржорзЗрж▓, ржЪрж┐ржарж┐, ржорзЗрж▓
ЁЯУи => ЁЯУи, ржЖржЧржд, ржЖржЧржд ржЦрж╛ржо, ржЗ-ржорзЗрж▓, ржЗржорзЗрж▓, ржЦрж╛ржо, ржЧрзНрж░рж╣ржг, ржЪрж┐ржарж┐, ржорзЗрж▓
ЁЯУй => ЁЯУй, ржЗ-ржорзЗрж▓, ржЗржорзЗрж▓, ржЦрж╛ржо, ржЪрж┐ржарж┐, рждрзАрж░, рждрзАрж░рзЗрж░ рж╕рж╛ржерзЗ ржЦрж╛ржо, ржирж┐ржорзНржиржорзБржЦрзА, ржкрзНрж░рзЗрж░рж┐ржд, ржмрж╣рж┐рж░рзНржЧрж╛ржорзА, ржорзЗрж▓
ЁЯУд => ЁЯУд, ржЖржЙржЯржмржХрзНрж╕, ржЖржЙржЯржмржХрзНрж╕ ржЯрзНрж░рзЗ, ржЪрж┐ржарж┐, ржЯрзНрж░рзЗ, ржкрзНрж░рзЗрж░рж┐ржд, ржмрж╛ржХрзНрж╕, ржорзЗрж▓
ЁЯУе => ЁЯУе, ржЗржиржмржХрзНрж╕, ржЗржиржмржХрзНрж╕ ржЯрзНрж░рзЗ, ржЧрзНрж░рж╣ржг, ржЪрж┐ржарж┐, ржЯрзНрж░рзЗ, ржмрж╛ржХрзНрж╕, ржорзЗрж▓
ЁЯУж => ЁЯУж, ржкрзНржпрж╛ржХрзЗржЬ, ржмрж╛ржХрзНрж╕, ржорзЛржбрж╝ржХ
ЁЯУл => ЁЯУл, ржЙрждрзНржерж┐ржд ржкрждрж╛ржХрж╛рж░ рж╕рж╛ржерзЗ ржмржирзНржз ржорзЗрж▓ржмрж╛ржХрзНрж╕, ржбрж╛ржХ ржмрж╛ржХрзНрж╕, ржмржирзНржз, ржорзЗрж▓, ржорзЗрж▓ржмрж╛ржХрзНрж╕
ЁЯУк => ЁЯУк, ржбрж╛ржХ ржмрж╛ржХрзНрж╕, ржиржд, ржиржд ржХрж░рж╛ ржкрждрж╛ржХрж╛рж░ рж╕рж╛ржерзЗ ржмржирзНржз ржорзЗрж▓ржмрж╛ржХрзНрж╕, ржмржирзНржз, ржорзЗрж▓, ржорзЗрж▓ржмрж╛ржХрзНрж╕
ЁЯУм => ЁЯУм, ржЙрждрзНржерж┐ржд ржкрждрж╛ржХрж╛рж░ рж╕рж╛ржерзЗ ржЦрзЛрж▓рж╛ ржорзЗрж▓ржмрж╛ржХрзНрж╕, ржЦрзЛрж▓рж╛, ржбрж╛ржХ ржмрж╛ржХрзНрж╕, ржорзЗрж▓, ржорзЗрж▓ржмрж╛ржХрзНрж╕
ЁЯУн => ЁЯУн, ржЦрзЛрж▓рж╛, ржбрж╛ржХ ржмрж╛ржХрзНрж╕, ржиржд, ржиржд ржкрждрж╛ржХрж╛рж░ рж╕рж╛ржерзЗ ржЦрзЛрж▓рж╛ ржорзЗрж▓ржмрж╛ржХрзНрж╕, ржорзЗрж▓, ржорзЗрж▓ржмрж╛ржХрзНрж╕
ЁЯУо => ЁЯУо, ржкрзЛрж╕рзНржЯржмржХрзНрж╕, ржорзЗрж▓, ржорзЗрж▓ржмрж╛ржХрзНрж╕
ЁЯЧ│ => ЁЯЧ│, ржмрж╛ржХрзНрж╕, ржмрзНржпрж╛рж▓ржЯ, ржмрзНржпрж╛рж▓ржЯрзЗрж░ рж╕рж╛ржерзЗ ржмрзНржпрж╛рж▓ржЯ ржмржХрзНрж╕
тЬП => тЬП, ржкрзЗржирж╕рж┐рж▓
тЬТ => тЬТ, ржХрж▓ржо, ржХрж╛рж▓рзЛ ржирж┐ржм, ржирж┐ржм
ЁЯЦЛ => ЁЯЦЛ, ржХрж▓ржо, ржлрж╛ржЙржирзНржЯрзЗржи, ржлрж╛ржЙржирзНржЯрзЗржи ржкрзЗржи
ЁЯЦК => ЁЯЦК, ржкрзЗржи, ржмрж▓ржкрзЗржи
ЁЯЦМ => ЁЯЦМ, ржкрзЗржЗржирзНржЯ ржмрзНрж░рж╛рж╢, ржкрзЗржирзНржЯрж┐ржВ
ЁЯЦН => ЁЯЦН, ржХрзНрж░рзЗржпрж╝ржи
ЁЯУЭ => ЁЯУЭ, ржкрзЗржирзНрж╕рж┐рж▓, ржорзЗржорзЛ
ЁЯТ╝ => ЁЯТ╝, ржмрзНрж░рж┐ржлржХрзЗрж╕
ЁЯУБ => ЁЯУБ, ржлрж╛ржЗрж▓, ржлрж╛ржЗрж▓ ржлрзЛрж▓рзНржбрж╛рж░, ржлрзЛрж▓рзНржбрж╛рж░
ЁЯУВ => ЁЯУВ, ржЦрзЛрж▓рж╛, ржлрж╛ржЗрж▓, ржлрж╛ржЗрж▓ ржлрзЛрж▓рзНржбрж╛рж░ ржЦрзЛрж▓рж╛, ржлрзЛрж▓рзНржбрж╛рж░
ЁЯЧВ => ЁЯЧВ, ржХрж╛рж░рзНржб, ржХрж╛рж░рзНржбрзЗрж░ рж╕рзВржЪрзАрж░ ржмрж┐ржнрж╛ржЬржХ, ржмрж┐ржнржХрзНржд, рж╕рзВржЪржХ
ЁЯУЕ => ЁЯУЕ, ржХрзНржпрж╛рж▓рзЗржирзНржбрж╛рж░, рждрж╛рж░рж┐ржЦ
ЁЯУЖ => ЁЯУЖ, ржХрзНржпрж╛рж▓рзЗржирзНржбрж╛рж░, ржЯрж┐ржпрж╝рж╛рж░-ржЕржл ржХрзНржпрж╛рж▓рзЗржирзНржбрж╛рж░
ЁЯЧТ => ЁЯЧТ, ржирзЛржЯ, ржкрзЗржБржЪрж╛ржирзЛ, ржкрзНржпрж╛ржб, рж╕рзНржкрж╛ржЗрж░рж╛рж▓ ржирзЛржЯржкрзНржпрж╛ржб
ЁЯЧУ => ЁЯЧУ, ржХрзНржпрж╛рж▓рзЗржирзНржбрж╛рж░, ржкрзЗржБржЪрж╛ржирзЛ, ржкрзНржпрж╛ржб, рж╕рзНржкрж╛ржЗрж░рж╛рж▓ ржХрзНржпрж╛рж▓рзЗржирзНржбрж╛рж░
ЁЯУЗ => ЁЯУЗ, ржХрж╛рж░рзНржб, ржХрж╛рж░рзНржбрзЗрж░ рж╕рзВржЪрзА, рж░рзЛрж▓рзЛржбрзЗржХрзНрж╕, рж╕рзВржЪржХ
ЁЯУИ => ЁЯУИ, ржЙрж░рзНржзрзНржмржорзБржЦрзА, ржХрзНрж░ржоржмрж░рзНржзржорж╛ржи ржЪрж╛рж░рзНржЯ, ржЧрзНрж░рж╛ржл, ржЪрж╛рж░рзНржЯ, ржкрзНрж░ржмржгрждрж╛, ржмрзГржжрзНржзрж┐
ЁЯУЙ => ЁЯУЙ, ржХрзНрж░ржорж╣рзНрж░рж╛рж╕ржорж╛ржи ржЪрж╛рж░рзНржЯ, ржЧрзНрж░рж╛ржл, ржЪрж╛рж░рзНржЯ, ржирж┐ржорзНржиржорзБржЦрзА, ржкрзНрж░ржмржгрждрж╛
ЁЯУК => ЁЯУК, ржЧрзНрж░рж╛ржл, ржЪрж╛рж░рзНржЯ, ржмрж╛рж░, ржмрж╛рж░ ржЪрж╛рж░рзНржЯ
ЁЯУЛ => ЁЯУЛ, ржХрзНрж▓рж┐ржкржмрзЛрж░рзНржб
ЁЯУМ => ЁЯУМ, ржкрж┐ржи, ржкрзБрж╢ржкрж┐ржи
ЁЯУН => ЁЯУН, ржЧрзЛрж▓рж╛ржХрж╛рж░ ржкрзБрж╢ржкрж┐ржи, ржкрж┐ржи, ржкрзБрж╢ ржкрж┐ржи
ЁЯУО => ЁЯУО, ржкрзЗржкрж╛рж░ржХрзНрж▓рж┐ржк
ЁЯЦЗ => ЁЯЦЗ, ржкрзЗржкрж╛рж░ ржХрзНрж▓рж┐ржк, рж▓рж┐ржВржХ, рж╕ржВржпрзБржХрзНржд ржкрзЗржкрж╛рж░ ржХрзНрж▓рж┐ржк
ЁЯУП => ЁЯУП, рж░рзБрж▓рж╛рж░, рж╕рзЛржЬрж╛ ржкрзНрж░рж╛ржирзНржд, рж╕рзЛржЬрж╛ рж░рзБрж▓рж╛рж░
ЁЯУР => ЁЯУР, рждрзНрж░рж┐ржнрзБржЬ, рждрзНрж░рж┐ржнрзБржЬрж╛ржХрзГрждрж┐ рж░рзБрж▓рж╛рж░, рж░рзБрж▓рж╛рж░, рж╕рзЗржЯ
тЬВ => тЬВ, ржХрж╛ржБржЪрж┐, рж╕рж░ржЮрзНржЬрж╛ржо
ЁЯЧГ => ЁЯЧГ, ржХрж╛рж░рзНржб, ржХрж╛рж░рзНржбрзЗрж░ ржлрж╛ржЗрж▓ ржмржХрзНрж╕, ржлрж╛ржЗрж▓, ржмрж╛ржХрзНрж╕
ЁЯЧД => ЁЯЧД, ржХрзНржпрж╛ржмрж┐ржирзЗржЯ, ржлрж╛ржЗрж▓, ржлрж╛ржЗрж▓рзЗрж░ ржХрзНржпрж╛ржмрж┐ржирзЗржЯ
ЁЯЧС => ЁЯЧС, ржирзЛржВрж░рж╛ ржлрзЗрж▓рж╛рж░ ржЭрзБржбрж╝рж┐, ржмрж╛ржЬрзЗ ржХрж╛ржЧржЬ ржлрзЗрж▓рж╛рж░ ржЭрзБржБржбрж╝рж┐
ЁЯФТ => ЁЯФТ, рждрж╛рж▓рж╛ ржмржирзНржз, ржмржирзНржз
ЁЯФУ => ЁЯФУ, ржЦрзЛрж▓рж╛, ржЦрзЛрж▓рж╛ рждрж╛рж▓рж╛, рждрж╛рж▓рж╛, рждрж╛рж▓рж╛ ржЦрзЛрж▓рж╛
ЁЯФП => ЁЯФП, ржХрж▓ржо, ржХрж╛рж▓рж┐, ржЧрзЛржкржирзАржпрж╝рждрж╛, рждрж╛рж▓рж╛, ржирж┐ржм, ржкрзЗржирзЗрж░ рж╕рж╛ржерзЗ рждрж╛рж▓рж╛
ЁЯФР => ЁЯФР, ржЪрж╛ржмрж┐, ржЪрж╛ржмрж┐ ржжрж┐ржпрж╝рзЗ рждрж╛рж▓рж╛ ржмржирзНржз ржХрж░рж╛, рждрж╛рж▓рж╛, ржирж┐рж░рж╛ржкржж, ржмржирзНржз
ЁЯФС => ЁЯФС, ржЪрж╛ржмрж┐, рждрж╛рж▓рж╛, ржкрж╛рж╕ржУржпрж╝рж╛рж░рзНржб
ЁЯЧЭ => ЁЯЧЭ, ржЪрж╛ржмрж┐, рждрж╛рж▓рж╛, ржкрзБрж░рж╛ржирзЛ, ржкрзБрж░рзЛржирзЛ ржЪрж╛ржмрж┐, рж╕рзВрждрзНрж░
ЁЯФи => ЁЯФи, рж╕рж░ржЮрзНржЬрж╛ржо, рж╣рж╛рждрзБржбрж╝рж┐
тЫП => тЫП, ржХрзБржбрж╝рж╛рж▓, ржЦржиржи, рж╕рж░ржЮрзНржЬрж╛ржо
тЪТ => тЪТ, ржЧрж╛ржЗрждрж┐, рж╕рж░ржЮрзНржЬрж╛ржо, рж╣рж╛рждрзБржбрж╝рж┐, рж╣рж╛рждрзБржбрж╝рж┐ ржПржмржВ ржХрзБржбрж╝рж╛рж▓
ЁЯЫа => ЁЯЫа, рж░рзЗржЮрзНржЪ, рж╕рж░ржЮрзНржЬрж╛ржо, рж╣рж╛рждрзБржбрж╝рж┐, рж╣рж╛рждрзБржбрж╝рж┐ ржПржмржВ рж░рзЗржЮрзНржЪ
ЁЯЧб => ЁЯЧб, ржЕрж╕рзНрждрзНрж░, ржЫрзБрж░рж┐
тЪФ => тЪФ, ржЕрж╕рзНрждрзНрж░, ржЖржбрж╝рж╛ржЖржбрж╝рж┐ ржнрж╛ржмрзЗ ржерж╛ржХрж╛, ржЖржбрж╝рж╛ржЖржбрж╝рж┐ рж░рж╛ржЦрж╛ рждрж▓рзЛржпрж╝рж╛рж░, рждрж▓рзЛржпрж╝рж╛рж░
ЁЯФл => ЁЯФл, ржЕрж╕рзНрждрзНрж░, ржкрж┐рж╕рзНрждрж▓, ржмржирзНржжрзБржХ, рж░рж┐ржнрж▓ржмрж╛рж░, рж╕рж░ржЮрзНржЬрж╛ржо
ЁЯП╣ => ЁЯП╣, ржЕрж╕рзНрждрзНрж░, рждрзАрж░, рждрзАрж░ ржзржирзБржХ, рждрзАрж░ржирзНржжрж╛ржЬ, ржзржирзБ, ржирзЛржпрж╝рж╛ржи, рж░рж╛рж╢рж┐ржЪржХрзНрж░, рж╕рж░ржЮрзНржЬрж╛ржо
ЁЯЫб => ЁЯЫб, ржЕрж╕рзНрждрзНрж░, ржврж╛рж▓
ЁЯФз => ЁЯФз, рж░рзЗржЮрзНржЪ, рж╕рж░ржЮрзНржЬрж╛ржо
ЁЯФй => ЁЯФй, ржирж╛ржЯ, ржирж╛ржЯ ржПржмржВ ржмрзЛрж▓рзНржЯ, ржмрзЛрж▓рзНржЯ, рж╕рж░ржЮрзНржЬрж╛ржо
тЪЩ => тЪЩ, ржЧрж┐ржпрж╝рж╛рж░, рж╕рж░ржЮрзНржЬрж╛ржо
ЁЯЧЬ => ЁЯЧЬ, ржХрзНрж▓рзНржпрж╛ржорзНржк, ржнрж╛ржЗрж╕, рж╕рж░ржЮрзНржЬрж╛ржо
тЪЧ => тЪЧ, ржЕрзНржпрж╛рж▓рзЗржоржмрж┐ржХ, рж░рж╕рж╛ржпрж╝ржи, рж╕рж░ржЮрзНржЬрж╛ржо
тЪЦ => тЪЦ, ржУржЬржи, рждрзБрж▓рж╛, рждрзБрж▓рж╛ рж░рж╛рж╢рж┐, ржмрж┐ржЪрж╛рж░, ржнрж╛рж░рж╕рж╛ржорзНржп, ржнрж╛рж░рж╕рж╛ржорзНржп рж╕рзНржХрзЗрж▓, рж░рж╛рж╢рж┐ржЪржХрзНрж░, рж╕рж░ржЮрзНржЬрж╛ржо
ЁЯФЧ => ЁЯФЧ, рж▓рж┐ржВржХ, рж▓рж┐ржЩрзНржХ
тЫУ => тЫУ, ржЪрзЗржи, рж╢рзГржЩрзНржЦрж▓
ЁЯТЙ => ЁЯТЙ, ржЕрж╕рзБрж╕рзНрже, ржУрж╖рзБржз, ржбрж╛ржХрзНрждрж╛рж░, рж╢ржЯ, рж╕рж░ржЮрзНржЬрж╛ржо, рж╕рж┐рж░рж┐ржЮрзНржЬ, рж╕рзВржБржЪ
ЁЯТК => ЁЯТК, ржЕрж╕рзБрж╕рзНрже, ржУрж╖рзБржз, ржбрж╛ржХрзНрждрж╛рж░, ржмржбрж╝рж┐
ЁЯЪм => ЁЯЪм, ржзрзБржорзНрж░ржкрж╛ржи, рж╕рж┐ржЧрж╛рж░рзЗржЯ
тЪ░ => тЪ░, ржХржлрж┐ржи, ржорзГрждрзНржпрзБ
тЪ▒ => тЪ▒, ржЕржирзНрждрзЗрж╖рзНржЯрзНржпрж┐ ржХрзНрж░рж┐ржпрж╝рж╛ржХрж░рзНржорзЗрж░ ржкрж╛рждрзНрж░, ржЕржирзНрждрзНржпрзЗрж╖рзНржЯрж┐ржХрзНрж░рж┐ржпрж╝рж╛, ржкрж╛рждрзНрж░, ржорзГрждрзНржпрзБ
ЁЯЧ┐ => ЁЯЧ┐, ржорзБржЦ, ржорзВрж░рзНрждрж┐, ржорзЛржЖржЗ, ржорзЛржпрж╝рж╛ржЗ
ЁЯЫв => ЁЯЫв, ржбрзНрж░рж╛ржо, рждрзЗрж▓, рждрзЗрж▓рзЗрж░ ржбрзНрж░рж╛ржо
ЁЯФо => ЁЯФо, ржХрж▓рзНржкржирж╛, ржХрзНрж░рж┐рж╕рзНржЯрж╛рж▓, ржХрзНрж░рж┐рж╕рзНржЯрж╛рж▓ ржмрж▓, ржмрж▓, рж░рзВржкржХржерж╛, рж╕рж░ржЮрзНржЬрж╛ржо, рж╕рзМржнрж╛ржЧрзНржп
ЁЯЫТ => ЁЯЫТ, ржХрж╛рж░рзНржЯ, ржЯрзНрж░рж▓рж┐, рж╢ржкрж┐ржВ, рж╢ржкрж┐ржВ ржХрж╛рж░рзНржЯ
ЁЯПз => ЁЯПз, ржПржЯрж┐ржПржо, ржПржЯрж┐ржПржо ржЪрж┐рж╣рзНржи, ржЯрзЗрж▓рж╛рж░, ржмрзНржпрж╛ржВржХ, рж╕рзНржмржпрж╝ржВржХрзНрж░рж┐ржпрж╝
ЁЯЪо => ЁЯЪо, ржЬржЮрзНржЬрж╛рж▓, ржЬржЮрзНржЬрж╛рж▓ ржмрж╛ржХрзНрж╕, ржмрж┐ржи ржЪрж┐рж╣рзНржирзЗ рж▓рж┐ржЯрж╛рж░
ЁЯЪ░ => ЁЯЪ░, ржЬрж▓, ржкрж╛ржи ржХрж░рж╛, ржкрж╛ржирзАржпрж╝, ржкрзЗржпрж╝ ржЬрж▓
тЩ┐ => тЩ┐, ржкрзНрж░ржмрзЗрж╢, рж╣рзБржЗрж▓ржЪрзЗржпрж╝рж╛рж░
ЁЯЪ╣ => ЁЯЪ╣, ржкрзБрж░рзБрж╖, ржкрзБрж░рзБрж╖ржжрзЗрж░ ржХржХрзНрж╖, рж░рзЗрж╕рзНржЯрж░рзБржо, рж╢рзМржЪрж╛ржЧрж╛рж░
ЁЯЪ║ => ЁЯЪ║, ржирж╛рж░рзА, ржорж╣рж┐рж▓рж╛ржжрзЗрж░ ржХржХрзНрж╖, рж░рзЗрж╕рзНржЯрж░рзБржо, рж╢рзМржЪрж╛ржЧрж╛рж░
ЁЯЪ╗ => ЁЯЪ╗, ржЖрж░рж╛ржорзЗрж░ ржХржХрзНрж╖, рж╢рзМржЪрж╛ржЧрж╛рж░
ЁЯЪ╝ => ЁЯЪ╝, ржЪрзЗржЮрзНржЬрж┐ржВ, рж╢рж┐рж╢рзБ, рж╢рж┐рж╢рзБрж░ ржЪрж┐рж╣рзНржи
ЁЯЪ╛ => ЁЯЪ╛, ржЬрж▓, ржмрж╛ржерж░рзБржо, рж░рзЗрж╕рзНржЯрж░рзБржо
ЁЯЫВ => ЁЯЫВ, ржирж┐ржпрж╝ржирзНрждрзНрж░ржг, ржкрж╛рж╕ржкрзЛрж░рзНржЯ, ржкрж╛рж╕ржкрзЛрж░рзНржЯ ржирж┐ржпрж╝ржирзНрждрзНрж░ржг
ЁЯЫГ => ЁЯЫГ, ржХрж╛рж╕рзНржЯржо, ржХрж╛рж╕рзНржЯржорж╕
ЁЯЫД => ЁЯЫД, ржЬрж┐ржирж┐рж╕ржкрждрзНрж░ ржжрж╛ржмрж┐ ржХрж░рж╛, ржжрж╛ржмрж┐, ржмрзНржпрж╛ржЧрзЗржЬ
ЁЯЫЕ => ЁЯЫЕ, ржмрзНржпрж╛ржЧрзЗржЬ, ржорж╛рж▓ржкрждрзНрж░ ржЫрзЗржбрж╝рзЗ ржпрж╛ржУржпрж╝рж╛, рж▓ржХрж╛рж░, рж▓рж╛ржЧрзЗржЬ
тЪа => тЪа, ржзрзВржоржкрж╛ржи, рж╕рждрж░рзНржХрждрж╛
ЁЯЪ╕ => ЁЯЪ╕, ржЯрзНрж░рж╛ржлрж┐ржХ, ржкржержЪрж╛рж░рзА, ржкрж╛рж░рж╛ржкрж╛рж░, рж╢рж┐рж╢рзБрж░рж╛ ржХрзНрж░рж╕ ржХрж░ржЫрзЗ, рж╕ржирзНрждрж╛ржи
тЫФ => тЫФ, ржЯрзНрж░рж╛ржлрж┐ржХ, ржиржпрж╝, ржирж╛, ржирж┐рж╖рж┐ржжрзНржз, ржирж┐рж╖рж┐ржжрзНржз ржерж╛ржХрж╛, ржирзЛ ржПржирзНржЯрзНрж░рж┐, ржкрзНрж░ржмрзЗрж╢
ЁЯЪл => ЁЯЪл, ржиржпрж╝, ржирж╛, ржирж┐рж╖рж┐ржжрзНржз, ржкрзНрж░ржмрзЗрж╢
ЁЯЪ│ => ЁЯЪ│, ржиржпрж╝, ржирж╛, ржирж┐рж╖рж┐ржжрзНржз, ржирж┐рж╖рж┐ржжрзНржз ржерж╛ржХрж╛, ржмрж╛ржЗржХ, ржмрж╛ржЗрж╕рж╛ржЗржХрзЗрж▓, ржмрж╛ржЗрж╕рж╛ржЗржХрзЗрж▓ ржирж┐рж╖рж┐ржжрзНржз, ржпрж╛ржиржмрж╛рж╣ржи
ЁЯЪн => ЁЯЪн, ржзрзВржоржкрж╛ржи, ржзрзВржоржкрж╛ржи ржХрж░ржмрзЗржи ржирж╛, ржиржпрж╝, ржирж╛, ржирж┐рж╖рж┐ржжрзНржз, ржирж┐рж╖рж┐ржжрзНржз ржерж╛ржХрж╛
ЁЯЪп => ЁЯЪп, ржЖржмрж░рзНржЬржирж╛ ржЫржбрж╝рж╛ржмрзЗржи ржирж╛, ржЬржЮрзНржЬрж╛рж▓, ржиржпрж╝, ржирж╛, ржирж┐рж╖рж┐ржжрзНржз, ржирж┐рж╖рж┐ржжрзНржз ржерж╛ржХрж╛
ЁЯЪ▒ => ЁЯЪ▒, ржЬрж▓, ржиржпрж╝, ржирж╛, ржирж┐рж╖рж┐ржжрзНржз, ржирж┐рж╖рж┐ржжрзНржз ржерж╛ржХрж╛, ржкрж╛ржи ржХрж░рж╛, ржкрж╛ржирзАржпрж╝, ржкрзЗржпрж╝ ржЬрж▓ ржиржпрж╝
ЁЯЪ╖ => ЁЯЪ╖, ржиржпрж╝, ржирж╛, ржирж┐рж╖рж┐ржжрзНржз, ржирж┐рж╖рж┐ржжрзНржз ржерж╛ржХрж╛, ржкржержЪрж╛рж░рзА, ржпрж╛рждрзНрж░рзА ржкрж╛рж░рж╛ржкрж╛рж░ ржирж┐рж╖рзЗржз
ЁЯУ╡ => ЁЯУ╡, ржХрзЛржирзЛ ржорзЛржмрж╛ржЗрж▓ ржлрзЛржи ржирзЗржЗ, ржЯрзЗрж▓рж┐ржлрзЛржи, ржиржпрж╝, ржирж╛, ржирж┐рж╖рж┐ржжрзНржз, ржирж┐рж╖рж┐ржжрзНржз ржерж╛ржХрж╛, ржлрзЛржи, ржорзЛржмрж╛ржЗрж▓, рж╕рзЗрж▓
ЁЯФЮ => ЁЯФЮ, 18, ржЕржкрж░рж┐ржгржд, ржЖржарж╛рж░рзЛ, ржЖржарж╛рж░рзЛрж░ ржоржзрзНржпрзЗ ржХрзЗржЙ ржирзЗржЗ, ржиржпрж╝, ржирж╛, ржирж┐рж╖рж┐ржжрзНржз, ржирж┐рж╖рж┐ржжрзНржз ржерж╛ржХрж╛, ржмржпрж╝рж╕ рж╕рзАржорж╛
тШв => тШв, ржЪрж┐рж╣рзНржи, рж░рзЗржбрж┐ржУржЕрзНржпрж╛ржХржЯрж┐ржн
тШг => тШг, ржЪрж┐рж╣рзНржи, ржмрж╛ржпрж╝рзЛрж╣рзНржпрж╛ржЬрж╛рж░рзНржб
тмЖ => тмЖ, ржЙрждрзНрждрж░, ржЙржкрж░рзЗ рждрзАрж░, рждрзАрж░, ржжрж┐ржХ, ржжрж┐ржЧржирж┐рж░рзНржгржпрж╝
тЖЧ => тЖЧ, ржЖржирзНрждржГ ржжрж┐ржЧржирж┐рж░рзНржгржпрж╝, ржЙрждрзНрждрж░-ржкрзВрж░рзНржм, ржЙржкрж░рзЗ ржбрж╛ржирзЗ рждрзАрж░, рждрзАрж░, ржжрж┐ржХ
тЮб => тЮб, ржбрж╛ржиржжрж┐ржХрзЗрж░ рждрзАрж░, рждрзАрж░, ржжрж┐ржХ, ржжрж┐ржЧржирж┐рж░рзНржгржпрж╝, ржкрзВрж░рзНржм
тЖШ => тЖШ, ржЖржирзНрждржГ ржжрж┐ржЧржирж┐рж░рзНржгржпрж╝, рждрзАрж░, ржжржХрзНрж╖рж┐ржг-ржкрзВрж░рзНржм, ржжрж┐ржХ, ржирзАржЪрзЗ ржбрж╛ржирзЗ рждрзАрж░
тмЗ => тмЗ, рждрзАрж░, ржжржХрзНрж╖рж┐ржг, ржжрж┐ржХ, ржжрж┐ржЧржирж┐рж░рзНржгржпрж╝, ржирж┐ржЪрзЗ, ржирзАржЪрзЗрж░ рждрзАрж░
тЖЩ => тЖЩ, ржЖржирзНрждржГ ржжрж┐ржЧржирж┐рж░рзНржгржпрж╝, рждрзАрж░, ржжржХрзНрж╖рж┐ржг-ржкрж╢рзНржЪрж┐ржо, ржжрж┐ржХ, ржирзАржЪрзЗрж░ ржмрж╛ржорзЗ рждрзАрж░
тмЕ => тмЕ, рждрзАрж░, ржжрж┐ржХ, ржжрж┐ржЧржирж┐рж░рзНржгржпрж╝, ржкрж╢рзНржЪрж┐ржо, ржмрж╛ржо рждрзАрж░
тЖЦ => тЖЦ, ржЖржирзНрждржГ ржжрж┐ржЧржирж┐рж░рзНржгржпрж╝, ржЙрждрзНрждрж░-ржкрж╢рзНржЪрж┐ржо, ржЙржкрж░рзЗ ржмрж╛ржорзЗ рждрзАрж░, рждрзАрж░, ржжрж┐ржХ
тЖХ => тЖХ, ржЙржкрж░рзЗ ржирзАржЪрзЗ рждрзАрж░, рждрзАрж░
тЖФ => тЖФ, рждрзАрж░, ржмрж╛ржорзЗ-ржбрж╛ржирзЗ рждрзАрж░
тЖй => тЖй, ржбрж╛ржи рждрзАрж░ ржмрж╛ржжрж┐ржХрзЗ ржмрж╛ржБржХрж╛ржирзЛ, рждрзАрж░
тЖк => тЖк, рждрзАрж░, ржмрж╛ржо рждрзАрж░ ржбрж╛ржи ржжрж┐ржХрзЗ ржмрж╛ржБржХрж╛ржирзЛ
тд┤ => тд┤, ржбрж╛ржи рждрзАрж░ ржЙржкрж░рзЗрж░ ржжрж┐ржХрзЗ ржмрж╛ржБржХрж╛ржирзЛ, рждрзАрж░
тд╡ => тд╡, ржбрж╛ржи рждрзАрж░ ржирзАржЪрзЗрж░ ржжрж┐ржХрзЗ ржмрж╛ржБржХрж╛ржирзЛ, рждрзАрж░, ржирж┐ржорзНржиржорзБржЦрзА
ЁЯФГ => ЁЯФГ, ржШржбрж╝рж┐рж░ ржХрж╛ржБржЯрж╛рж░ ржЙрж▓рзНрж▓ржорзНржм рждрзАрж░, ржШржбрж╝рж┐рж░ ржХрж╛ржБржЯрж╛рж░ ржжрж┐ржХрзЗ, рждрзАрж░, ржкрзБржирж░рж╛ржпрж╝ рж▓рзЛржб
ЁЯФД => ЁЯФД, ржШржбрж╝рж┐рж░ ржХрж╛ржБржЯрж╛рж░ ржмрж┐ржкрж░рзАржд ржжрж┐ржХрзЗ, ржШржбрж╝рж┐рж░ ржХрж╛ржБржЯрж╛рж░ ржмрж┐ржкрж░рзАржд ржжрж┐ржХрзЗ ржШрзЛрж░рж╛, ржШржбрж╝рж┐рж░ ржХрж╛ржБржЯрж╛рж░ ржмрж┐ржкрж░рзАрждрзЗ рждрзАрж░ ржмрзЛрждрж╛ржо, рждрзАрж░
ЁЯФЩ => ЁЯФЩ, рждрзАрж░, ржкрж┐ржЫржирзЗ, ржкрж┐ржЫржирзЗ рждрзАрж░
ЁЯФЪ => ЁЯФЪ, рждрзАрж░, рж╢рзЗрж╖, рж╢рзЗрж╖рзЗрж░ рждрзАрж░
ЁЯФЫ => ЁЯФЫ, ржЕржи! рждрзАрж░, ржЪрж╛рж▓рзБ, ржЪрж┐рж╣рзНржи, рждрзАрж░
ЁЯФЬ => ЁЯФЬ, рждрзАрж░, рж╢рзАржШрзНрж░ рждрзАрж░, рж╢рзАржШрзНрж░ржЗ
ЁЯФЭ => ЁЯФЭ, ржЙрж░рзНржжрзНржзржорзБржЦрзА, рждрзАрж░, рж╢рзАрж░рзНрж╖, рж╢рзАрж░рзНрж╖рзЗрж░ рждрзАрж░
ЁЯЫР => ЁЯЫР, ржЙржкрж╛рж╕ржирж╛рж░ рж╕рзНржерж╛ржи, ржзрж░рзНржо, ржкрзВржЬрж╛
тЪЫ => тЪЫ, ржХржгрж┐ржХрж╛рж░ ржЪрж┐рж╣рзНржи, ржирж╛рж╕рзНрждрж┐ржХ, ржкрж░ржорж╛ржгрзБ
ЁЯХЙ => ЁЯХЙ, ржУржо, ржзрж░рзНржо, рж╣рж┐ржирзНржжрзБ
тЬб => тЬб, ржЗрж╣рзБржжрж┐, ржЗрж╣рзБржжрж┐ ржзрж░рзНржо, ржбрзЗржнрж┐ржб, ржбрзЗржнрж┐ржб ржиржХрзНрж╖рждрзНрж░, рждрж╛рж░рж╛, ржзрж░рзНржо
тШ╕ => тШ╕, ржЪрж╛ржХрж╛, ржзрж░рзНржо, ржзрж░рзНржорзЗрж░ ржЪрж╛ржХрж╛, ржмрзМржжрзНржз
тШп => тШп, ржЗржи, ржЗржи ржЗржпрж╝рж╛ржЩрзНржЧ, ржЗржпрж╝рж╛ржВ, рждрж╛ржУ, рждрж╛ржУржмрж╛ржжрзА, ржзрж░рзНржо
тЬЭ => тЬЭ, ржХрзНрж░рж╕, ржЦрзГрж╕рзНржЯрж╛ржи, ржзрж░рзНржо, рж▓рзНржпрж╛ржЯрж┐ржи ржХрзНрж░рж╕
тШж => тШж, ржЕрж░рзНржержбржХрзНрж╕ ржХрзНрж░рж╕, ржХрзНрж░рж╕, ржЦрзГрж╕рзНржЯрж╛ржи, ржзрж░рзНржо
тШк => тШк, ржЗрж╕рж▓рж╛ржо, рждрж╛рж░рж╛ ржПржмржВ ржЕрж░рзНржзржЪржирзНржжрзНрж░рж╛ржХрж╛рж░, ржзрж░рзНржо, ржорзБрж╕рж▓рж┐ржо
тШо => тШо, рж╢рж╛ржирзНрждрж┐, рж╢рж╛ржирзНрждрж┐рж░ ржЪрж┐рж╣рзНржи
ЁЯХО => ЁЯХО, ржжрзАржкрж╛ржзрж╛рж░, ржзрж░рзНржо, ржмрж╛рждрж┐ржжрж╛ржи, ржорзЗржирзЛрж░рж╛
ЁЯФп => ЁЯФп, ржбржЯ-ржпрзБржХрзНржд ржЫржЯрж┐ ржкржпрж╝рзЗржирзНржЯрзЗрж░ рждрж╛рж░рж╛, рждрж╛рж░рж╛, рж╕рзМржнрж╛ржЧрзНржп
тЩИ => тЩИ, ржорзЗрж╖, рж░рж╛рж╢рж┐ржЪржХрзНрж░
тЩЙ => тЩЙ, ржмрзБрж▓, ржмрзГрж╖, рж░рж╛рж╢рж┐ржЪржХрзНрж░
тЩК => тЩК, ржорж┐ржерзБржи, ржорж┐ржерзБржирж░рж╛рж╢рж┐, рж░рж╛рж╢рж┐ржЪржХрзНрж░
тЩЛ => тЩЛ, ржХрж░рзНржХржЯ, ржХрж░рзНржХржЯрж░рж╛рж╢рж┐, рж░рж╛рж╢рж┐ржЪржХрзНрж░
тЩМ => тЩМ, рж░рж╛рж╢рж┐ржЪржХрзНрж░, рж╕рж┐ржВрж╣
тЩН => тЩН, ржХржирзНржпрж╛, ржХрзБржорж╛рж░рзА, рж░рж╛рж╢рж┐ржЪржХрзНрж░
тЩО => тЩО, рждрзБрж▓рж╛, ржмрж┐ржЪрж╛рж░, ржнрж╛рж░рж╕рж╛ржорзНржп, рж░рж╛рж╢рж┐ржЪржХрзНрж░
тЩП => тЩП, ржмрзГрж╢рзНржЪрж┐ржХ, рж░рж╛рж╢рж┐ржЪржХрзНрж░
тЩР => тЩР, ржзржирзБ, рж░рж╛рж╢рж┐ржЪржХрзНрж░
тЩС => тЩС, ржоржХрж░, рж░рж╛рж╢рж┐ржЪржХрзНрж░
тЩТ => тЩТ, ржХрзБржорзНржн, ржЬрж▓, рж░рж╛рж╢рж┐ржЪржХрзНрж░
тЩУ => тЩУ, ржорзАржи, рж░рж╛рж╢рж┐ржЪржХрзНрж░
тЫО => тЫО, ржЕржлрж┐ржЙржЪрзБрж╕, ржмрж╛рж╣ржХ, рж░рж╛рж╢рж┐ржЪржХрзНрж░, рж╕рж╛ржк
ЁЯФА => ЁЯФА, ржЕржжрж▓ржмржжрж▓ ржЯрзНрж░рзНржпрж╛ржХ ржмрзЛрждрж╛ржо, ржЖржбрж╝рж╛ржЖржбрж╝рж┐ ржнрж╛ржмрзЗ ржЕржжрж▓ржмржжрж▓ ржХрж░рж╛, рждрзАрж░
ЁЯФБ => ЁЯФБ, ржШржбрж╝рж┐рж░ ржХрж╛ржБржЯрж╛рж░ ржжрж┐ржХрзЗ, рждрзАрж░, ржкрзБржирж░рж╛ржмрзГрждрзНрждрж┐, ржкрзБржирж░рж╛ржпрж╝ ржХрж░рж╛рж░ ржмрзЛрждрж╛ржо
ЁЯФВ => ЁЯФВ, ржПржХржмрж╛рж░, ржШржбрж╝рж┐рж░ ржХрж╛ржБржЯрж╛рж░ ржжрж┐ржХрзЗ, рждрзАрж░, ржкрзБржирж░рж╛ржпрж╝ ржХрж░рж╛рж░ ржПржХржХ ржмрзЛрждрж╛ржо
тЦ╢ => тЦ╢, ржЪрж╛рж▓рж╛ржирзЛ, ржбрж╛ржиржжрж┐ржХ, рждрзАрж░, рждрзНрж░рж┐ржнрзБржЬ, ржкрзНрж▓рзЗ ржмрзЛрждрж╛ржо
тПй => тПй, ржЕржЧрзНрж░ржмрж░рзНрждрзА, рждрзАрж░, ржжрзНржмрж┐ржЧрзБржг, ржжрзНрж░рзБржд, ржлрж╛рж╕рзНржЯ-ржлрж░рзЛржпрж╝рж╛рж░рзНржб ржмрзЛрждрж╛ржо
тПн => тПн, рждрзАрж░, рждрзНрж░рж┐ржнрзБржЬ, ржкрж░ржмрж░рзНрждрзА ржЯрзНрж░рзНржпрж╛ржХ, ржкрж░ржмрж░рзНрждрзА ржЯрзНрж░рзНржпрж╛ржХрзЗрж░ ржмрзЛрждрж╛ржо, ржкрж░рзЗрж░ ржжрзГрж╢рзНржп
тПп => тПп, ржЦрзЗрж▓рж╛, ржбрж╛ржи, рждрзАрж░, рждрзНрж░рж┐ржнрзБржЬ, ржкрзНрж▓рзЗ ржмрж╛ ржмрж┐рж░рждрж┐ ржмрзЛрждрж╛ржо, ржмрж┐рж░рждрж┐
тЧА => тЧА, рждрзАрж░, рждрзНрж░рж┐ржнрзБржЬ, ржмрж╛ржо, ржмрж┐ржкрж░рзАржд, рж░рж┐ржнрж╛рж░рзНрж╕ ржмрзЛрждрж╛ржо
тПк => тПк, рждрзАрж░, ржжрзНржмрж┐ржЧрзБржг, ржжрзНрж░рзБржд рж░рж┐ржнрж╛рж░рзНрж╕ ржмрзЛрждрж╛ржо, ржкрж┐ржЫржирзЗ ржлрзЗрж░рж╛
тПо => тПо, рждрзАрж░, рждрзНрж░рж┐ржнрзБржЬ, ржкрзВрж░рзНржмржмрж░рзНрждрзА ржЯрзНрж░рзНржпрж╛ржХ, ржкрзВрж░рзНржмржмрж░рзНрждрзА ржжрзГрж╢рзНржп, рж╢рзЗрж╖рзЗрж░ ржЯрзНрж░рзНржпрж╛ржХ ржмрзЛрждрж╛ржо
ЁЯФ╝ => ЁЯФ╝, ржЙржкрж░рзЗрж░ ржмрзЛрждрж╛ржо, рждрзАрж░, ржмрзЛрждрж╛ржо, рж▓рж╛рж▓
тПл => тПл, рждрзАрж░, ржжрзНржмрж┐ржЧрзБржг, ржжрзНрж░рзБржд ржЙржкрж░рзЗрж░ ржмрзЛрждрж╛ржо
ЁЯФ╜ => ЁЯФ╜, рждрзАрж░, ржирж┐ржЪрзЗ, ржирзАржЪрзЗрж░ ржмрзЛрждрж╛ржо, ржмрзЛрждрж╛ржо, рж▓рж╛рж▓
тПм => тПм, рждрзАрж░, ржжрзНржмрж┐ржЧрзБржг, ржжрзНрж░рзБржд ржирзАржЪрзЗрж░ ржмрзЛрждрж╛ржо, ржирж┐ржЪрзЗ
тП╕ => тП╕, ржЙрж▓рзНрж▓ржорзНржм, ржжрзНржмрж┐ржЧрзБржг, ржмрж╛рж░, ржмрж┐рж░рждрж┐, ржмрж┐рж░рждрж┐ ржмрзЛрждрж╛ржо
тП╣ => тП╣, ржмржирзНржз, ржмржирзНржз ржмрзЛрждрж╛ржо, ржмрж░рзНржЧрж╛ржХрж╛рж░
тП║ => тП║, ржмрзГрждрзНржд, рж░рзЗржХрж░рзНржб, рж░рзЗржХрж░рзНржб ржмрзЛрждрж╛ржо
тПП => тПП, ржЗржЬрзЗржХрзНржЯ ржмрзЛрждрж╛ржо, ржорзЛржЫрж╛
ЁЯОж => ЁЯОж, ржХрзНржпрж╛ржорзЗрж░рж╛, ржлрж┐рж▓рзНржо, ржорзБржнрж┐, рж╕рж┐ржирзЗржорж╛
ЁЯФЕ => ЁЯФЕ, ржЕржирзБржЬрзНржЬрзНржмрж▓ ржмрзЛрждрж╛ржо, ржЕрж╕рзНржкрж╖рзНржЯ, ржЙржЬрзНржЬрзНржмрж▓рждрж╛, ржХржо
ЁЯФЖ => ЁЯФЖ, ржЙржЬрзНржЬрзНржмрж▓, ржЙржЬрзНржЬрзНржмрж▓ ржмрзЛрждрж╛ржо, ржЙржЬрзНржЬрзНржмрж▓рждрж╛
ЁЯУ╢ => ЁЯУ╢, ржЕрзНржпрж╛ржирзНржЯрзЗржирж╛, ржЕрзНржпрж╛ржирзНржЯрзЗржирж╛ ржжржгрзНржб, ржЯрзЗрж▓рж┐ржлрзЛржи, ржлрзЛржи, ржмрж╛рж░, ржорзЛржмрж╛ржЗрж▓, рж╕рж┐ржЧржирзНржпрж╛рж▓, рж╕рзЗрж▓
ЁЯУ│ => ЁЯУ│, ржХржорзНржкржи, ржЯрзЗрж▓рж┐ржлрзЛржи, ржлрзЛржи, ржнрж╛ржЗржмрзНрж░рзЗрж╢ржи ржорзЛржб, ржорзЛржб, ржорзЛржмрж╛ржЗрж▓, рж╕рзЗрж▓
ЁЯУ┤ => ЁЯУ┤, ржЯрзЗрж▓рж┐ржлрзЛржи, ржлрзЛржи, ржмржирзНржз, ржорзЛржмрж╛ржЗрж▓, ржорзЛржмрж╛ржЗрж▓ ржлрзЛржи ржмржирзНржз, рж╕рзЗрж▓
тЩА => тЩА, ржорж╣рж┐рж▓рж╛, рж╕рзНрждрзНрж░рж┐, рж╕рзНрждрзНрж░рзА ржЪрж┐рж╣рзНржи
тЩВ => тЩВ, ржЫрзЗрж▓рзЗ, ржкрзБрж░рзБрж╖, ржкрзБрж░рзБрж╖ ржЪрж┐рж╣рзНржи
тЪХ => тЪХ, ржЕрзНржпрж╛рж╕ржХрзНрж▓рж┐ржкрж┐ржпрж╝рж╕, ржФржпржж, ржЪрж┐ржХрж┐рзОрж╕рж╛, ржЪрж┐ржХрж┐рзОрж╕рж╛рж░ ржЪрж┐рж╣рзНржи, рж╕рзНржЯрж╛ржл
тЩ╗ => тЩ╗, ржкрзБржирж░рзНржмрзНржпржмрж╣рж╛рж░, рж░рж┐рж╕рж╛ржЗржХрзЗрж▓рж┐ржВ ржЪрж┐рж╣рзНржи
тЪЬ => тЪЬ, ржкрзБрж╖рзНржкржмрж┐рж╢рзЗрж╖, ржлрзНрж▓рж╛рж░-ржбрж┐-рж▓рж┐рж╕ (ржПржХржзрж░ржирзЗрж░ ржлрзБрж▓)
ЁЯФ▒ => ЁЯФ▒, ржЬрж╛рж╣рж╛ржЬ, рждрзНрж░рж┐рж╢рзВрж▓, рждрзНрж░рж┐рж╢рзВрж▓ ржкрзНрж░рждрзАржХ, ржирзЛржЩрзНржЧрж░, ржкрзНрж░рждрзАржХ, рж╕рж░ржЮрзНржЬрж╛ржо
ЁЯУЫ => ЁЯУЫ, ржирж╛ржо, ржирж╛ржорзЗрж░ ржмрзНржпрж╛ржЬ, ржмрзНржпрж╛ржЬ
ЁЯФ░ => ЁЯФ░, ржЬрж╛ржкрж╛ржирж┐, ржкрж╛рждрж╛, рж╢рж┐ржХрзНрж╖рж╛ржиржмрж┐рж╕, рж╢рж┐ржХрзНрж╖рж╛ржиржмрж┐рж╕ржжрзЗрж░ ржЬржирзНржп ржЬрж╛ржкрж╛ржирзА ржкрзНрж░рждрзАржХ, рж╢рзЗржнрзНрж░ржи, рж╕ржмрзБржЬ, рж╕рж░ржЮрзНржЬрж╛ржо, рж╣рж▓рзБржж
тнХ => тнХ, ржЕржирзЗржХ ржмржбрж╝ ржмрзГрждрзНржд, ржЗржВрж░рж╛ржЬрзА тАШржУтАЩ ржЪрж┐рж╣рзНржи, ржмрзГрждрзНржд
тЬЕ => тЬЕ, ржЦрзБржм ржмржбрж╝ рж╕рж╛ржжрж╛ ржЪрзЗржХ ржорж╛рж░рзНржХ, ржЪрж┐рж╣рзНржи, ржЯрж┐ржХ
тШС => тШС, ржЪрзЗржХрзЗрж░ рж╕рж╛ржерзЗ ржмрзНржпрж╛рж▓ржЯ ржмржХрзНрж╕, ржЯрж┐ржХ, ржмрж╛ржХрзНрж╕, ржмрзНржпрж╛рж▓ржЯ
тЬФ => тЬФ, ржЕржирзЗржХ ржмржбрж╝ ржЪрзЗржХ ржорж╛рж░рзНржХ, ржЪрж┐рж╣рзНржи, ржЯрж┐ржХ
тЬЦ => тЬЦ, ржЕржирзЗржХ ржмржбрж╝ ржЧрзБржг ржЪрж┐рж╣рзНржи, ржПржХрзНрж╕, ржЧрзБржг, ржЧрзБржи ржХрж░рж╛, ржмрж╛рждрж┐рж▓
тЭМ => тЭМ, ржПржХрзНрж╕, ржХрзНрж░рж╕ ржорж╛рж░рзНржХ, ржЧрзБржг, ржЧрзБржи ржХрж░рж╛, ржЪрж┐рж╣рзНржи, ржмрж╛рждрж┐рж▓
тЭО => тЭО, ржХрзНрж░рж╕ ржорж╛рж░рзНржХрзЗрж░ ржмрзЛрждрж╛ржо, ржЪрж┐рж╣рзНржи, ржмрж░рзНржЧрж╛ржХрж╛рж░
тЮХ => тЮХ, ржЕржирзЗржХ ржмржбрж╝ ржпрзЛржЧ ржЪрж┐рж╣рзНржи, ржЧржгрж┐ржд, ржпрзЛржЧ
тЮЦ => тЮЦ, ржЕржирзЗржХ ржмржбрж╝ ржмрж┐ржпрж╝рзЛржЧ ржЪрж┐рж╣рзНржи, ржЧржгрж┐ржд, ржмрж┐ржпрж╝рзЛржЧ
тЮЧ => тЮЧ, ржЕржирзЗржХ ржмржбрж╝ ржнрж╛ржЧрзЗрж░ ржЪрж┐рж╣рзНржи, ржЧржгрж┐ржд, ржмрж┐ржнрж╛ржЧ
тЮ░ => тЮ░, ржХрж╛рж░рзНрж▓рж┐ рж▓рзБржк, ржХрзБржирзНржбрж▓рзА ржкрж╛ржХрж╛ржирзЛ, рж▓рзБржк
тЮ┐ => тЮ┐, ржХрзБржирзНржбрж▓рзА ржкрж╛ржХрж╛ржирзЛ, ржжрзБржЯрж┐ ржХрж╛рж░рзНрж▓рж┐ рж▓рзБржк, ржжрзНржмрж┐ржЧрзБржг, рж▓рзБржк
уА╜ => уА╜, ржЕржВрж╢, ржЕржВрж╢ ржкрж░рж┐ржмрж░рзНрждржирзЗрж░ ржЪрж┐рж╣рзНржи, ржЪрж┐рж╣рзНржи
тЬ│ => тЬ│, ржЖржЯржЯрж┐ -рж╕рзНржкрзЛржХрзЗрж░ рждрж╛рж░ржХрж╛ржЪрж┐рж╣рзНржи, рждрж╛рж░ржХрж╛ржЪрж┐рж╣рзНржи
тЬ┤ => тЬ┤, ржЖржЯржЯрж┐ ржкржпрж╝рзЗржирзНржЯрзЗрж░ рждрж╛рж░рж╛, рждрж╛рж░рж╛
тЭЗ => тЭЗ, ржЬрзНржмрж▓ржЬрзНржмрж▓ ржХрж░рж╛, ржжрзНржпрзБрждрж┐
тА╝ => тА╝, ржЪрж┐рж╣рзНржи, ржжрзБржЯрж┐ ржмрж┐рж╕рзНржоржпрж╝ржмрзЛржзржХ ржЪрж┐рж╣рзНржи, ржмрж┐рж╕рзНржоржпрж╝ржмрзЛржзржХ, ржмрзНржпрж╛ржВ ржмрзНржпрж╛ржВ, ржпрждрж┐ржЪрж┐рж╣рзНржи
тБЙ => тБЙ, ржПржХржЗрж╕рж╛ржерзЗ ржмрж┐рж╕рзНржоржпрж╝ржмрзЛржзржХ ржПржмржВ ржкрзНрж░рж╢рзНржиржмрзЛржзржХ, ржЪрж┐рж╣рзНржи, ржкрзНрж░рж╢рзНржи, ржмрж┐рж╕рзНржоржпрж╝ржмрзЛржзржХ, ржмрж┐рж╕рзНржоржпрж╝ржмрзЛржзржХ ржкрзНрж░рж╢рзНржиржмрзЛржзржХ ржЪрж┐рж╣рзНржи, ржпрждрж┐ржЪрж┐рж╣рзНржи
тЭУ => тЭУ, ржЪрж┐рж╣рзНржи, ржкрзНрж░рж╢рзНржи, ржкрзНрж░рж╢рзНржиржмрзЛржзржХ ржЪрж┐рж╣рзНржи, ржпрждрж┐ржЪрж┐рж╣рзНржи
тЭФ => тЭФ, ржЪрж┐рж╣рзНржи, ржкрзНрж░рж╢рзНржи, ржпрждрж┐ржЪрж┐рж╣рзНржи, рж░рзВржкрж░рзЗржЦрж╛, рж╕рж╛ржжрж╛ ржкрзНрж░рж╢рзНржиржмрзЛржзржХ ржЪрж┐рж╣рзНржи
тЭХ => тЭХ, ржЪрж┐рж╣рзНржи, ржмрж┐рж╕рзНржоржпрж╝ржмрзЛржзржХ, ржпрждрж┐ржЪрж┐рж╣рзНржи, рж░рзВржкрж░рзЗржЦрж╛, рж╕рж╛ржжрж╛ ржмрж┐рж╕рзНржоржпрж╝ржмрзЛржзржХ ржЪрж┐рж╣рзНржи
тЭЧ => тЭЧ, ржЪрж┐рж╣рзНржи, ржмрж┐рж╕рзНржоржпрж╝ржмрзЛржзржХ, ржмрж┐рж╕рзНржоржпрж╝ржмрзЛржзржХ ржЪрж┐рж╣рзНржи, ржпрждрж┐ржЪрж┐рж╣рзНржи
уА░ => уА░, ржбрзНржпрж╛рж╢, рждрж░ржЩрзНржЧрж╛ржпрж╝рж┐ржд, рждрж░ржЩрзНржЧрж╛ржпрж╝рж┐ржд ржбрзНржпрж╛рж╢, ржпрждрж┐ржЪрж┐рж╣рзНржи
┬й => ┬й, ржХржкрж┐рж░рж╛ржЗржЯ
┬о => ┬о, ржиржерж┐ржнрзБржХрзНржд, ржирж┐ржмржирзНржзрж┐ржд
тДв => тДв, TM, ржЪрж┐рж╣рзНржи, ржЯрзНрж░рзЗржб ржорж╛рж░рзНржХ, ржЯрзНрж░рзЗржбржорж╛рж░рзНржХ
ЁЯТп => ЁЯТп, 100, ржПржХрж╢рзЛ ржкржпрж╝рзЗржирзНржЯ, ржкрзВрж░рзНржг, рж╢ржд, рж╕рзНржХрзЛрж░
ЁЯФа => ЁЯФа, ржЕржХрзНрж╖рж░, ржЗржиржкрзБржЯ, ржЗржиржкрзБржЯ рж▓рж╛рждрж┐ржи ржмржбрж╝ рж╣рж╛рждрзЗрж░ ржЕржХрзНрж╖рж░, ржмржбрж╝ рж╣рж╛рждрзЗрж░ ржЕржХрзНрж╖рж░, рж▓рж╛рждрж┐ржи
ЁЯФб => ЁЯФб, ржЕржХрзНрж╖рж░, ржЗржиржкрзБржЯ, ржЗржиржкрзБржЯ рж▓рж╛рждрж┐ржи ржЫрзЛржЯ рж╣рж╛рждрзЗрж░ ржЕржХрзНрж╖рж░, ржП ржмрж┐ рж╕рж┐ ржбрж┐, ржЫрзЛржЯ рж╣рж╛рждрзЗрж░ ржЕржХрзНрж╖рж░, рж▓рж╛рждрж┐ржи
ЁЯФв => ЁЯФв, 1234, ржЗржиржкрзБржЯ, ржЗржиржкрзБржЯ ржиржорзНржмрж░, рж╕ржВржЦрзНржпрж╛
ЁЯФг => ЁЯФг, ржЗржиржкрзБржЯ, ржЗржиржкрзБржЯ ржЪрж┐рж╣рзНржи
ЁЯФд => ЁЯФд, ржЕржХрзНрж╖рж░, ржЗржиржкрзБржЯ, ржЗржиржкрзБржЯ рж▓рж╛рждрж┐ржи ржЕржХрзНрж╖рж░, ржПржмрж┐рж╕рж┐, ржмрж░рзНржгржорж╛рж▓рж╛, рж▓рж╛рждрж┐ржи
ЁЯЕ░ => ЁЯЕ░, ржП, ржП ржмрзЛрждрж╛ржо, рж░ржХрзНржд
ЁЯЖО => ЁЯЖО, ржП ржмрж┐ ржмрзЛрждрж╛ржо, ржПржмрж┐, рж░ржХрзНржд
ЁЯЕ▒ => ЁЯЕ▒, ржмрж┐, ржмрж┐ ржмрзЛрждрж╛ржо, рж░ржХрзНржд
ЁЯЖС => ЁЯЖС, ржмрж░рзНржЧржХрзНрж╖рзЗрждрзНрж░рзЗрж░ рж╕рж┐ ржПрж▓, рж╕рж┐ржПрж▓
ЁЯЖТ => ЁЯЖТ, ржХрзБрж▓, ржмрж░рзНржЧржХрзНрж╖рзЗрждрзНрж░рзЗрж░ ржоржзрзНржпрзЗ ржХрзБрж▓
ЁЯЖУ => ЁЯЖУ, ржмрж░рзНржЧржХрзНрж╖рзЗрждрзНрж░рзЗрж░ ржоржзрзНржпрзЗ ржлрзНрж░рзА, ржмрж┐ржирж╛ржорзВрж▓рзНржпрзЗ
тД╣ => тД╣, i ржЪрж┐рж╣рзНржи, рждржерзНржп, рждржерзНржп рж╕рзВрждрзНрж░
ЁЯЖФ => ЁЯЖФ, ржЖржЗржбрж┐, ржкрж░рж┐ржЪржпрж╝, ржмрж░рзНржЧрж╛ржХрж╛рж░ ржЖржЗржбрж┐
тУВ => тУВ, ржПржо, ржмрзГрждрзНржд, ржмрзГрждрзНрждрзЗ ржерж╛ржХрж╛ ржПржо ржЕржХрзНрж╖рж░
ЁЯЖХ => ЁЯЖХ, ржирждрзБржи, ржмрж░рзНржЧржХрзНрж╖рзЗрждрзНрж░рзЗрж░ ржоржзрзНржпрзЗ ржирж┐ржЙ
ЁЯЖЦ => ЁЯЖЦ, ржПржиржЬрж┐ ржЪрж┐рж╣рзНржи, ржмрж░рзНржЧржХрзНрж╖рзЗрждрзНрж░рзЗрж░ ржоржзрзНржпрзЗ ржПржи ржЬрж┐
ЁЯЕ╛ => ЁЯЕ╛, ржЗржВрж░рж╛ржЬрзА тАШржУтАЩ ржЪрж┐рж╣рзНржи, ржУ ржмрзЛрждрж╛ржо, рж░ржХрзНржд
ЁЯЖЧ => ЁЯЖЧ, ржарж┐ржХ ржЖржЫрзЗ, ржмрж░рзНржЧржХрзНрж╖рзЗрждрзНрж░рзЗрж░ ржоржзрзНржпрзЗ ржУржХрзЗ
ЁЯЕ┐ => ЁЯЕ┐, ржкрж╛рж░рзНржХрж┐ржВ, ржкрж┐ ржмрзЛрждрж╛ржо
ЁЯЖШ => ЁЯЖШ, ржПрж╕ржУржПрж╕, ржмрж░рзНржЧржХрзНрж╖рзЗрждрзНрж░рзЗрж░ ржоржзрзНржпрзЗ ржПрж╕ ржУ ржПрж╕, рж╕рж╛рж╣рж╛ржпрзНржп
ЁЯЖЩ => ЁЯЖЩ, ржЖржк! ржмрзЛрждрж╛ржо, ржЙржкрж░рзЗтАШ рж╢рзАрж░рзНрж╖ржХ ржЪрж┐рж╣рзНржи
ЁЯЖЪ => ЁЯЖЪ, ржмржирж╛ржо, ржмрж░рзНржЧрж╛ржХрж╛рж░ ржоржзрзНржпрзЗ ржнрж┐ ржПрж╕ (ржнрж╛рж░рзНрж╕рзЗрж╕)
ЁЯИБ => ЁЯИБ, ржЬрж╛ржкрж╛ржирж┐, ржмрж░рзНржЧрж╛ржХрж╛рж░ ржХрж╛рждрж╛ржХрж╛ржирж╛ ржХрзЛржХрзЛ
ЁЯИВ => ЁЯИВ, ржЬрж╛ржкрж╛ржирж┐, ржмрж░рзНржЧрж╛ржХрж╛рж░ ржХрж╛рждрж╛ржХрж╛ржирж╛рж╕рж╛
ЁЯИ╖ => ЁЯИ╖, ржЬрж╛ржкрж╛ржирж┐, ржмрж░рзНржЧрж╛ржХрж╛рж░ ржорзБржи ржЪрж┐рждрзНрж░рж▓рж┐ржкрж┐
ЁЯИ╢ => ЁЯИ╢, ржЬрж╛ржкрж╛ржирж┐, ржмрж░рзНржЧрж╛ржХрж╛рж░ ржмрж┐ржжрзНржпржорж╛ржи ржЪрж┐рждрзНрж░рж▓рж┐ржкрж┐
ЁЯИп => ЁЯИп, ржЬрж╛ржкрж╛ржирж┐, ржмрж░рзНржЧрж╛ржХрж╛рж░ ржЖржЩрзБрж▓рзЗрж░ ржЪрж┐рждрзНрж░рж▓рж┐ржкрж┐
ЁЯЙР => ЁЯЙР, ржЧрзЛрж▓рж╛ржХрж╛рж░ рж╕рзБржмрж┐ржзрж╛ржЬржиржХ ржЪрж┐рждрзНрж░рж▓рж┐ржкрж┐, ржЬрж╛ржкрж╛ржирж┐
ЁЯИ╣ => ЁЯИ╣, ржЬрж╛ржкрж╛ржирж┐, ржмрж░рзНржЧрж╛ржХрж╛рж░ ржмрж┐ржнржХрзНржд ржЪрж┐рждрзНрж░рж▓рж┐ржкрж┐
ЁЯИЪ => ЁЯИЪ, ржЬрж╛ржкрж╛ржирж┐, ржмрж░рзНржЧрж╛ржХрж╛рж░ ржЕржкрж▓рж╛ржкрзЗрж░ ржЪрж┐рждрзНрж░рж▓рж┐ржкрж┐
ЁЯИ▓ => ЁЯИ▓, ржЬрж╛ржкрж╛ржирж┐, ржмрж░рзНржЧрж╛ржХрж╛рж░ ржирж┐рж╖рж┐ржжрзНржз ржЪрж┐рждрзНрж░рж▓рж┐ржкрж┐
ЁЯЙС => ЁЯЙС, ржЪрзАржирж╛, ржмрзГрждрзНрждрзЗрж░ ржоржзрзНржпрзЗ рж╕рзНржмрзАржХрзГржд ржЪрж┐рждрзНрж░рж▓рж┐ржкрж┐
ЁЯИ╕ => ЁЯИ╕, ржЪрзАржирж╛, ржмрж░рзНржЧрж╛ржХрж╛рж░ ржкрзНрж░ржпрзЛржЬрзНржп ржЪрж┐рждрзНрж░рж▓рж┐ржкрж┐
ЁЯИ┤ => ЁЯИ┤, ржЪрзАржирж╛, ржмрж░рзНржЧрж╛ржХрж╛рж░ ржПржХрждрзНрж░рзЗ ржЪрж┐рждрзНрж░рж▓рж┐ржкрж┐
ЁЯИ│ => ЁЯИ│, ржЪрзАржирж╛, ржмрж░рзНржЧрж╛ржХрж╛рж░ ржЦрж╛рж▓рж┐ ржЪрж┐рждрзНрж░рж▓рж┐ржкрж┐
уКЧ => уКЧ, ржЕржнрж┐ржиржирзНржжржи, ржЧрзЛрж▓рж╛ржХрж╛рж░ ржЕржнрж┐ржиржирзНржжржирзЗрж░ ржЪрж┐рждрзНрж░рж▓рж┐ржкрж┐, ржЪрзАржирж╛, ржирж┐рж╢рж╛ржи, рж╕ржВржмрж░рзНржзржирж╛
уКЩ => уКЩ, ржЧрзЛржкржи, ржЧрзЛрж▓рж╛ржХрж╛рж░ ржЧрзЛржкржи ржЪрж┐рждрзНрж░рж▓рж┐ржкрж┐, ржЪрзАржирж╛, ржирж┐рж╢рж╛ржи
ЁЯИ║ => ЁЯИ║, ржЪрзАржирж╛, ржмрж░рзНржЧрж╛ржХрж╛рж░ ржЕржкрж╛рж░рзЗржЯрж┐ржВ ржЪрж┐рждрзНрж░рж▓рж┐ржкрж┐
ЁЯИ╡ => ЁЯИ╡, ржЪрзАржирж╛, ржмрж░рзНржЧрж╛ржХрж╛рж░ ржкрзВрж░рзНржгрждрж╛рж░ ржЪрж┐рждрзНрж░рж▓рж┐ржкрж┐
тЦк => тЦк, ржХрж╛рж▓рзЛ ржЫрзЛржЯ ржмрж░рзНржЧржХрзНрж╖рзЗрждрзНрж░, ржЬрзНржпрж╛ржорж┐рждрж┐ржХ, ржмрж░рзНржЧрж╛ржХрж╛рж░
тЦл => тЦл, ржЬрзНржпрж╛ржорж┐рждрж┐ржХ, ржмрж░рзНржЧрж╛ржХрж╛рж░, рж╕рж╛ржжрж╛ ржЫрзЛржЯ ржмрж░рзНржЧржХрзНрж╖рзЗрждрзНрж░
тЧ╗ => тЧ╗, ржЬрзНржпрж╛ржорж┐рждрж┐ржХ, ржмрж░рзНржЧрж╛ржХрж╛рж░, рж╕рж╛ржжрж╛ ржорж╛ржЭрж╛рж░рж┐ ржмрж░рзНржЧржХрзНрж╖рзЗрждрзНрж░
тЧ╝ => тЧ╝, ржХрж╛рж▓рзЛ ржорж╛ржЭрж╛рж░рж┐ ржмрж░рзНржЧржХрзНрж╖рзЗрждрзНрж░, ржЬрзНржпрж╛ржорж┐рждрж┐ржХ, ржмрж░рзНржЧрж╛ржХрж╛рж░
тЧ╜ => тЧ╜, ржЬрзНржпрж╛ржорж┐рждрж┐ржХ, ржмрж░рзНржЧрж╛ржХрж╛рж░, рж╕рж╛ржжрж╛ ржорж╛ржЭрж╛рж░рж┐ ржЫрзЛржЯ ржмрж░рзНржЧржХрзНрж╖рзЗрждрзНрж░
тЧ╛ => тЧ╛, ржХрж╛рж▓рзЛ ржорж╛ржЭрж╛рж░рж┐ ржЫрзЛржЯ ржмрж░рзНржЧржХрзНрж╖рзЗрждрзНрж░, ржЬрзНржпрж╛ржорж┐рждрж┐ржХ, ржмрж░рзНржЧрж╛ржХрж╛рж░
тмЫ => тмЫ, ржХрж╛рж▓рзЛ ржмржбрж╝ ржмрж░рзНржЧржХрзНрж╖рзЗрждрзНрж░, ржЬрзНржпрж╛ржорж┐рждрж┐ржХ, ржмрж░рзНржЧрж╛ржХрж╛рж░
тмЬ => тмЬ, ржЬрзНржпрж╛ржорж┐рждрж┐ржХ, ржмрж░рзНржЧрж╛ржХрж╛рж░, рж╕рж╛ржжрж╛ ржмржбрж╝ ржмрж░рзНржЧржХрзНрж╖рзЗрждрзНрж░
ЁЯФ╢ => ЁЯФ╢, ржХржорж▓рж╛, ржХржорж▓рж╛ рж░ржЩрзЗрж░ ржмржбрж╝ рж╣рзАрж░рзЗ, ржЬрзНржпрж╛ржорж┐рждрж┐ржХ, ржбрж╛ржпрж╝ржоржирзНржб
ЁЯФ╖ => ЁЯФ╖, ржЬрзНржпрж╛ржорж┐рждрж┐ржХ, ржбрж╛ржпрж╝ржоржирзНржб, ржирзАрж▓, ржирзАрж▓ рж░ржЩрзЗрж░ ржмржбрж╝ рж╣рзАрж░рзЗ
ЁЯФ╕ => ЁЯФ╕, ржХржорж▓рж╛, ржХржорж▓рж╛ рж░ржЩрзЗрж░ ржЫрзЛржЯ рж╣рзАрж░рзЗ, ржЬрзНржпрж╛ржорж┐рждрж┐ржХ, ржбрж╛ржпрж╝ржоржирзНржб
ЁЯФ╣ => ЁЯФ╣, ржЬрзНржпрж╛ржорж┐рждрж┐ржХ, ржбрж╛ржпрж╝ржоржирзНржб, ржирзАрж▓, ржирзАрж▓ рж░ржЩрзЗрж░ ржЫрзЛржЯ рж╣рзАрж░рзЗ
ЁЯФ║ => ЁЯФ║, ржЬрзНржпрж╛ржорж┐рждрж┐ржХ, рж▓рж╛рж▓, рж▓рж╛рж▓ рждрзНрж░рж┐ржнрзБржЬ ржЙржкрж░рзЗрж░ ржжрж┐ржХрзЗ ржкржпрж╝рзЗржирзНржЯ ржХрж░рж╛
ЁЯФ╗ => ЁЯФ╗, ржЬрзНржпрж╛ржорж┐рждрж┐ржХ, ржирж┐ржорзНржиржорзБржЦрзА, рж▓рж╛рж▓, рж▓рж╛рж▓ рждрзНрж░рж┐ржнрзБржЬ ржирзАржЪрзЗрж░ ржжрж┐ржХрзЗ ржкржпрж╝рзЗржирзНржЯ ржХрж░рж╛
ЁЯТа => ЁЯТа, ржПржХржЯрж┐ ржбржЯрзЗрж░ рж╕рж╛ржерзЗ рж╣рзАрж░рзЗ, ржХржорж┐ржХ, ржЬрзНржпрж╛ржорж┐рждрж┐ржХ, ржбрж╛ржпрж╝ржоржирзНржб, ржнрж┐рждрж░рзЗ
ЁЯФШ => ЁЯФШ, ржЬрзНржпрж╛ржорж┐рждрж┐ржХ, ржмрзЛрждрж╛ржо, рж░рзЗржбрж┐ржУ, рж░рзЗржбрж┐ржУ ржмрзЛрждрж╛ржо
ЁЯФ▓ => ЁЯФ▓, ржХрж╛рж▓рзЛ ржмрж░рзНржЧрж╛ржХрж╛рж░ ржмрзЛрждрж╛ржо, ржЬрзНржпрж╛ржорж┐рждрж┐ржХ, ржмрж░рзНржЧрж╛ржХрж╛рж░, ржмрзЛрждрж╛ржо
ЁЯФ│ => ЁЯФ│, ржЬрзНржпрж╛ржорж┐рждрж┐ржХ, ржмрж░рзНржЧрж╛ржХрж╛рж░, ржмрзЛрждрж╛ржо, рж░рзВржкрж░рзЗржЦрж╛, рж╕рж╛ржжрж╛ ржмрж░рзНржЧрж╛ржХрж╛рж░ ржмрзЛрждрж╛ржо
тЪк => тЪк, ржЬрзНржпрж╛ржорж┐рждрж┐ржХ, ржмрзГрждрзНржд, рж╕рж╛ржжрж╛ ржмрзГрждрзНржд
тЪл => тЪл, ржХрж╛рж▓рзЛ ржмрзГрждрзНржд, ржЬрзНржпрж╛ржорж┐рждрж┐ржХ, ржмрзГрждрзНржд
ЁЯФ┤ => ЁЯФ┤, ржЬрзНржпрж╛ржорж┐рждрж┐ржХ, ржмрзГрждрзНржд, рж▓рж╛рж▓, рж▓рж╛рж▓ ржмрзГрждрзНржд
ЁЯФ╡ => ЁЯФ╡, ржЬрзНржпрж╛ржорж┐рждрж┐ржХ, ржирзАрж▓, ржирзАрж▓ ржмрзГрждрзНржд, ржмрзГрждрзНржд
ЁЯПБ => ЁЯПБ, ржЫржХ ржХрж╛ржЯрж╛ ржкрждрж╛ржХрж╛, ржЫржХржХрж╛ржЯрж╛, рж░рзЗрж╕рж┐ржВ
ЁЯЪй => ЁЯЪй, рждрзНрж░рж┐ржнрзБржЬрж╛ржХрзГрждрж┐ ржкрждрж╛ржХрж╛, ржкрзЛрж╕рзНржЯ
ЁЯОМ => ЁЯОМ, ржЖржбрж╝рж╛ржЖржбрж╝рж┐ ржЕржмрж╕рзНржерж╛ржпрж╝ ржерж╛ржХрж╛, ржЖржбрж╝рж╛ржЖржбрж╝рж┐ ржЕржмрж╕рзНржерж╛ржпрж╝ ржерж╛ржХрж╛ ржкрждрж╛ржХрж╛, ржЙржжржпрж╛ржкржи, ржХрзНрж░рж╕, ржЬрж╛ржкрж╛ржирж┐
ЁЯП┤ => ЁЯП┤, ржХрж╛рж▓рзЛ ржкрждрж╛ржХрж╛ ржУржбрж╝рж╛ржирзЛ, рждрж░ржЩрзНржЧрж╛ржпрж╝рж┐ржд
ЁЯП│ => ЁЯП│, рждрж░ржЩрзНржЧрж╛ржпрж╝рж┐ржд, рж╕рж╛ржжрж╛ ржкрждрж╛ржХрж╛ ржУржбрж╝рж╛ржирзЛ
ЁЯП│тАНЁЯМИ => ЁЯП│тАНЁЯМИ, ржкрж╛рждрж╛ржХ, рж░рж╛ржоржзржирзБ, рж░рж╛ржоржзржирзБ ржкрждрж╛ржХрж╛
ЁЯЗжЁЯЗи => ЁЯЗжЁЯЗи, ржЕрзНржпрж╛рж╕рж╕рзЗржирж╢ржи ржЖржЗрж▓рзНржпрж╛ржирзНржб
ЁЯЗжЁЯЗй => ЁЯЗжЁЯЗй, ржЖржирзНржбрзЛрж░рж╛
ЁЯЗжЁЯЗк => ЁЯЗжЁЯЗк, рж╕ржВржпрзБржХрзНржд ржЖрж░ржм ржЖржорж┐рж░рж╛ржд
ЁЯЗжЁЯЗл => ЁЯЗжЁЯЗл, ржЖржлржЧрж╛ржирж┐рж╕рзНрждрж╛ржи
ЁЯЗжЁЯЗм => ЁЯЗжЁЯЗм, ржЕрзНржпрж╛ржирзНржЯрж┐ржЧрзБржпрж╝рж╛ ржУ ржмрж╛рж░ржмрзБржбрж╛
ЁЯЗжЁЯЗо => ЁЯЗжЁЯЗо, ржПрзНржпрж╛ржЩрзНржЧрзБржЗрж▓рж╛
ЁЯЗжЁЯЗ▒ => ЁЯЗжЁЯЗ▒, ржЖрж▓ржмрзЗржирж┐ржпрж╝рж╛
ЁЯЗжЁЯЗ▓ => ЁЯЗжЁЯЗ▓, ржЖрж░рзНржорзЗржирж┐ржпрж╝рж╛
ЁЯЗжЁЯЗ┤ => ЁЯЗжЁЯЗ┤, ржЕрзНржпрж╛ржЩрзНржЧрзЛрж▓рж╛
ЁЯЗжЁЯЗ╢ => ЁЯЗжЁЯЗ╢, ржЕрзНржпрж╛ржирзНржЯрж╛рж░рзНржХржЯрж┐ржХрж╛
ЁЯЗжЁЯЗ╖ => ЁЯЗжЁЯЗ╖, ржЖрж░рзНржЬрзЗржирзНржЯрж┐ржирж╛
ЁЯЗжЁЯЗ╕ => ЁЯЗжЁЯЗ╕, ржЖржорзЗрж░рж┐ржХрж╛ржи рж╕рж╛ржорзЛржпрж╝рж╛
ЁЯЗжЁЯЗ╣ => ЁЯЗжЁЯЗ╣, ржЕрж╕рзНржЯрзНрж░рж┐ржпрж╝рж╛
ЁЯЗжЁЯЗ║ => ЁЯЗжЁЯЗ║, ржЕрж╕рзНржЯрзНрж░рзЗрж▓рж┐ржпрж╝рж╛
ЁЯЗжЁЯЗ╝ => ЁЯЗжЁЯЗ╝, ржЖрж░рзБржмрж╛
ЁЯЗжЁЯЗ╜ => ЁЯЗжЁЯЗ╜, ржЖрж▓рж╛ржирзНржб ржжрзНржмрзАржкржкрзБржЮрзНржЬ
ЁЯЗжЁЯЗ┐ => ЁЯЗжЁЯЗ┐, ржЖржЬрж╛рж░ржмрж╛ржЗржЬрж╛ржи
ЁЯЗзЁЯЗж => ЁЯЗзЁЯЗж, ржмрж╕ржирж┐ржпрж╝рж╛ ржУ рж╣рж╛рж░рзНржЬрзЗржЧрзЛржнрж┐ржирж╛
ЁЯЗзЁЯЗз => ЁЯЗзЁЯЗз, ржмрж╛рж░ржмрж╛ржжрзЛрж╕
ЁЯЗзЁЯЗй => ЁЯЗзЁЯЗй, ржмрж╛ржВрж▓рж╛ржжрзЗрж╢
ЁЯЗзЁЯЗк => ЁЯЗзЁЯЗк, ржмрзЗрж▓ржЬрж┐ржпрж╝рж╛ржо
ЁЯЗзЁЯЗл => ЁЯЗзЁЯЗл, ржмрзБрж░ржХрж┐ржирж╛ ржлрж╛рж╕рзЛ
ЁЯЗзЁЯЗм => ЁЯЗзЁЯЗм, ржмрзБрж▓ржЧрзЗрж░рж┐ржпрж╝рж╛
ЁЯЗзЁЯЗн => ЁЯЗзЁЯЗн, ржмрж╛рж╣рж░рж╛ржЗржи
ЁЯЗзЁЯЗо => ЁЯЗзЁЯЗо, ржмрзБрж░рзБржирзНржбрж┐
ЁЯЗзЁЯЗп => ЁЯЗзЁЯЗп, ржмрзЗржирж┐ржи
ЁЯЗзЁЯЗ▒ => ЁЯЗзЁЯЗ▒, рж╕рзЗржирзНржЯ ржмрж╛рж░ржерзЗрж▓рж┐ржорж┐
ЁЯЗзЁЯЗ▓ => ЁЯЗзЁЯЗ▓, ржмрж╛рж░ржорзБржбрж╛
ЁЯЗзЁЯЗ│ => ЁЯЗзЁЯЗ│, ржмрзНрж░рзБржирзЗржЗ
ЁЯЗзЁЯЗ┤ => ЁЯЗзЁЯЗ┤, ржмрж▓рж┐ржнрж┐ржпрж╝рж╛
ЁЯЗзЁЯЗ╢ => ЁЯЗзЁЯЗ╢, ржХрзНржпрж╛рж░рж┐ржмрж┐ржпрж╝рж╛ржи ржирзЗржжрж╛рж░рж▓рзНржпрж╛ржирзНржбрж╕
ЁЯЗзЁЯЗ╖ => ЁЯЗзЁЯЗ╖, ржмрзНрж░рж╛ржЬрж┐рж▓
ЁЯЗзЁЯЗ╕ => ЁЯЗзЁЯЗ╕, ржмрж╛рж╣рж╛ржорж╛ ржжрзНржмрзАржкржкрзБржЮрзНржЬ
ЁЯЗзЁЯЗ╣ => ЁЯЗзЁЯЗ╣, ржнрзБржЯрж╛ржи
ЁЯЗзЁЯЗ╗ => ЁЯЗзЁЯЗ╗, ржмрзЛржнрзЗржЯ ржжрзНржмрзАржк
ЁЯЗзЁЯЗ╝ => ЁЯЗзЁЯЗ╝, ржмрждрж╕рзЛржпрж╝рж╛ржирж╛
ЁЯЗзЁЯЗ╛ => ЁЯЗзЁЯЗ╛, ржмрзЗрж▓рж╛рж░рзБрж╢
ЁЯЗзЁЯЗ┐ => ЁЯЗзЁЯЗ┐, ржмрзЗрж▓рж┐ржЬ
ЁЯЗиЁЯЗж => ЁЯЗиЁЯЗж, ржХрж╛ржирж╛ржбрж╛
ЁЯЗиЁЯЗи => ЁЯЗиЁЯЗи, ржХрзЛржХрзЛрж╕ (ржХрж┐рж▓рж┐ржВ) ржжрзНржмрзАржкржкрзБржЮрзНржЬ
ЁЯЗиЁЯЗй => ЁЯЗиЁЯЗй, ржХржЩрзНржЧрзЛ-ржХрж┐ржирж╢рж╛рж╕рж╛
ЁЯЗиЁЯЗл => ЁЯЗиЁЯЗл, ржоржзрзНржп ржЖржлрзНрж░рж┐ржХрж╛рж░ ржкрзНрж░ржЬрж╛рждржирзНрждрзНрж░
ЁЯЗиЁЯЗм => ЁЯЗиЁЯЗм, ржХржЩрзНржЧрзЛ - ржмрзНрж░рж╛ржЬрж╛ржнрж┐рж▓
ЁЯЗиЁЯЗн => ЁЯЗиЁЯЗн, рж╕рзБржЗржЬрж╛рж░рж▓рзНржпрж╛ржирзНржб
ЁЯЗиЁЯЗо => ЁЯЗиЁЯЗо, ржХрзЛржд ржжрж┐ржнрзЛржпрж╝рж╛рж░
ЁЯЗиЁЯЗ░ => ЁЯЗиЁЯЗ░, ржХрзБржХ ржжрзНржмрзАржкржкрзБржЮрзНржЬ
ЁЯЗиЁЯЗ▒ => ЁЯЗиЁЯЗ▒, ржЪрж┐рж▓рж┐
ЁЯЗиЁЯЗ▓ => ЁЯЗиЁЯЗ▓, ржХрзНржпрж╛ржорзЗрж░рзБржи
ЁЯЗиЁЯЗ│ => ЁЯЗиЁЯЗ│, ржЪрзАржи
ЁЯЗиЁЯЗ┤ => ЁЯЗиЁЯЗ┤, ржХрж▓ржорзНржмрж┐ржпрж╝рж╛
ЁЯЗиЁЯЗ╡ => ЁЯЗиЁЯЗ╡, ржХрзНрж▓рж┐ржкрж╛рж░ржЯржи ржЖржЗрж▓рзНржпрж╛ржирзНржб
ЁЯЗиЁЯЗ╖ => ЁЯЗиЁЯЗ╖, ржХрзЛрж╕рзНржЯрж╛рж░рж┐ржХрж╛
ЁЯЗиЁЯЗ║ => ЁЯЗиЁЯЗ║, ржХрж┐ржЙржмрж╛
ЁЯЗиЁЯЗ╗ => ЁЯЗиЁЯЗ╗, ржХрзЗржкржнрж╛рж░рзНржжрзЗ
ЁЯЗиЁЯЗ╝ => ЁЯЗиЁЯЗ╝, ржХрзБрж░рж╛рж╕рж╛ржУ
ЁЯЗиЁЯЗ╜ => ЁЯЗиЁЯЗ╜, ржХрзНрж░рж┐рж╕ржорж╛рж╕ ржжрзНржмрзАржк
ЁЯЗиЁЯЗ╛ => ЁЯЗиЁЯЗ╛, рж╕рж╛ржЗржкрзНрж░рж╛рж╕
ЁЯЗиЁЯЗ┐ => ЁЯЗиЁЯЗ┐, ржЪрзЗржЪрж┐ржпрж╝рж╛
ЁЯЗйЁЯЗк => ЁЯЗйЁЯЗк, ржЬрж╛рж░рзНржорж╛ржирж┐
ЁЯЗйЁЯЗм => ЁЯЗйЁЯЗм, ржжрж┐ржпрж╝рзЗржЧрзЛ ржЧрж╛рж░рзНрж╕рж┐ржпрж╝рж╛
ЁЯЗйЁЯЗп => ЁЯЗйЁЯЗп, ржЬрж┐ржмрзБрждрж┐
ЁЯЗйЁЯЗ░ => ЁЯЗйЁЯЗ░, ржбрзЗржиржорж╛рж░рзНржХ
ЁЯЗйЁЯЗ▓ => ЁЯЗйЁЯЗ▓, ржбрзЛржорж┐ржирж┐ржХрж╛
ЁЯЗйЁЯЗ┤ => ЁЯЗйЁЯЗ┤, ржбрзЛржорзЗржирж┐ржХрж╛ржи ржкрзНрж░ржЬрж╛рждржирзНрждрзНрж░
ЁЯЗйЁЯЗ┐ => ЁЯЗйЁЯЗ┐, ржЖрж▓ржЬрзЗрж░рж┐ржпрж╝рж╛
ЁЯЗкЁЯЗж => ЁЯЗкЁЯЗж, ржХрзБржЙржЯрж╛ ржПржмржВ ржорзЗрж▓рж┐рж▓рж╛
ЁЯЗкЁЯЗи => ЁЯЗкЁЯЗи, ржЗржХрзБржпрж╝рзЗржбрж░
ЁЯЗкЁЯЗк => ЁЯЗкЁЯЗк, ржПрж╕рзНрждрзЛржирж┐ржпрж╝рж╛
ЁЯЗкЁЯЗм => ЁЯЗкЁЯЗм, ржорж┐рж╢рж░
ЁЯЗкЁЯЗн => ЁЯЗкЁЯЗн, ржкрж╢рзНржЪрж┐ржо рж╕рж╛рж╣рж╛рж░рж╛
ЁЯЗкЁЯЗ╖ => ЁЯЗкЁЯЗ╖, ржЗрж░рж┐рждрзНрж░рж┐ржпрж╝рж╛
ЁЯЗкЁЯЗ╕ => ЁЯЗкЁЯЗ╕, рж╕рзНржкрзЗржи
ЁЯЗкЁЯЗ╣ => ЁЯЗкЁЯЗ╣, ржЗржерж┐ржУржкрж┐ржпрж╝рж╛
ЁЯЗкЁЯЗ║ => ЁЯЗкЁЯЗ║, ржЗржЙрж░рзЛржкрзАржпрж╝ ржЗржЙржирж┐ржпрж╝ржи
ЁЯЗкЁЯЗ┐ => ЁЯЗкЁЯЗ┐, ржЗржЙрж░рзЛржЬрзЛржи
ЁЯЗлЁЯЗо => ЁЯЗлЁЯЗо, ржлрж┐ржирж▓рзНржпрж╛ржирзНржб
ЁЯЗлЁЯЗп => ЁЯЗлЁЯЗп, ржлрж┐ржЬрж┐
ЁЯЗлЁЯЗ░ => ЁЯЗлЁЯЗ░, ржлржХрж▓рзНржпрж╛ржирзНржб ржжрзНржмрзАржкржкрзБржЮрзНржЬ
ЁЯЗлЁЯЗ▓ => ЁЯЗлЁЯЗ▓, ржорж╛ржЗржХрзНрж░рзЛржирзЗрж╢рж┐ржпрж╝рж╛
ЁЯЗлЁЯЗ┤ => ЁЯЗлЁЯЗ┤, ржлрзНржпрж╛рж░ржУ ржжрзНржмрзАржкржкрзБржЮрзНржЬ
ЁЯЗлЁЯЗ╖ => ЁЯЗлЁЯЗ╖, ржлрзНрж░рж╛ржирзНрж╕
ЁЯЗмЁЯЗж => ЁЯЗмЁЯЗж, ржЧрзНржпрж╛ржмржи
ЁЯЗмЁЯЗз => ЁЯЗмЁЯЗз, ржпрзБржХрзНрждрж░рж╛ржЬрзНржп
ЁЯЗмЁЯЗй => ЁЯЗмЁЯЗй, ржЧрзНрж░рзЗржирж╛ржбрж╛
ЁЯЗмЁЯЗк => ЁЯЗмЁЯЗк, ржЬрж░рзНржЬрж┐ржпрж╝рж╛
ЁЯЗмЁЯЗл => ЁЯЗмЁЯЗл, ржлрж░рж╛рж╕рзА ржЧрж╛ржпрж╝рж╛ржирж╛
ЁЯЗмЁЯЗм => ЁЯЗмЁЯЗм, ржЧрзБржпрж╝рж╛рж░рзНржирж╕рж┐
ЁЯЗмЁЯЗн => ЁЯЗмЁЯЗн, ржШрж╛ржирж╛
ЁЯЗмЁЯЗо => ЁЯЗмЁЯЗо, ржЬрж┐ржмрзНрж░рж╛рж▓рзНржЯрж╛рж░
ЁЯЗмЁЯЗ▒ => ЁЯЗмЁЯЗ▒, ржЧрзНрж░рзАржирж▓рзНржпрж╛ржирзНржб
ЁЯЗмЁЯЗ▓ => ЁЯЗмЁЯЗ▓, ржЧрж╛ржорзНржмрж┐ржпрж╝рж╛
ЁЯЗмЁЯЗ│ => ЁЯЗмЁЯЗ│, ржЧрж┐ржирж┐
ЁЯЗмЁЯЗ╡ => ЁЯЗмЁЯЗ╡, ржЧрзБржпрж╝рж╛ржжрзЗрж▓рзМржк
ЁЯЗмЁЯЗ╢ => ЁЯЗмЁЯЗ╢, ржирж┐рж░ржХрзНрж╖рзАржпрж╝ ржЧрж┐ржирж┐
ЁЯЗмЁЯЗ╖ => ЁЯЗмЁЯЗ╖, ржЧрзНрж░рзАрж╕
ЁЯЗмЁЯЗ╕ => ЁЯЗмЁЯЗ╕, ржжржХрзНрж╖рж┐ржг ржЬрж░рзНржЬрж┐ржпрж╝рж╛ ржУ ржжржХрзНрж╖рж┐ржг рж╕рзНржпрж╛ржирзНржбржЙржЗржЪ ржжрзНржмрзАржкржкрзБржЮрзНржЬ
ЁЯЗмЁЯЗ╣ => ЁЯЗмЁЯЗ╣, ржЧрзБржпрж╝рж╛рждрзЗржорж╛рж▓рж╛
ЁЯЗмЁЯЗ║ => ЁЯЗмЁЯЗ║, ржЧрзБржпрж╝рж╛ржо
ЁЯЗмЁЯЗ╝ => ЁЯЗмЁЯЗ╝, ржЧрж┐ржирж┐-ржмрж┐рж╕рж╛ржЙ
ЁЯЗмЁЯЗ╛ => ЁЯЗмЁЯЗ╛, ржЧрж┐ржпрж╝рж╛ржирж╛
ЁЯЗнЁЯЗ░ => ЁЯЗнЁЯЗ░, рж╣ржВржХржВ ржПрж╕ржПржЖрж░ ржЪрзАржирж╛
ЁЯЗнЁЯЗ▓ => ЁЯЗнЁЯЗ▓, рж╣рж╛рж░рзНржб ржПржмржВ ржорзНржпрж╛ржХржбрзЛржирж╛рж▓рзНржб ржжрзНржмрзАржкржкрзБржЮрзНржЬ
ЁЯЗнЁЯЗ│ => ЁЯЗнЁЯЗ│, рж╣ржирзНржбрзБрж░рж╛рж╕
ЁЯЗнЁЯЗ╖ => ЁЯЗнЁЯЗ╖, ржХрзНрж░рзЛржпрж╝рзЗрж╢рж┐ржпрж╝рж╛
ЁЯЗнЁЯЗ╣ => ЁЯЗнЁЯЗ╣, рж╣рж╛ржЗрждрж┐
ЁЯЗнЁЯЗ║ => ЁЯЗнЁЯЗ║, рж╣рж╛ржЩрзНржЧрзЗрж░рж┐
ЁЯЗоЁЯЗи => ЁЯЗоЁЯЗи, ржХрзНржпрж╛ржирж╛рж░рж┐ ржжрзНржмрзАржкржкрзБржЮрзНржЬ
ЁЯЗоЁЯЗй => ЁЯЗоЁЯЗй, ржЗржирзНржжрзЛржирзЗрж╢рж┐ржпрж╝рж╛
ЁЯЗоЁЯЗк => ЁЯЗоЁЯЗк, ржЖржпрж╝рж╛рж░рж▓рзНржпрж╛ржирзНржб
ЁЯЗоЁЯЗ▒ => ЁЯЗоЁЯЗ▒, ржЗржЬрж░рж╛ржпрж╝рзЗрж▓
ЁЯЗоЁЯЗ▓ => ЁЯЗоЁЯЗ▓, ржЖржЗрж▓ ржЕржл ржорзНржпрж╛ржи
ЁЯЗоЁЯЗ│ => ЁЯЗоЁЯЗ│, ржнрж╛рж░ржд
ЁЯЗоЁЯЗ┤ => ЁЯЗоЁЯЗ┤, ржмрзНрж░рж┐ржЯрж┐рж╢ ржнрж╛рж░ржд ржорж╣рж╛рж╕рж╛ржЧрж░рзАржпрж╝ ржЕржЮрзНржЪрж▓
ЁЯЗоЁЯЗ╢ => ЁЯЗоЁЯЗ╢, ржЗрж░рж╛ржХ
ЁЯЗоЁЯЗ╖ => ЁЯЗоЁЯЗ╖, ржЗрж░рж╛ржи
ЁЯЗоЁЯЗ╕ => ЁЯЗоЁЯЗ╕, ржЖржЗрж╕рж▓рзНржпрж╛ржирзНржб
ЁЯЗоЁЯЗ╣ => ЁЯЗоЁЯЗ╣, ржЗрждрж╛рж▓рж┐
ЁЯЗпЁЯЗк => ЁЯЗпЁЯЗк, ржЬрж╛рж░рзНрж╕рж┐
ЁЯЗпЁЯЗ▓ => ЁЯЗпЁЯЗ▓, ржЬрж╛ржорж╛ржЗржХрж╛
ЁЯЗпЁЯЗ┤ => ЁЯЗпЁЯЗ┤, ржЬрж░рзНржбржи
ЁЯЗпЁЯЗ╡ => ЁЯЗпЁЯЗ╡, ржЬрж╛ржкрж╛ржи
ЁЯЗ░ЁЯЗк => ЁЯЗ░ЁЯЗк, ржХрзЗржирж┐ржпрж╝рж╛
ЁЯЗ░ЁЯЗм => ЁЯЗ░ЁЯЗм, ржХрж┐рж░ржЧрж┐ржЬрж┐рж╕рзНрждрж╛ржи
ЁЯЗ░ЁЯЗн => ЁЯЗ░ЁЯЗн, ржХржорзНржмрзЛржбрж┐ржпрж╝рж╛
ЁЯЗ░ЁЯЗо => ЁЯЗ░ЁЯЗо, ржХрж┐рж░рж┐ржмрж╛рждрж┐
ЁЯЗ░ЁЯЗ▓ => ЁЯЗ░ЁЯЗ▓, ржХржорзЛрж░рзЛрж╕
ЁЯЗ░ЁЯЗ│ => ЁЯЗ░ЁЯЗ│, рж╕рзЗржирзНржЯ ржХрж┐ржЯрж╕ ржУ ржирзЗржнрж┐рж╕
ЁЯЗ░ЁЯЗ╡ => ЁЯЗ░ЁЯЗ╡, ржЙрждрзНрждрж░ ржХрзЛрж░рж┐ржпрж╝рж╛
ЁЯЗ░ЁЯЗ╖ => ЁЯЗ░ЁЯЗ╖, ржжржХрзНрж╖рж┐ржг ржХрзЛрж░рж┐ржпрж╝рж╛
ЁЯЗ░ЁЯЗ╝ => ЁЯЗ░ЁЯЗ╝, ржХрзБржпрж╝рзЗржд
ЁЯЗ░ЁЯЗ╛ => ЁЯЗ░ЁЯЗ╛, ржХрзЗржорзНржпрж╛ржи ржжрзНржмрзАржкржкрзБржЮрзНржЬ
ЁЯЗ░ЁЯЗ┐ => ЁЯЗ░ЁЯЗ┐, ржХрж╛ржЬрж╛ржЦрж╕рзНрждрж╛ржи
ЁЯЗ▒ЁЯЗж => ЁЯЗ▒ЁЯЗж, рж▓рж╛ржУрж╕
ЁЯЗ▒ЁЯЗз => ЁЯЗ▒ЁЯЗз, рж▓рзЗржмрж╛ржиржи
ЁЯЗ▒ЁЯЗи => ЁЯЗ▒ЁЯЗи, рж╕рзЗржирзНржЯ рж▓рзБрж╕рж┐ржпрж╝рж╛
ЁЯЗ▒ЁЯЗо => ЁЯЗ▒ЁЯЗо, рж▓рж┐ржЪрзЗржирж╕рзНржЯрзЗржЗржи
ЁЯЗ▒ЁЯЗ░ => ЁЯЗ▒ЁЯЗ░, рж╢рзНрж░рзАрж▓ржЩрзНржХрж╛
ЁЯЗ▒ЁЯЗ╖ => ЁЯЗ▒ЁЯЗ╖, рж▓рж╛ржЗржмрзЗрж░рж┐ржпрж╝рж╛
ЁЯЗ▒ЁЯЗ╕ => ЁЯЗ▒ЁЯЗ╕, рж▓рзЗрж╕рзЛржерзЛ
ЁЯЗ▒ЁЯЗ╣ => ЁЯЗ▒ЁЯЗ╣, рж▓рж┐ржерзБржпрж╝рж╛ржирж┐ржпрж╝рж╛
ЁЯЗ▒ЁЯЗ║ => ЁЯЗ▒ЁЯЗ║, рж▓рж╛ржХрзНрж╕рзЗржоржмрж╛рж░рзНржЧ
ЁЯЗ▒ЁЯЗ╗ => ЁЯЗ▒ЁЯЗ╗, рж▓рж╛рждрзНржнрж┐ржпрж╝рж╛
ЁЯЗ▒ЁЯЗ╛ => ЁЯЗ▒ЁЯЗ╛, рж▓рж┐ржмрж┐ржпрж╝рж╛
ЁЯЗ▓ЁЯЗж => ЁЯЗ▓ЁЯЗж, ржорзЛрж░ржХрзНржХрзЛ
ЁЯЗ▓ЁЯЗи => ЁЯЗ▓ЁЯЗи, ржорзЛржирж╛ржХрзЛ
ЁЯЗ▓ЁЯЗй => ЁЯЗ▓ЁЯЗй, ржорзЛрж▓рзНржжрж╛ржнрж┐ржпрж╝рж╛
ЁЯЗ▓ЁЯЗк => ЁЯЗ▓ЁЯЗк, ржоржирзНржЯрж┐ржирж┐ржЧрзНрж░рзЛ
ЁЯЗ▓ЁЯЗл => ЁЯЗ▓ЁЯЗл, рж╕рзЗржирзНржЯ ржорж╛рж░рзНржЯрж┐ржи
ЁЯЗ▓ЁЯЗм => ЁЯЗ▓ЁЯЗм, ржорж╛ржжрж╛ржЧрж╛рж╕рзНржХрж╛рж░
ЁЯЗ▓ЁЯЗн => ЁЯЗ▓ЁЯЗн, ржорж╛рж░рзНрж╢рж╛рж▓ ржжрзНржмрзАржкржкрзБржЮрзНржЬ
ЁЯЗ▓ЁЯЗ░ => ЁЯЗ▓ЁЯЗ░, ржорзНржпрж╛рж╕рж╛ржбрзЛржирж┐ржпрж╝рж╛
ЁЯЗ▓ЁЯЗ▒ => ЁЯЗ▓ЁЯЗ▒, ржорж╛рж▓рж┐
ЁЯЗ▓ЁЯЗ▓ => ЁЯЗ▓ЁЯЗ▓, ржорж╛ржпрж╝рж╛ржиржорж╛рж░ (ржмрж╛рж░рзНржорж╛)
ЁЯЗ▓ЁЯЗ│ => ЁЯЗ▓ЁЯЗ│, ржоржЩрзНржЧрзЛрж▓рж┐ржпрж╝рж╛
ЁЯЗ▓ЁЯЗ┤ => ЁЯЗ▓ЁЯЗ┤, ржорзНржпрж╛ржХрж╛ржУ ржПрж╕ржПржЖрж░ ржЪрзАржирж╛
ЁЯЗ▓ЁЯЗ╡ => ЁЯЗ▓ЁЯЗ╡, ржЙрждрзНрждрж░рж╛ржЮрзНржЪрж▓рзАржпрж╝ ржорж╛рж░рж┐ржпрж╝рж╛ржирж╛ ржжрзНржмрзАржкржкрзБржЮрзНржЬ
ЁЯЗ▓ЁЯЗ╢ => ЁЯЗ▓ЁЯЗ╢, ржорж╛рж░рзНржЯрж┐ржирж┐ржХ
ЁЯЗ▓ЁЯЗ╖ => ЁЯЗ▓ЁЯЗ╖, ржорж░рж┐рждрж╛ржирж┐ржпрж╝рж╛
ЁЯЗ▓ЁЯЗ╕ => ЁЯЗ▓ЁЯЗ╕, ржоржирзНржЯрж╕рзЗрж░рж╛ржЯ
ЁЯЗ▓ЁЯЗ╣ => ЁЯЗ▓ЁЯЗ╣, ржорж╛рж▓рзНржЯрж╛
ЁЯЗ▓ЁЯЗ║ => ЁЯЗ▓ЁЯЗ║, ржорж░рж┐рж╢рж╛рж╕
ЁЯЗ▓ЁЯЗ╗ => ЁЯЗ▓ЁЯЗ╗, ржорж╛рж▓ржжрзНржмрзАржк
ЁЯЗ▓ЁЯЗ╝ => ЁЯЗ▓ЁЯЗ╝, ржорж╛рж▓рж╛ржЙржЗ
ЁЯЗ▓ЁЯЗ╜ => ЁЯЗ▓ЁЯЗ╜, ржорзЗржХрзНрж╕рж┐ржХрзЛ
ЁЯЗ▓ЁЯЗ╛ => ЁЯЗ▓ЁЯЗ╛, ржорж╛рж▓ржпрж╝рзЗрж╢рж┐ржпрж╝рж╛
ЁЯЗ▓ЁЯЗ┐ => ЁЯЗ▓ЁЯЗ┐, ржорзЛржЬрж╛ржорзНржмрж┐ржХ
ЁЯЗ│ЁЯЗж => ЁЯЗ│ЁЯЗж, ржирж╛ржорж┐ржмрж┐ржпрж╝рж╛
ЁЯЗ│ЁЯЗи => ЁЯЗ│ЁЯЗи, ржирж┐ржЙ ржХрзНржпрж╛рж▓рзЗржбрзЛржирж┐ржпрж╝рж╛
ЁЯЗ│ЁЯЗк => ЁЯЗ│ЁЯЗк, ржирж╛ржЗржЬрж╛рж░
ЁЯЗ│ЁЯЗл => ЁЯЗ│ЁЯЗл, ржирж░ржлрзЛржХ ржжрзНржмрзАржк
ЁЯЗ│ЁЯЗм => ЁЯЗ│ЁЯЗм, ржирж╛ржЗржЬрзЗрж░рж┐ржпрж╝рж╛
ЁЯЗ│ЁЯЗо => ЁЯЗ│ЁЯЗо, ржирж┐ржХрж╛рж░рж╛ржЧрзБржпрж╝рж╛
ЁЯЗ│ЁЯЗ▒ => ЁЯЗ│ЁЯЗ▒, ржирзЗржжрж╛рж░рж▓рзНржпрж╛ржирзНржбрж╕
ЁЯЗ│ЁЯЗ┤ => ЁЯЗ│ЁЯЗ┤, ржирж░ржУржпрж╝рзЗ
ЁЯЗ│ЁЯЗ╡ => ЁЯЗ│ЁЯЗ╡, ржирзЗржкрж╛рж▓
ЁЯЗ│ЁЯЗ╖ => ЁЯЗ│ЁЯЗ╖, ржирж╛ржЙрж░рзБ
ЁЯЗ│ЁЯЗ║ => ЁЯЗ│ЁЯЗ║, ржирж┐ржЙржпрж╝рзЗ
ЁЯЗ│ЁЯЗ┐ => ЁЯЗ│ЁЯЗ┐, ржирж┐ржЙржЬрж┐рж▓рзНржпрж╛ржирзНржб
ЁЯЗ┤ЁЯЗ▓ => ЁЯЗ┤ЁЯЗ▓, ржУржорж╛ржи
ЁЯЗ╡ЁЯЗж => ЁЯЗ╡ЁЯЗж, ржкрж╛ржирж╛ржорж╛
ЁЯЗ╡ЁЯЗк => ЁЯЗ╡ЁЯЗк, ржкрзЗрж░рзБ
ЁЯЗ╡ЁЯЗл => ЁЯЗ╡ЁЯЗл, ржлрж░рж╛рж╕рзА ржкрж▓рж┐ржирзЗрж╢рж┐ржпрж╝рж╛
ЁЯЗ╡ЁЯЗм => ЁЯЗ╡ЁЯЗм, ржкрж╛ржкрзБржпрж╝рж╛ ржирж┐ржЙ ржЧрж┐ржирж┐
ЁЯЗ╡ЁЯЗн => ЁЯЗ╡ЁЯЗн, ржлрж┐рж▓рж┐ржкрж╛ржЗржи
ЁЯЗ╡ЁЯЗ░ => ЁЯЗ╡ЁЯЗ░, ржкрж╛ржХрж┐рж╕рзНрждрж╛ржи
ЁЯЗ╡ЁЯЗ▒ => ЁЯЗ╡ЁЯЗ▒, ржкрзЛрж▓рзНржпрж╛ржирзНржб
ЁЯЗ╡ЁЯЗ▓ => ЁЯЗ╡ЁЯЗ▓, рж╕рзЗржирзНржЯ ржкрж┐ржпрж╝рзЗрж░ ржУ ржорж┐ржХрзБржпрж╝рзЗрж▓ржи
ЁЯЗ╡ЁЯЗ│ => ЁЯЗ╡ЁЯЗ│, ржкрж┐ржЯржХрзЗржпрж╝рж╛рж░рзНржи ржжрзНржмрзАржкржкрзБржЮрзНржЬ
ЁЯЗ╡ЁЯЗ╖ => ЁЯЗ╡ЁЯЗ╖, ржкрзБржпрж╝рзЗрж░рзНрждрзЛ рж░рж┐ржХрзЛ
ЁЯЗ╡ЁЯЗ╕ => ЁЯЗ╡ЁЯЗ╕, ржкрзНржпрж╛рж▓рзЗрж╕рзНржЯрж╛ржЗржирзЗрж░ ржЕржЮрзНржЪрж▓рж╕ржорзВрж╣
ЁЯЗ╡ЁЯЗ╣ => ЁЯЗ╡ЁЯЗ╣, ржкрж░рзНрждрзБржЧрж╛рж▓
ЁЯЗ╡ЁЯЗ╝ => ЁЯЗ╡ЁЯЗ╝, ржкрж╛рж▓рж╛ржЙ
ЁЯЗ╡ЁЯЗ╛ => ЁЯЗ╡ЁЯЗ╛, ржкрзНржпрж╛рж░рж╛ржЧрзБржпрж╝рзЗ
ЁЯЗ╢ЁЯЗж => ЁЯЗ╢ЁЯЗж, ржХрж╛рждрж╛рж░
ЁЯЗ╢ЁЯЗ┤ => ЁЯЗ╢ЁЯЗ┤, ржЖржЙржЯрж▓рж╛ржЗржирж┐ржВ ржУрж╕рж╛ржирж┐ржпрж╝рж╛
ЁЯЗ╖ЁЯЗк => ЁЯЗ╖ЁЯЗк, рж░рж┐ржЗржЙржирж┐ржпрж╝ржи
ЁЯЗ╖ЁЯЗ┤ => ЁЯЗ╖ЁЯЗ┤, рж░рзЛржорж╛ржирж┐ржпрж╝рж╛
ЁЯЗ╖ЁЯЗ╕ => ЁЯЗ╖ЁЯЗ╕, рж╕рж╛рж░рзНржмрж┐ржпрж╝рж╛
ЁЯЗ╖ЁЯЗ║ => ЁЯЗ╖ЁЯЗ║, рж░рж╛рж╢рж┐ржпрж╝рж╛
ЁЯЗ╖ЁЯЗ╝ => ЁЯЗ╖ЁЯЗ╝, рж░рзБржпрж╝рж╛ржирзНржбрж╛
ЁЯЗ╕ЁЯЗж => ЁЯЗ╕ЁЯЗж, рж╕рзМржжрж┐ ржЖрж░ржм
ЁЯЗ╕ЁЯЗз => ЁЯЗ╕ЁЯЗз, рж╕рж▓рзЛржоржи ржжрзНржмрзАржкржкрзБржЮрзНржЬ
ЁЯЗ╕ЁЯЗи => ЁЯЗ╕ЁЯЗи, рж╕рж┐рж╕рж┐рж▓рж┐
ЁЯЗ╕ЁЯЗй => ЁЯЗ╕ЁЯЗй, рж╕рзБржжрж╛ржи
ЁЯЗ╕ЁЯЗк => ЁЯЗ╕ЁЯЗк, рж╕рзБржЗржбрзЗржи
ЁЯЗ╕ЁЯЗм => ЁЯЗ╕ЁЯЗм, рж╕рж┐ржЩрзНржЧрж╛ржкрзБрж░
ЁЯЗ╕ЁЯЗн => ЁЯЗ╕ЁЯЗн, рж╕рзЗржирзНржЯ рж╣рзЗрж▓рзЗржирж╛
ЁЯЗ╕ЁЯЗо => ЁЯЗ╕ЁЯЗо, рж╕рзНрж▓рзЛржнрж╛ржирж┐ржпрж╝рж╛
ЁЯЗ╕ЁЯЗп => ЁЯЗ╕ЁЯЗп, рж╕рзНржмрж╛рж▓ржмрж╛рж░рзНржб ржУ ржЬрж╛ржи ржорзЗржпрж╝рзЗржи
ЁЯЗ╕ЁЯЗ░ => ЁЯЗ╕ЁЯЗ░, рж╕рзНрж▓рзЛржнрж╛ржХрж┐ржпрж╝рж╛
ЁЯЗ╕ЁЯЗ▒ => ЁЯЗ╕ЁЯЗ▒, рж╕рж┐ржпрж╝рзЗрж░рж╛ рж▓рж┐ржУржи
ЁЯЗ╕ЁЯЗ▓ => ЁЯЗ╕ЁЯЗ▓, рж╕рж╛ржи ржорж╛рж░рж┐ржирзЛ
ЁЯЗ╕ЁЯЗ│ => ЁЯЗ╕ЁЯЗ│, рж╕рзЗржирзЗржЧрж╛рж▓
ЁЯЗ╕ЁЯЗ┤ => ЁЯЗ╕ЁЯЗ┤, рж╕рзЛржорж╛рж▓рж┐ржпрж╝рж╛
ЁЯЗ╕ЁЯЗ╖ => ЁЯЗ╕ЁЯЗ╖, рж╕рзБрж░рж┐ржирж╛ржо
ЁЯЗ╕ЁЯЗ╕ => ЁЯЗ╕ЁЯЗ╕, ржжржХрзНрж╖рж┐ржг рж╕рзБржжрж╛ржи
ЁЯЗ╕ЁЯЗ╣ => ЁЯЗ╕ЁЯЗ╣, рж╕рж╛ржУржЯрзЛржорж╛ ржУ ржкрзНрж░рж┐ржирзНрж╕рж┐ржкрж┐
ЁЯЗ╕ЁЯЗ╗ => ЁЯЗ╕ЁЯЗ╗, ржПрж▓ рж╕рж╛рж▓ржнрзЗржжрж░
ЁЯЗ╕ЁЯЗ╜ => ЁЯЗ╕ЁЯЗ╜, рж╕рж┐ржирзНржЯ ржорж╛рж░рзНржЯрзЗржи
ЁЯЗ╕ЁЯЗ╛ => ЁЯЗ╕ЁЯЗ╛, рж╕рж┐рж░рж┐ржпрж╝рж╛
ЁЯЗ╕ЁЯЗ┐ => ЁЯЗ╕ЁЯЗ┐, рж╕рзЛржпрж╝рж╛ржЬрж┐рж▓рзНржпрж╛ржирзНржб
ЁЯЗ╣ЁЯЗж => ЁЯЗ╣ЁЯЗж, ржЯрзНрж░рж┐рж╕рзНржЯрж╛ржи ржбрж╛ ржХрзБржирж╣рж╛
ЁЯЗ╣ЁЯЗи => ЁЯЗ╣ЁЯЗи, рждрзБрж░рзНржХрж╕ ржУ ржХрж╛ржЗржХрзЛрж╕ ржжрзНржмрзАржкржкрзБржЮрзНржЬ
ЁЯЗ╣ЁЯЗй => ЁЯЗ╣ЁЯЗй, ржЪрж╛ржж
ЁЯЗ╣ЁЯЗл => ЁЯЗ╣ЁЯЗл, ржлрж░рж╛рж╕рзА ржжржХрзНрж╖рж┐ржгрж╛ржЮрзНржЪрж▓
ЁЯЗ╣ЁЯЗм => ЁЯЗ╣ЁЯЗм, ржЯрзЛржЧрзЛ
ЁЯЗ╣ЁЯЗн => ЁЯЗ╣ЁЯЗн, ржерж╛ржЗрж▓рзНржпрж╛ржирзНржб
ЁЯЗ╣ЁЯЗп => ЁЯЗ╣ЁЯЗп, рждрж╛ржЬрж┐ржХрж┐рж╕рзНрждрж╛ржи
ЁЯЗ╣ЁЯЗ░ => ЁЯЗ╣ЁЯЗ░, ржЯрзЛржХрзЗрж▓рж╛ржЙ
ЁЯЗ╣ЁЯЗ▒ => ЁЯЗ╣ЁЯЗ▒, рждрж┐ржорзБрж░-рж▓рзЗрж╕рзНрждрзЗ
ЁЯЗ╣ЁЯЗ▓ => ЁЯЗ╣ЁЯЗ▓, рждрзБрж░рзНржХржорзЗржирж┐рж╕рзНрждрж╛ржи
ЁЯЗ╣ЁЯЗ│ => ЁЯЗ╣ЁЯЗ│, рждрж┐ржЙржирж┐рж╕рж┐ржпрж╝рж╛
ЁЯЗ╣ЁЯЗ┤ => ЁЯЗ╣ЁЯЗ┤, ржЯрзЛржЩрзНржЧрж╛
ЁЯЗ╣ЁЯЗ╖ => ЁЯЗ╣ЁЯЗ╖, рждрзБрж░рж╕рзНржХ
ЁЯЗ╣ЁЯЗ╣ => ЁЯЗ╣ЁЯЗ╣, рждрзНрж░рж┐ржирж┐ржирж╛ржж ржУ ржЯрзЛржмрзНржпрж╛ржЧрзЛ
ЁЯЗ╣ЁЯЗ╗ => ЁЯЗ╣ЁЯЗ╗, ржЯрзБржнрж╛рж▓рзБ
ЁЯЗ╣ЁЯЗ╝ => ЁЯЗ╣ЁЯЗ╝, рждрж╛ржЗржУржпрж╝рж╛ржи
ЁЯЗ╣ЁЯЗ┐ => ЁЯЗ╣ЁЯЗ┐, рждрж╛ржЮрзНржЬрж╛ржирж┐ржпрж╝рж╛
ЁЯЗ║ЁЯЗж => ЁЯЗ║ЁЯЗж, ржЗржЙржХрзНрж░рзЗржи
ЁЯЗ║ЁЯЗм => ЁЯЗ║ЁЯЗм, ржЙржЧрж╛ржирзНржбрж╛
ЁЯЗ║ЁЯЗ▓ => ЁЯЗ║ЁЯЗ▓, ржпрзБржХрзНрждрж░рж╛рж╖рзНржЯрзНрж░рзЗрж░ ржкрж╛рж░рзНрж╢рзНржмржмрж░рзНрждрзА ржжрзНржмрзАржкржкрзБржЮрзНржЬ
ЁЯЗ║ЁЯЗ│ => ЁЯЗ║ЁЯЗ│, ржЬрж╛рждрж┐рж╕ржВржШ
ЁЯЗ║ЁЯЗ╕ => ЁЯЗ║ЁЯЗ╕, ржорж╛рж░рзНржХрж┐ржи ржпрзБржХрзНрждрж░рж╛рж╖рзНржЯрзНрж░
ЁЯЗ║ЁЯЗ╛ => ЁЯЗ║ЁЯЗ╛, ржЙрж░рзБржЧрзБржпрж╝рзЗ
ЁЯЗ║ЁЯЗ┐ => ЁЯЗ║ЁЯЗ┐, ржЙржЬржмрзЗржХрж┐рж╕рзНрждрж╛ржи
ЁЯЗ╗ЁЯЗж => ЁЯЗ╗ЁЯЗж, ржнрзНржпрж╛ржЯрж┐ржХрж╛ржи рж╕рж┐ржЯрж┐
ЁЯЗ╗ЁЯЗи => ЁЯЗ╗ЁЯЗи, рж╕рзЗржирзНржЯ ржнрж┐ржирж╕рзЗржирзНржЯ ржУ ржЧрзНрж░рзЗржирж╛ржбрж┐ржирж╕
ЁЯЗ╗ЁЯЗк => ЁЯЗ╗ЁЯЗк, ржнрзЗржирзЗржЬрзБржпрж╝рзЗрж▓рж╛
ЁЯЗ╗ЁЯЗм => ЁЯЗ╗ЁЯЗм, ржмрзНрж░рж┐ржЯрж┐рж╢ ржнрж╛рж░рзНржЬрж┐ржи ржжрзНржмрзАржкржкрзБржЮрзНржЬ
ЁЯЗ╗ЁЯЗо => ЁЯЗ╗ЁЯЗо, ржорж╛рж░рзНржХрж┐ржи ржпрзБржХрзНрждрж░рж╛рж╖рзНржЯрзНрж░рзЗрж░ ржнрж╛рж░рзНржЬрж┐ржи ржжрзНржмрзАржкржкрзБржЮрзНржЬ
ЁЯЗ╗ЁЯЗ│ => ЁЯЗ╗ЁЯЗ│, ржнрж┐ржпрж╝рзЗрждржирж╛ржо
ЁЯЗ╗ЁЯЗ║ => ЁЯЗ╗ЁЯЗ║, ржнрж╛ржирзБржпрж╝рж╛ржЯрзБ
ЁЯЗ╝ЁЯЗл => ЁЯЗ╝ЁЯЗл, ржУржпрж╝рж╛рж▓рж┐рж╕ ржУ ржлрзБржЯрзБржирж╛
ЁЯЗ╝ЁЯЗ╕ => ЁЯЗ╝ЁЯЗ╕, рж╕рж╛ржорзЛржпрж╝рж╛
ЁЯЗ╜ЁЯЗ░ => ЁЯЗ╜ЁЯЗ░, ржХрж╕рзЛржнрзЛ
ЁЯЗ╛ЁЯЗк => ЁЯЗ╛ЁЯЗк, ржЗржпрж╝рзЗржорзЗржи
ЁЯЗ╛ЁЯЗ╣ => ЁЯЗ╛ЁЯЗ╣, ржорж╛ржпрж╝рзЛрждрзНрждрзЗ
ЁЯЗ┐ЁЯЗж => ЁЯЗ┐ЁЯЗж, ржжржХрзНрж╖рж┐ржг ржЖржлрзНрж░рж┐ржХрж╛
ЁЯЗ┐ЁЯЗ▓ => ЁЯЗ┐ЁЯЗ▓, ржЬрж╛ржорзНржмрж┐ржпрж╝рж╛
ЁЯЗ┐ЁЯЗ╝ => ЁЯЗ┐ЁЯЗ╝, ржЬрж┐ржорзНржмрж╛ржмрзЛржпрж╝рзЗ
ЁЯЗ┐ЁЯЗ┐ => ЁЯЗ┐ЁЯЗ┐, ржЕржЬрж╛ржирж╛ ржЕржЮрзНржЪрж▓