ЁЯП╗ => ЁЯП╗, рмЪрм░рнНрмо рм░рмЩрнНрмЧ, рмкрнНрм░рмХрм╛рм░ 1тАУ2, рм╣рм╛рм▓рмХрм╛ рмЪрм░рнНрмо рм░рмЩрнНрмЧ
ЁЯП╝ => ЁЯП╝, рмЪрм░рнНрмо рм░рмЩрнНрмЧ, рмкрнНрм░рмХрм╛рм░ 3, рмормзрнНрнЯрмо-рм╣рм╛рм▓рмХрм╛ рмЪрм░рнНрмо рм░рмЩрнНрмЧ
ЁЯП╜ => ЁЯП╜, рмЪрм░рнНрмо рм░рмЩрнНрмЧ, рмкрнНрм░рмХрм╛рм░ 4, рмормзрнНрнЯрмо рмЪрм░рнНрмо рм░рмЩрнНрмЧ
ЁЯП╛ => ЁЯП╛, рмЪрм░рнНрмо рм░рмЩрнНрмЧ, рмкрнНрм░рмХрм╛рм░ 5, рмормзрнНрнЯрмо-рмЧрм╛рмв рмЪрм░рнНрмо рм░рмЩрнНрмЧ
ЁЯП┐ => ЁЯП┐, рмЧрм╛рмв рмЪрм░рнНрмо рм░рмЩрнНрмЧ, рмЪрм░рнНрмо рм░рмЩрнНрмЧ, рмкрнНрм░рмХрм╛рм░ 6
ЁЯША => ЁЯША, рмжрм╛рмирнНрмд рмжрнЗрмЦрм╛рмЗ рм╣рм╕рнБрмерм┐рммрм╛ рморнБрм╣рмБ, рморнБрм╣рмБ ред рмжрм╛рмирнНрмд рмжрнЗрмЦрм╛рмЗ рм╣рм╕рм┐рммрм╛
ЁЯШБ => ЁЯШБ, рмЖрмЦрм┐ ред рморнБрм╣рмБ ред рмжрм╛рмирнНрмд рмжрнЗрмЦрм╛рмЗ рм╣рм╕рм┐рммрм╛ ред рм╕рнНрморм┐рмдрм╣рм╛рм╕рнНрнЯ, рм╣рм╕рм╣рм╕рм┐рмЖ рмЖрмЦрм┐ рм╕рм╣ рмЖрмирмирнНрмжрм┐рмд рморнБрм╣рмБ
ЁЯШВ => ЁЯШВ, рмЖрмирмирнНрмж, рмЖрмирмирнНрмжрм╛рм╢рнНрм░рнБ рм╕рм╣ рморнБрм╣рмБ, рморнБрм╣рмБ, рм╣рм╕рм┐рммрм╛ ред рм▓рнБрм╣
ЁЯдг => ЁЯдг, рмЧрмбрм┐рммрм╛, рмЪрмЯрм╛рмг, рморнБрм╣рмБ, рм╣рм╕рм┐ рм╣рм╕рм┐ рмЪрмЯрм╛рмгрм░рнЗ рмЧрмбрм┐рмпрм┐рммрм╛, рм╣рм╕рм┐рммрм╛
ЁЯШГ => ЁЯШГ, рмЦрнЛрм▓рм╛, рмкрм╛рмЯрм┐, рммрмб рмЖрмЦрм┐ рм╕рм╣рм┐рмд рм╣рм╕рмХрнБрм░рм╛ рморнБрм╣рмБ, рморнБрм╣рмБ, рм╕рнНрморм┐рмдрм╣рм╛рм╕рнНрнЯ
ЁЯШД => ЁЯШД, рмЖрмЦрм┐, рмЦрнЛрм▓рм╛, рмкрм╛рмЯрм┐, рморнБрм╣рмБ, рм╕рнНрморм┐рмдрм╣рм╛рм╕рнНрнЯ, рм╣рм╕рнБрмерм┐рммрм╛ рмЖрмЦрм┐ рм╕рм╣ рм╣рм╕рмХрнБрм░рм╛ рморнБрм╣рмБ
ЁЯШЕ => ЁЯШЕ, рмЦрнЛрм▓рм╛, рмЭрм╛рм│, рмЭрм╛рм│ рм▓рм╛рмЧрм┐рмерм┐рммрм╛ рм╣рм╕рмХрнБрм░рм╛ рморнБрм╣рмБ, рмермгрнНрмбрм╛, рморнБрм╣рмБ, рм╕рнНрморм┐рмдрм╣рм╛рм╕рнНрнЯ
ЁЯШЖ => ЁЯШЖ, рмЦрнЛрм▓рм╛, рмкрм╛рмЯрм┐, рморнБрм╣рмБ, рм╕рмирнНрмдрнБрм╖рнНрмЯ, рм╕рнНрморм┐рмдрм╣рм╛рм╕рнНрнЯ, рм╣рм╕рм┐рммрм╛, рм╣рм╕рнБрмХрнБрм░рм╛ рммрмХрнНрм░ рмЪрм╛рм╣рм╛рмгрм┐ рмерм┐рммрм╛ рморнБрм╣рмБ
ЁЯШЙ => ЁЯШЙ, рмЖрмЦрм┐ рмарм╛рм░ рморм╛рм░рнБрмерм┐рммрм╛ рморнБрм╣рмБ, рмЖрмЦрм┐ рморм╛рм░рм┐рммрм╛, рморнБрм╣рмБ
ЁЯШК => ЁЯШК, рмЖрмЦрм┐, рморнБрм╣рмБ, рм▓рмЬрнНрмЬрм┐рмд рм╣рнЗрммрм╛, рм╕рнНрморм┐рмдрм╣рм╛рм╕рнНрнЯ, рм╣рм╕рнБрмерм┐рммрм╛ рмЖрмЦрм┐ рм╕рм╣рм┐рмд рм╣рм╕рнБрмерм┐рммрм╛ рморнБрм╣рмБ
ЁЯШЛ => ЁЯШЛ, рмЙрморнН рмЙрморнН рмнрм▓, рмдрнГрмкрнНрмдрм┐рмХрм░ рм╕рнНрн▒рм╛рмжрм┐рм╖рнНрмЯ рмЦрм╛рмжрнНрнЯ рмЦрм╛рмЗрммрм╛ рмкрм░рнЗ рморнБрм╣рмБ, рмкрм╛рмгрм┐ рмЖрм╕рм┐рммрм╛, рморнБрм╣рмБ, рморнБрм╣рмБрм░рнЗ рмкрм╛рмгрм┐ рмЖрм╕рм┐рммрм╛, рм╕рнНрм╡рм╛рмжрм┐рм╖рнНрмЯ рмЦрм╛рмжрнНрнЯ, рм╣рм╕ рморнБрм╣рмБ
ЁЯШО => ЁЯШО, рмЕрмдрм┐ рммрм┐рмирмжрм╛рм╕рнН, рмЪрм╖рморм╛, рмЪрм╖рморм╛ рм╕рм╣рм┐рмд рм╣рм╕, рммрм┐рмирмжрм╛рм╕рнН, рммрм┐рмирмжрм╛рм╕рнН рморнБрм╣рмБ, рморнБрм╣рмБ, рм╕рмирнНтАМрмЧрнНрм▓рм╛рм╕рнНтАМ рм╕рм╣ рм╣рм╕рнБрмерм┐рммрм╛ рморнБрм╣рмБ, рм╣рм╕рм╣рм╕рм┐рмЖ
ЁЯШН => ЁЯШН, рмЖрмЦрм┐, рмкрнНрм░рнЗрмо, рморнБрм╣рмБ, рм╕рнНрмирнЗрм╣рмкрнВрм░рнНрмгрнНрмг, рм╣рм╕рм╣рм╕рм┐рмЖ рморнБрм╣рмБ, рм╣рм╛рм░рнНрмЯрнН, рм╣рм╛рм░рнНрмЯрнН рмпрнБрмХрнНрмд рмЖрмЦрм┐, рм╣рнГрмжрнЯ-рмЖрмЦрм┐ рмерм┐рммрм╛ рм╣рм╕рнБрмерм┐рммрм╛ рморнБрм╣рмБ
ЁЯШШ => ЁЯШШ, рмЪрнБрморм╛ рмжрнЗрммрм╛, рморнБрм╣рмБ, рморнБрм╣рмБрмХрнБ рмЪрнБрморм╛ рмжрнЗрммрм╛, рморнБрм╣рмБрм░рнБ рмПрмХ рмЪрнБрморнНрммрми рмЙрмбрм╛рмЗрммрм╛
ЁЯШЧ => ЁЯШЧ, рмЪрм┐рморм╛ рмжрнЗрммрм╛ рморнБрм╣рмБ, рмЪрнБрморм╛, рмЪрнБрморнНрммрми рмжрнЗрмЙрмерм┐рммрм╛ рморнБрм╣рмБ, рморнБрм╣рмБ
ЁЯШЩ => ЁЯШЩ, рмЪрнБрморм╛ рмПрммрмВ рм╣рм╕, рморнБрм╣рмБ, рм╣рм╕, рм╣рм╕ рм╕рм╣рм┐рмд рмЪрнБрморм╛рмжрнЗрммрм╛ рморнБрм╣рмБ, рм╣рм╕рм╣рм╕рм┐рмЖ рмЖрмЦрм┐, рм╣рм╕рнБрмерм┐рммрм╛ рмЖрмЦрм┐ рм╕рм╣ рмЪрнБрморнНрммрми рмжрнЗрмЙрмерм┐рммрм╛ рморнБрм╣рмБ
ЁЯШЪ => ЁЯШЪ, рмЖрмЦрм┐ рммрмирнНрмж, рмЖрмЦрм┐ рммрмирнНрмж рмХрм░рм┐ рмЪрнБрморм╛ рмжрнЗрммрм╛, рмЪрнБрморм╛ рмжрнЗрммрм╛, рммрмирнНрмж рмЖрмЦрм┐ рм╕рм╣ рмЪрнБрморнНрммрми рмжрнЗрмЙрмерм┐рммрм╛ рморнБрм╣рмБ, рморнБрм╣рмБ
тШ║ => тШ║, рмЕрмг рм╣рм╕рм╣рм╕рм┐рмЖ рморнБрм╣рмБ, рморнБрм╣рмБ, рм╣рм╕рмХрнБрм░рм╛ рморнБрм╣рмБ, рм╣рм╕рм╣рм╕рм┐рмЖ, рм╣рм╕рм╣рм╕рм┐рмЖ рморнБрм╣рмБ
ЁЯЩВ => ЁЯЩВ, рмЯрм┐рмХрнЗ рм╣рм╕рнБрмерм┐рммрм╛ рморнБрм╣рмБ, рморнБрм╣рмБ, рм╕рнНрморм┐рмдрм╣рм╛рм╕рнНрнЯ
ЁЯдЧ => ЁЯдЧ, рмЖрм▓рм┐рмЩрнНрмЧрми, рмЖрм▓рм┐рмЩрнНрмЧрми рмХрм░рм┐рммрм╛, рмХрнЛрм│рм╛рмЗрммрм╛рмХрнБ рм╣рм╛рмд рмЦрнЛрм▓рм╛рмерм┐рммрм╛ рморнБрм╣рмБ, рморнБрм╣рмБ
ЁЯдй => ЁЯдй, рмЖрмЦрм┐рмЧрнБрмбрм┐рмХ, рмдрм╛рм░рмХрм╛ рмЦрмЪрм┐рмд, рмдрм╛рм░рм╛, рмжрм╛рмирнНрмд рмжрнЗрмЦрм╛рмЗ рм╣рм╕рм┐рммрм╛, рморнБрм╣рмБ
ЁЯдФ => ЁЯдФ, рмЪрм┐рмирнНрмдрм╛ рмХрм░рм┐рммрм╛, рмЪрм┐рмирнНрмдрм╛рм╢рнАрм│ рморнБрм╣рмБ, рморнБрм╣рмБ
ЁЯди => ЁЯди, рмЕрммрм┐рм╢рнНрм╡рм╛рм╕, рмЙрмарм┐рмерм┐рммрм╛ рмЖрмЦрм┐рмкрмдрм╛ рм╕рм╣рм┐рмд рморнБрм╣рмБ, рм╕рмирнНрмжрнЗрм╣рнА
ЁЯШР => ЁЯШР, рмХрнМрмгрм╕рм┐ рмормирнНрмдрммрнНрнЯ рмирм╛рм╣рм┐рмБ, рмкрнНрм░рм╛рмХрнГрмдрм┐рмХ, рмкрнНрм░рм╛рмХрнГрмдрм┐рмХ рморнБрм╣рмБ, рмнрм╛рммрм╢рнВрмирнНрнЯ, рмнрм╛рммрм╢рнВрмирнНрнЯ рморнБрм╣рмБ, рморнБрм╣рмБ, рм╕рм╛рмзрм╛рм░рмг рморнБрм╣рмБ
ЁЯШС => ЁЯШС, рмЕрмнрм┐рммрнНрнЯрмХрнНрмдрм┐ рммрм┐рм╣рнАрми рморнБрм╣рмБ, рмХрнМрмгрм╕рм┐ рмормирнНрмдрммрнНрнЯ рмирм╛рм╣рм┐рмБ, рмнрм╛рммрм╢рнВрмирнНрнЯ, рмнрм╛рммрм╢рнВрмирнНрнЯ рморнБрм╣рмБ, рморнБрм╣рмБ
ЁЯШ╢ => ЁЯШ╢, рмкрм╛рмЯрм┐ рмирмерм┐рммрм╛ рморнБрм╣рмБ, рмкрм╛рмЯрм┐ рмирм╛рм╣рм┐рмБ, рморнБрм╣рмБ
ЁЯЩД => ЁЯЩД, рмЖрмЦрм┐, рмШрнВрм░рнБрмерм┐рммрм╛, рмШрнВрм░рнБрмерм┐рммрм╛ рмЖрмЦрм┐ рм╕рм╣ рморнБрм╣рмБ, рмкрм╛рмЯрм┐
ЁЯШП => ЁЯШП, рмирм┐рм░рнНрммрнЛрмз рмнрм╛рммрм░рнЗ рм╣рм╕рм┐рммрм╛, рмирм┐рм░рнНрммрнЛрмзрмдрм╛ рмнрм░рм╛ рм╣рм╕ рмерм┐рммрм╛ рморнБрм╣рмБ, рморнБрм╣рмБ
ЁЯШг => ЁЯШг, рмжрнГрмв рморнБрм╣рмБ, рморнБрм╣рмБ, рм╢рмХрнНрмд рмХрм░рм┐рммрм╛, рм╢рмХрнНрмд рморнБрм╣рмБ
ЁЯШе => ЁЯШе, рмЖрм░рм╛рмо рморм┐рм│рм┐рм▓рм╛, рмжрнБрмГрмЦрм┐, рмжрнБрмГрмЦрм┐ рмХрм┐рмирнНрмдрнБ рмЖрм░рм╛рмо рморм┐рм│рм┐рм▓рм╛, рмжрнБрмЦрм┐рмд рмХрм┐рмирнНрмдрнБ рмЖрм╢рнНрн▒рм╕рнНрмд рморнБрм╣рмБ, рморнБрм╣рмБ, рн▒рнЗрн▒!
ЁЯШо => ЁЯШо, рмЦрнЛрм▓рм╛ рмкрм╛рмЯрм┐, рмЦрнЛрм▓рм╛ рмкрм╛рмЯрм┐ рморнБрм╣рмБ, рмкрм╛рмЯрм┐, рморнБрм╣рмБ
ЁЯдР => ЁЯдР, рмЬрм┐рмкрм░рнНтАМ, рмЬрм┐рмкрнНтАМ рм▓рмЧрм╛ рмкрм╛рмЯрм┐ рм╕рм╣ рморнБрм╣рмБ, рмкрм╛рмЯрм┐, рморнБрм╣рмБ
ЁЯШп => ЁЯШп, рмЖрм╢рнНрмЪрм░рнНрмпрнНрнЯ рм╣рнЗрммрм╛, рмЪрмХрм┐рмд рм╣рнЗрммрм╛, рмирм┐рм╕рнНрмдрммрнНрмз рморнБрм╣рмБ, рморнБрм╣рмБ
ЁЯШк => ЁЯШк, рмирм┐рмжрнБрмЖ, рмирм┐рмжрнБрмЖ рморнБрм╣рмБ, рмирм┐рмжрнНрм░рм╛рм│рнБ рморнБрм╣рмБ, рморнБрм╣рмБ
ЁЯШл => ЁЯШл, рмХрнНрм▓рм╛рмирнНрмд рморнБрм╣рмБ, рморнБрм╣рмБ, рм╣рм╛рм▓рм┐рмЖ рм╣рнЛрмЗрмерм┐рммрм╛, рм╣рм╛рм▓рм┐рмЖ рм╣рнЛрмЗрмерм┐рммрм╛ рморнБрм╣рмБ
ЁЯШ┤ => ЁЯШ┤, рмирм┐рмжрнБрмЖ рморнБрм╣рмБ, рморнБрм╣рмБ, рм╢рнЛрмЗрммрм╛, рм╢рнЛрмЗрммрм╛ рморнБрм╣рмБ
ЁЯШМ => ЁЯШМ, рмЖрм╢рнНрн▒рм╕рнНрмд рморнБрм╣рмБ, рмЪрм┐рмирнНрмдрм╛рморнБрмХрнНрмд, рмЪрнБрмирнНрмдрм╛рморнБрмХрнНрмд рморнБрм╣рмБ, рморнБрм╣рмБ
ЁЯШЫ => ЁЯШЫ, рмЬрм┐рмн рммрм╛рм╣рм╛рм░ рмХрм░рм┐ рм░рмЦрм┐рммрм╛, рмЬрм┐рмн рммрм╛рм╣рм╛рм░ рмХрм░рм┐рмерм┐рммрм╛ рморнБрм╣рмБ, рмЬрм┐рмн рммрм╛рм╣рм╛рм░ рмХрм░рм┐рммрм╛, рмЬрм┐рмн рммрм╛рм╣рм╛рм░рм┐рмерм┐рммрм╛ рморнБрм╣рмБ, рморнБрм╣рмБ
ЁЯШЬ => ЁЯШЬ, рмЖрмЦрм┐ рморм╛рм░рм┐рммрм╛ рм╕рм╣рм┐рмд рмЬрм┐рмн рммрм╛рм╣рм╛рм░рмХрнБ рмХрм░рм┐рммрм╛, рмЖрмЦрм┐рморм╛рм░рм┐рммрм╛, рмХрнЗрммрм│ рм╣рмЗрм░рм╛рмг рмХрм░рм┐рммрм╛, рмХрнМрмдрнБрмХ, рмЬрм┐рмн рммрм╛рм╣рм╛рм░ рмХрм░рм┐рммрм╛, рмЬрм┐рмн рммрм╛рм╣рм╛рм░рм┐рммрм╛ рм╕рм╣рм┐рмд рмЖрмЦрм┐ рмарм╛рм░ рморм╛рм░рнБрмерм┐рммрм╛ рморнБрм╣рмБ, рморнБрм╣рмБ
ЁЯШЭ => ЁЯШЭ, рмЖрмЦрм┐ рммрмирнНрмж рмХрм░рм┐ рмЬрм┐рмн рммрм╛рм╣рм╛рм░рмХрнБ рмХрм░рм┐рммрм╛, рмШрнГрмгрм╛рм╕рнВрмЪрмХ, рмЬрм┐рмн рммрм╛рм╣рм╛рм░рмХрнБ рмХрм░рм┐рммрм╛, рмЬрм┐рмн рммрм╛рм╣рм╛рм░рм┐рммрм╛ рм╕рм╣рм┐рмд рммрмХрнНрм░ рмЪрм╛рм╣рм╛рмгрм┐ рмерм┐рммрм╛ рморнБрм╣рмБ, рммрмирнНрмж рм╣рнЛрмЗрмерм┐рммрм╛ рмЖрмЦрм┐, рмнрнЯрмЩрнНрмХрм░, рморнБрм╣рмБ
ЁЯдд => ЁЯдд, рмкрм╛рмЯрм┐рм░рнБ рм▓рм╛рм│ рмЧрмбрм┐рммрм╛, рмкрм╛рмЯрм┐рм░рнБ рм▓рм╛рм│ рмЧрмбрнБрмерм┐рммрм╛ рморнБрм╣рмБ, рморнБрм╣рмБ
ЁЯШТ => ЁЯШТ, рмЕрмкрнНрм░рм╢рнНрми, рмЕрмкрнНрм░рм╢рнНрми рморнБрм╣рмБ, рмЕрмкрнНрм░рм╕рмирнНрми рморнБрм╣рмБ, рмЦрнБрм╕рм┐рмирмерм┐рммрм╛, рморнБрм╣рмБ
ЁЯШУ => ЁЯШУ, рмЭрм╛рм│ рм╕рм╣рм┐рмд рм▓рмЬрнНрмЬрм╛рммрмирмд рморнБрм╣рмБ, рмермгрнНрмбрм╛ рмЭрм╛рм│, рмермгрнНрмбрм╛ рмЭрм╛рм│ рм╕рм╣рм┐рмд рморнБрм╣рмБ, рморнБрм╣рмБ
ЁЯШФ => ЁЯШФ, рмЙрмжрм╛рм╕, рмЪрм┐рмирнНрмдрм╛рмЧрнНрм░рм╕рнНрмд рморнБрм╣рмБ, рмЪрм┐рмирнНрмдрм┐рмд, рмЪрм┐рмирнНрмдрм┐рмд рморнБрм╣рмБ, рморнБрм╣рмБ
ЁЯШХ => ЁЯШХ, рмжрнНрм╡рмирнНрмжрмХрм░, рмжрнНрм╡рмирнНрмжрмХрм░ рморнБрм╣рмБ, рммрм┐рмЪрм│рм┐рмд рморнБрм╣рмБ, рморнБрм╣рмБ
ЁЯЩГ => ЁЯЩГ, рмУрм▓рмЯрм╛, рмУрм▓рмЯрм╛ рморнБрм╣рмБ, рморнБрм╣рмБ
ЁЯдС => ЁЯдС, рмЯрмЩрнНрмХрм╛, рмкрм╛рмЯрм┐, рмкрм╛рмЯрм┐рм░рнЗ рмЯрмЩрнНрмХрм╛ рмерм┐рммрм╛ рморнБрм╣рмБ, рморнБрм╣рмБ
ЁЯШ▓ => ЁЯШ▓, рмЪрмХрм┐рмд, рмЪрмХрм┐рмд рморнБрм╣рмБ, рмЪрмХрм┐рмд рм╣рнЗрммрм╛, рммрм┐рм╕рнНрморм┐рмд рморнБрм╣рмБ, рморнБрм╣рмБ, рм╕рморнНрмкрнБрм░рнНрмгрнНрмг рмЪрмХрм┐рмд
тШ╣ => тШ╣, рмнрнНрм░рнБрмХрнБрмЮрнНрмЪрми, рмнрнНрм░рнБрмХрнБрмЮрнНрмЪрми рмХрм░рм┐рмерм┐рммрм╛ рморнБрм╣рмБ, рморнБрм╣рмБ
ЁЯЩБ => ЁЯЩБ, рмЯрм┐рмХрнЗ рмнрнНрм░рнБрмХрнБрмЮрнНрмЪрми рмХрм░рм┐рмерм┐рммрм╛ рморнБрм╣рмБ, рмнрнНрм░рнБрмХрнБрмЮрнНрмЪрми, рморнБрм╣рмБ
ЁЯШЦ => ЁЯШЦ, рммрм┐рм░рмХрнНрмдрм┐рм╕рнВрмЪрмХ, рммрм┐рм░рмХрнНрмдрм┐рм╕рнВрмЪрмХ рморнБрм╣рмБ, рморнБрм╣рмБ
ЁЯШЮ => ЁЯШЮ, рморнБрм╣рмБ, рм╣рмдрм╛рм╢ рморнБрм╣рмБ, рм╣рмдрм╛рм╕, рм╣рмдрм╛рм╕ рм╣рнЗрммрм╛, рм╣рмдрм╛рм╕ рм╣рнЛрмЗрмерм┐рммрм╛ рморнБрм╣рмБ
ЁЯШЯ => ЁЯШЯ, рммрм┐рммрнНрм░рмд рморнБрм╣рмБ, рммрнНрнЯрм╕рнНрмд рморнБрм╣рмБ, рммрнНрнЯрм╕рнНрмд рм╣рнЗрммрм╛, рморнБрм╣рмБ
ЁЯШд => ЁЯШд, рмирм╛рмХрм░рнБ рм╕рм┐рмВрмШрм╛рмгрм┐ рмзрм╛рм░ рммрнЛрм╣рнБрмерм┐рммрм╛ рморнБрм╣рмБ, рммрм┐рмЬрнЯрнА, рммрм┐рмЬрнЯрнАрмнрм╛рмм, рморнБрмБ рмПрм╣рм╛ рмЬрм┐рмдрм┐рмерм┐рммрм╛ рморнБрм╣рмБ, рморнБрмБ рмЬрм┐рмдрм┐рмЫрм┐, рморнБрм╣рмБ
ЁЯШв => ЁЯШв, рмХрм╛рмирнНрмжрм┐рммрм╛, рмХрм╛рмирнНрмжрм┐рммрм╛ рморнБрм╣рмБ, рмХрм╛рмирнНрмжрнБрм░рм╛ рморнБрм╣рмБ, рмжрнБрмГрмЦ, рморнБрм╣рмБ, рм▓рнБрм╣
ЁЯШн => ЁЯШн, рмХрм╛рмирнНрмж, рмХрм╛рмирнНрмжрм┐рммрм╛, рмЬрнЛрм░рм░рнЗ рмХрм╛рмирнНрмжрнБрмерм┐рммрм╛ рморнБрм╣рмБ, рмЬрнЛрм░рнНтАМрм░рнЗ рмХрм╛рмирнНрмжрм┐рммрм╛, рморнБрм╣рмБ, рм▓рнБрм╣
ЁЯШж => ЁЯШж, рмХрнНрм░рнЛрмз, рмХрнНрм░рнЛрмзрм┐рмд рморнБрм╣рмБ, рмЦрнЛрм▓рм╛ рмкрм╛рмЯрм┐, рмЦрнЛрм▓рм╛ рмкрм╛рмЯрм┐ рм╕рм╣рм┐рмд рмХрнНрм░рнЛрмз, рмкрм╛рмЯрм┐ рмЦрнЛрм▓рм╛рмерм┐рммрм╛ рмнрнНрм░рнБрмХрнБрмЮрнНрмЪрми рморнБрм╣рмБ, рморнБрм╣рмБ
ЁЯШз => ЁЯШз, рмжрнБрмГрмЦрнА, рмжрнБрмГрмЦрнА рморнБрм╣рмБ, рммрнНрнЯрмерм┐рмд рморнБрм╣рмБ, рмнрнЛрмЧрм┐рммрм╛, рморнБрм╣рмБ
ЁЯШи => ЁЯШи, рмбрм░рмХрнБрм│рм╛ рморнБрм╣рмБ, рмбрм░рм┐рммрм╛, рмбрм░рм┐рммрм╛ рморнБрм╣рмБ, рмнрнЯрмнрнАрмд, рморнБрм╣рмБ
ЁЯШй => ЁЯШй, рмЕрммрм╕рмирнНрми рморнБрм╣рмБ, рморнБрм╣рмБ, рм╣рм╛рм▓рм┐рмЖ, рм╣рм╛рм▓рм┐рмЖ рм╣рнЛрмЗрмерм┐рммрм╛, рм╣рм╛рм▓рм┐рмЖ рм╣рнЛрмЗрмерм┐рммрм╛ рморнБрм╣рмБ
ЁЯдп => ЁЯдп, рммрм┐рм╕рнНрмлрнЛрм░рмг рм╣рнЗрмЙрмерм┐рммрм╛ рморнБрмгрнНрмб, рморм╛рмирм╕рм┐рмХ рмЖрмШрм╛рмдрмкрнНрм░рм╛рмкрнНрмд
ЁЯШм => ЁЯШм, рмЦрмдрнЗрмЗрм╣рнЗрммрм╛, рмЦрмдрнЗрмЗрм╣рнЗрммрм╛ рморнБрм╣рмБ, рммрм┐рмХрнГрмд рморнБрм╣рмБ, рморнБрм╣рмБ
ЁЯШ░ => ЁЯШ░, рмЭрм╛рм│ рм╕рм╣рм┐рмд рмЖрмдрнБрм░ рморнБрм╣рмБ, рмермгрнНрмбрм╛ рмЭрм╛рм│, рмермгрнНрмбрм╛ рмЭрм╛рм│ рм╕рм╣рм┐рмд рмирнАрм│ рморнБрм╣рмБ, рмкрм╛рмЯрм┐ рмЦрнЛрм▓рм╛, рммрнНрнЯрмЧрнНрм░ рморнБрм╣рмБ, рморнБрм╣рмБ
ЁЯШ▒ => ЁЯШ▒, рмбрм░рм┐рммрм╛, рмнрнЯ, рмнрнЯрмнрнАрмд, рмнрнЯрмнрнАрмд рморнБрм╣рмБ, рмнрнЯрм░рнЗ рмЪрм┐рмдрнНрмХрм╛рм░ рмХрм░рнБрмерм┐рммрм╛ рморнБрм╣рмБ, рмнрнЯрм░рнЗ рмбрм░рм┐рммрм╛, рмнрнЯрм░рнЗ рмнрнЯрмнрнАрмд рморнБрм╣рмБ рмХрм░рм┐рммрм╛, рморнБрм╣рмБ
ЁЯШ│ => ЁЯШ│, рмЙрмдрнНрмдрнЗрмЬрм┐рмд рморнБрм╣рмБ, рмЙрмдрнНрмдрнЗрмЬрм┐рмд рм╣рнЗрммрм╛, рмирм┐рмжрм░рнЗ, рмирм┐рмжрнБрмЖ, рморнБрм╣рмБ, рм░рмХрнНрмдрм┐рморм╛ рмкрмбрм┐рмерм┐рммрм╛ рморнБрм╣рмБ
ЁЯдк => ЁЯдк, рмЕрмдрнНрнЯрмзрм┐рмХ рмЙрмдрнНрм╕рм╛рм╣рнА рморнБрм╣рмБ, рмЖрмЦрм┐, рмЫрнЛрмЯ, рммрмб
ЁЯШ╡ => ЁЯШ╡, рмШрнВрм░рнНрмгрнНрмгрм┐рмд, рмШрнВрм░рнНрмгрнНрмгрм┐рмд рморнБрм╣рмБ, рморнБрм╣рмБ
ЁЯШб => ЁЯШб, рмУрма рмЧрнЛрмЬрнЗрмЗ рмерм┐рммрм╛ рморнБрм╣рмБ, рмкрм╛рмЧрм│, рморнБрм╣рмБ, рморнБрм╣рмБ рмлрнБрм▓рм╛рмЗрммрм╛, рм░рм╛рмЧ, рм▓рм╛рм▓рнН рморнБрм╣рмБ, рм▓рм╛рм▓рнН рморнБрм╣рмБ рмлрнБрм▓рм╛рмЗрммрм╛ рморнБрм╣рмБ
ЁЯШа => ЁЯШа, рмкрм╛рмЧрм│, рмкрнНрм░рмХрнЛрмкрм┐рмд рморнБрм╣рмБ, рморнБрм╣рмБ, рм░рм╛рмЧрм┐, рм░рм╛рмЧрм┐ рморнБрм╣рмБ
ЁЯдм => ЁЯдм, рмкрм╛рмЯрм┐рм░рнЗ рм╕рмЩрнНрмХрнЗрмд рм╕рм╣рм┐рмд рморнБрм╣рмБ, рм╢рмкрме рмХрм░рм┐рммрм╛
ЁЯШ╖ => ЁЯШ╖, рмбрм╛рмХрнНрмдрм░рнА рморнБрмЦрм╛, рмбрм╛рмХрнНрмдрм░рнА рморнБрмЦрм╛ рмкрм┐рмирнНрмзрм╛ рморнБрм╣рмБ, рмермгрнНрмбрм╛, рмкрм╛рмгрм┐рмкрм╛рмЧрм░рнЗ, рморнБрмЦрм╛, рморнБрмЦрм╛ рм╕рм╣ рморнБрм╣рмБ, рморнБрм╣рмБ
ЁЯдТ => ЁЯдТ, рмЕрм╕рнБрм╕рнНрме, рмерм░рнНрморнЛрморм┐рмЯрм░, рмерм░рнНрморнЛрморм┐рмЯрм░ рм╕рм╣рм┐рмд рморнБрм╣рмБ, рморнБрм╣рмБ, рм░рнЛрмЧрм┐рмгрм╛
ЁЯдХ => ЁЯдХ, рмЖрмШрм╛рмд, рмХрнНрм╖рмд, рмкрмЯрм┐, рморнБрмгрнНрмб-рмкрмЯрм┐ рмерм┐рммрм╛ рморнБрм╣рмБ, рморнБрм╣рмБ
ЁЯдв => ЁЯдв, рммрм╛рмирнНрмдрм┐, рммрм┐рмдрнГрм╖рнНрмгрм╛, рммрм┐рмдрнГрм╖рнНрмгрм╛ рморнБрм╣рмБ, рморнБрм╣рмБ
ЁЯдо => ЁЯдо, рммрм╛рмирнНрмдрм┐, рммрм╛рмирнНрмдрм┐ рмХрм░рнБрмерм┐рммрм╛ рморнБрм╣рмБ, рм░рнЛрмЧрм┐рмгрм╛
ЁЯдз => ЁЯдз, рмЫрм┐рмЩрнНрмХрм┐рммрм╛, рмЫрм┐рмЩрнНрмХрм┐рммрм╛ рммрнЗрм│рнЗ рм╢рнБрмн рмормирм╛рм╕рм┐рммрм╛, рмЫрм┐рмЩрнНрмХрнБрмерм┐рммрм╛ рморнБрм╣рмБ, рморнБрм╣рмБ
ЁЯШЗ => ЁЯШЗ, рмПрмХ рм╣рм╛рм▓рнЛ рм╕рм╣рм┐рмд рм╣рм╕, рморнБрм╣рмБ, рм╣рм╕, рм╣рм╛рм▓рнЛ, рм╣рм╛рм▓рнЛ рм╕рм╣рм┐рмд рм╣рм╕рнБрмерм┐рммрм╛ рморнБрм╣рмБ
ЁЯда => ЁЯда, рмХрм╛рмУрмЧрм╛рм░рнНрм▓, рмХрм╛рмУрммрмП, рмХрм╛рмУрммрмП рмЯрнЛрмкрм┐ рмкрм┐рмирнНрмзрм┐рмерм┐рммрм╛ рморнБрм╣рмБ, рмЯрнЛрмкрм┐, рморнБрм╣рмБ
ЁЯдб => ЁЯдб, рмЬрнЛрмХрм░, рмЬрнЛрмХрм░ рморнБрм╣рмБ, рморнБрм╣рмБ
ЁЯде => ЁЯде, рмкрм┐рмирнЛрмЪрм┐рмУ, рморм┐рмЫ, рморм┐рмЫ рмХрм╣рнБрмерм┐рммрм╛ рморнБрм╣рмБ, рморнБрм╣рмБ
ЁЯдл => ЁЯдл, рмЪрнБрмкрнНтАМ рм░рм╣рм┐рммрм╛ ред рмирнАрм░рмм, рмЪрнБрмкрнНтАМ рм░рм╣рм┐рммрм╛ рмкрм╛рмЗрмБ рмХрм╣рм┐рммрм╛ рморнБрм╣рмБ
ЁЯдн => ЁЯдн, рмЙрмдрнНрмдрнЗрмЬрмирм╛рмЬрмирм┐рмд рмЙрмЪрнНрмЪ рм╢рммрнНрмж, рмкрм╛рмЯрм┐рм░рнЗ рм╣рм╛рмд рммрмирнНрмж рмХрм░рм┐рмерм┐рммрм╛ рморнБрм╣рмБ
ЁЯзР => ЁЯзР, рмЕрм╣рмЩрнНрмХрм╛рм░рмкрнВрм░рнНрмгрнНрмг, рмЧрнЛрмЯрнЗ рмЖрмЦрм┐рм░рнЗ рмкрм┐рмирнНрмзрм╛ рмпрм╛рмЗрмерм┐рммрм╛ рмЪрм╖рморм╛ рм╕рм╣рм┐рмд рморнБрм╣рмБ
ЁЯдУ => ЁЯдУ, рмЕрмжрнНрмнрнБрмд рм▓рнЛрмХ, рмирм┐рм░рнНрммрнЛрмз, рмирм┐рм░рнНрммрнЛрмз рморнБрм╣рмБ, рморнБрм╣рмБ
ЁЯШИ => ЁЯШИ, рморнБрм╣рмБ, рм╢рм┐рмЩрнНрмЧ рм╕рм╣рм┐рмд рм╣рм╕рнБрмерм┐рммрм╛ рморнБрм╣рмБ, рм╣рм░рнНрми рм╕рм╣рм┐рмд рм╣рм╕, рм╣рм░рнНрмирнН, рм╣рм╕
ЁЯС┐ => ЁЯС┐, рмЫрнЛрмЯ рм╕рмЗрмдрм╛рми, рмжрнБрм╖рнНрмЯ рм╢рм┐рм╢рнБ, рморнБрм╣рмБ, рм╢рм┐рмЩрнНрмЧ рм╕рм╣рм┐рмд рмкрнНрм░рмХрнЛрмкрм┐рмд рморнБрм╣рмБ, рм╕рмЗрмдрм╛рми
ЁЯС╣ => ЁЯС╣, рмЕрм╕рнБрм░, рмЬрм╛рмкрм╛рмирнА рмормгрм┐рм╖рмЦрм┐рмЖ рм░рм╛рмХрнНрм╖, рмжрм╛рмирмм, рмкрм░рнА рмХрм╛рм╣рм╛рмгрнА, рмормгрм┐рм╖рмЦрм┐рмЖ рм░рм╛рмХрнНрм╖рм╕, рморнБрм╣рмБ, рм░рм╛рмХрнНрм╖рм╕
ЁЯС║ => ЁЯС║, рмЦрм░рнНрммрмХрм╛рнЯ рмЕрм╕рнБрм░, рмЬрм╛рмкрм╛рмирнА рмЦрм░рнНрммрмХрм╛рнЯ рмЕрм╕рнБрм░, рмЯрнЗрмЩрнНрмЧрнБ, рмкрм░рнА рмХрм╛рм╣рм╛рмгрнА, рморнБрм╣рмБ, рм░рм╛рмХрнНрм╖рм╕
ЁЯТА => ЁЯТА, рмЦрмкрнБрм░рм┐, рмкрм░рнА рмХрм╛рм╣рм╛рмгрнА, рморнБрм╣рмБ, рм╢рм░рнАрм░
тШа => тШа, рмЕрм╕рнБрм░, рмЦрмкрнБрм░рм┐, рмЦрмкрнБрм░рм┐ рмПрммрмВ рмЫрмХрм┐ рм╣рнЛрмЗ рм░рм╣рм┐рмерм┐рммрм╛ рм╣рм╛рмб, рмЫрмХрм┐ рм╣рнЛрмЗ рм░рм╣рм┐рмерм┐рммрм╛ рм╣рм╛рмб, рморнБрм╣рмБ, рморнГрмдрнНрнЯрнБ
ЁЯС╗ => ЁЯС╗, рмкрм░рнА рмХрм╛рм╣рм╛рмгрнА, рмнрнБрмд, рмнрнВрмд, рморнБрм╣рмБ
ЁЯС╜ => ЁЯС╜, рмЕрмирнНрнЯ рмЧрнНрм░рм╣рм░ рмЬрнАрмм рммрм╛ рмПрм▓рм┐рмПрмирнНтАМ, рмЕрммрм╛рм╕рнНрмдрмм рмХрм│рнНрмкрмирм╛, рмЕрм╕рнБрм░, рмЙрмлрнЛ, рмЬрнАрммрмЬрмирнНрмдрнБ, рмкрм░рнА рмХрм╛рм╣рм╛рмгрнА, рморм╣рм╛рмХрм╛рм╢рм░ рмЕрмирнНрнЯ рмЬрмЧрмдрм░рнБ рмЖрм╕рм┐рмерм┐рммрм╛ рмкрнНрм░рм╛рмгрнА, рморнБрм╣рмБ
ЁЯС╛ => ЁЯС╛, рмЕрмирнНрнЯ рмЧрнНрм░рм╣рм░ рмЬрнАрмм, рмЕрмирнНрнЯ рмЧрнНрм░рм╣рм░ рмжрм╛рмирмм, рмЕрммрм╛рм╕рнНрмдрмм рмХрм│рнНрмкрмирм╛, рмЕрм╕рнБрм░, рмЙрмлрнЛ, рмЬрнАрммрмЬрмирнНрмдрнБ, рмкрм░рнА рмХрм╛рм╣рм╛рмгрнА, рморм╣рм╛рмХрм╛рм╢рм░ рмЕрмирнНрнЯ рмЬрмЧрмдрм░рнБ рмЖрм╕рм┐рмерм┐рммрм╛ рмкрнНрм░рм╛рмгрнА, рморнБрм╣рмБ
ЁЯдЦ => ЁЯдЦ, рморнБрм╣рмБ ред рмЕрм╕рнБрм░ ред рм░рнЛрммрмЯрнНтАМ, рм░рнЛрммрнЛрмЯрнН рморнБрм╣рмБ
ЁЯТй => ЁЯТй, рмбрмЩрнНрмЧ, рмкрм╛рмЗрм▓рнН, рмкрнЛ, рмкрнЛрмкрнН, рмкрнЛрм░ рмкрм┐рмЖрм▓рнН, рморм│ рмЧрмжрм╛
ЁЯШ║ => ЁЯШ║, рмЦрнЛрм▓рм╛ рмкрм╛рмЯрм┐, рмЦрнЛрм▓рм╛ рмкрм╛рмЯрм┐ рм╕рм╣рм┐рмд рм╣рм╕рм╣рм╕рм┐рмЖ рммрм┐рм░рм╛рмбрм┐ рморнБрм╣рмБ, рмЦрнЛрм▓рм╛. рмкрм╛рмЯрм┐, рммрм┐рм░рм╛рмбрм┐, рммрм┐рм░рм╛рмбрм┐ рморнБрм╣рмБ, рморнБрм╣рмБ, рм╣рм╕рмХрнБрм░рм╛ рммрм┐рм░рм╛рмбрм┐ рморнБрм╣рмБ, рм╣рм╕рм╣рм╕рм┐рмЖ рммрм┐рм░рм╛рмбрм┐ рморнБрм╣рмБ
ЁЯШ╕ => ЁЯШ╕, рммрм┐рм░рм╛рмбрм┐, рммрм┐рм░рм╛рмбрм┐ рморнБрм╣рмБ, рморнБрм╣рмБ, рм╣рм╕ рм╕рм╣рм┐рмд рммрм┐рм░рм╛рмбрм┐ рморнБрм╣рмБ рмПрммрмВ рм╣рм╕рм╣рм╕рм┐рмЖ рмЖрмЦрм┐, рм╣рм╕рм╣рм╕рм┐рмЖ, рм╣рм╕рм╣рм╕рм┐рмЖ рммрм┐рм░рм╛рмбрм┐ рморнБрм╣рмБ, рм╣рм╕рнБрмерм┐рммрм╛ рмЖрмЦрм┐ рм╕рм╣рм┐рмд рм╣рм╕рмХрнБрм░рм╛ рммрм┐рм░рм╛рмбрм┐ рморнБрм╣рмБ
ЁЯШ╣ => ЁЯШ╣, рмЖрмирмирнНрмжрнНрм░рм╛рм╢рнНрм░рнБ рм╕рм╣рм┐рмд рммрм┐рм░рм╛рмбрм┐ рморнБрм╣рмБ, рмЦрнБрм╕рнАрм░ рм▓рнБрм╣, рмЦрнБрм╕рнАрм░ рм▓рнБрм╣ рм╕рм╣рм┐рмд рммрм┐рм░рм╛рмбрм┐ рморнБрм╣рмБ, рммрм┐рм░рм╛рмбрм┐, рммрм┐рм░рм╛рмбрм┐ рморнБрм╣рмБ, рморнБрм╣рмБ
ЁЯШ╗ => ЁЯШ╗, рмЖрмЦрм┐, рмкрнНрм░рнЗрмо, рмкрнНрм░рнЗрморм░рнЗ, рммрм┐рм░рм╛рмбрм┐, рммрм┐рм░рм╛рмбрм┐ рморнБрм╣рмБ, рморнБрм╣рмБ, рм╣рм╕рм╣рм╕рм┐рмЖ рммрм┐рм░рм╛рмбрм┐ рморнБрм╣рмБ, рм╣рнГрмжрнЯ, рм╣рнГрмжрнЯ-рмЖрмХрнГрмдрм┐ рмЖрмЦрм┐ рм╕рм╣рм┐рмд рм╣рм╕рм╣рм╕рм┐рмЖ рммрм┐рм░рм╛рмбрм┐, рм╣рнГрмжрнЯ-рмЖрмЦрм┐ рм╕рм╣рм┐рмд рм╣рм╕рнБрмерм┐рммрм╛ рммрм┐рм░рм╛рмбрм┐ рморнБрм╣рмБ
ЁЯШ╝ => ЁЯШ╝, рммрм┐рмХрнГрмд, рммрм┐рмХрнГрмд рммрм┐рм░рм╛рмбрм┐ рморнБрм╣рмБ, рммрм┐рмХрнГрмд рм╣рм╕, рммрм┐рмХрнГрмд рм╣рм╕ рм╕рм╣рм┐рмд рммрм┐рм░рм╛рмбрм┐ рморнБрм╣рмБ, рммрм┐рм░рм╛рмбрм┐, рммрм┐рм░рм╛рмбрм┐ рморнБрм╣рмБ, рморнБрм╣рмБ
ЁЯШ╜ => ЁЯШ╜, рмЖрмЦрм┐, рмЖрмЦрм┐ рммрмирнНрмж рм╣рнЛрмЗрмЫрм┐, рмЪрнБрморм╛, рмЪрнБрморм╛рмжрнЗрмЙрмерм┐рммрм╛ рммрм┐рм░рм╛рмбрм┐, рмЪрнБрморм╛рмжрнЗрммрм╛, рммрмирнНрмж рмЖрмЦрм┐ рм╕рм╣рм┐рмд рмЪрнБрморнНрммрми рмжрнЗрмЙрмерм┐рммрм╛ рммрм┐рм░рм╛рмбрм┐ рморнБрм╣рмБ, рммрмирнНрмж рм╣рнЛрмЗрмЫрм┐, рммрм┐рм░рм╛рмбрм┐, рморнБрм╣рмБ
ЁЯЩА => ЁЯЩА, рмЕрммрм╕рмирнНрми рммрм┐рм░рм╛рмбрм┐ рморнБрм╣рмБ, рмермХрм┐рмпрм╛рмЗрмерм┐рммрм╛ рммрм┐рм░рм╛рмбрм┐ рморнБрм╣рмБ, рмкрнНрм░рмХрнГрмдрм░рнЗ рмЖрм╢рнНрмЪрм░рнНрмпрнНрнЯ рм╣рнЛрмЗрмерм┐рммрм╛, рммрм┐рм░рм╛рмбрм┐, рморнБрм╣рмБ, рм╣рнЗ рмнрмЧрммрм╛рми
ЁЯШ┐ => ЁЯШ┐, рмХрм╛рмирнНрмжрм┐рммрм╛, рмХрм╛рмирнНрмжрм┐рммрм╛ рморнБрм╣рмБ, рмХрм╛рмирнНрмжрнБрмерм┐рммрм╛ рммрм┐рм░рм╛рмбрм┐ рморнБрм╣рмБ, рммрм┐рм░рм╛рмбрм┐, рморнБрм╣рмБ
ЁЯШ╛ => ЁЯШ╛, рмУрма рмЧрнЛрмЬрнЗрмЗ рмерм┐рммрм╛ рммрм┐рм░рм╛рмбрм┐ рморнБрм╣рмБ, рммрм┐рм░рм╛рмбрм┐, рммрм┐рм░рм╛рмжрм┐ рморнБрм╣рмБ, рморнБрм╣рмБ, рморнБрм╣рмБ рмлрнБрм▓рм╛рмЗрмерм┐рммрм╛ рммрм┐рм░рм╛рмбрм┐ рморнБрм╣рмБ, рморнБрм╣рмБ рмлрнБрм▓рм╛рмЗрммрм╛
ЁЯЩИ => ЁЯЩИ, рмЦрм░рм╛рмк рмХрмерм╛ рмжрнЗрмЦрнБрмирмерм┐рммрм╛ рморм╛рмЩрнНрмХрмб, рмЦрм░рм╛рмк рмирмжрнЗрмЦрм┐рммрм╛, рмЦрм░рм╛рмк рмирмжрнЗрмЦрнБрмерм┐рммрм╛ рморм╛рмЩрнНрмХрмб, рморм╛рмЩрнНрмХрмб
ЁЯЩЙ => ЁЯЩЙ, рмЦрм░рм╛рмк рмХрмерм╛ рм╢рнБрмгрнБрмирмерм┐рммрм╛ рморм╛рмЩрнНрмХрмб, рмЦрм░рм╛рмк рмирм╢рнБрмгрм┐рммрм╛, рмЦрм░рм╛рмк рмирм╢рнБрмгрнБрмерм┐рммрм╛ рморм╛рмЩрнНрмХрмб, рморм╛рмЩрнНрмХрмб
ЁЯЩК => ЁЯЩК, рмЦрм░рм╛рмк рмХрмерм╛ рмХрм╣рнБрмирмерм┐рммрм╛ рморм╛рмЩрнНрмХрмб, рмЦрм░рм╛рмк рмирмХрм╣рм┐рммрм╛, рмЦрм░рм╛рмк рмирмХрм╣рнБрмерм┐рммрм╛ рморм╛рмЩрнНрмХрмб, рморм╛рмЩрнНрмХрмб
ЁЯС╢ => ЁЯС╢, рмЫрнЛрмЯ рмкрм┐рм▓рм╛, рм▓рнЛрмХрморм╛рмирнЗ, рм╢рм┐рм╢рнБ
ЁЯзТ => ЁЯзТ, рмХрнНрм▓рм┐рммрм▓рм┐рмЩрнНрмЧ, рмкрм┐рм▓рм╛, рмпрнБрммрмХ
ЁЯСж => ЁЯСж, рмкрнБрмЕ рмкрм┐рм▓рм╛, рммрм╛рм│рмХ, рм▓рнЛрмХрморм╛рмирнЗ
ЁЯСз => ЁЯСз, рмЭрм┐рмЕ рмкрм┐рм▓рм╛, рммрм╛рм│рм┐рмХрм╛, рм▓рнЛрмХрморм╛рмирнЗ
ЁЯзС => ЁЯзС, рмХрнНрм▓рм┐рммрм▓рм┐рмЩрнНрмЧ, рмкрнНрм░рм╛рмкрнНрмд рммрнЯрм╕рнНрмХ
ЁЯСи => ЁЯСи, рмкрнБрм░рнБрм╖
ЁЯСй => ЁЯСй, рморм╣рм┐рм│рм╛
ЁЯзУ => ЁЯзУ, рмЕрмзрм┐рмХ рммрнЯрм╕рнНрмХ, рмХрнНрм▓рм┐рммрм▓рм┐рмЩрнНрмЧ, рммрнГрмжрнНрмз
ЁЯС┤ => ЁЯС┤, рмкрнБрм░рнБрм╖, рммрнГрмжрнНрмз, рммрнГрмжрнНрмз рммрнНрнЯрмХрнНрмдрм┐, рм▓рнЛрмХрморм╛рмирнЗ
ЁЯС╡ => ЁЯС╡, рммрнГрмжрнНрмз, рммрнГрмжрнНрмз рморм╣рм┐рм│рм╛, рморм╣рм┐рм│рм╛, рм▓рнЛрмХрморм╛рмирнЗ
ЁЯСитАНтЪХ => ЁЯСитАНтЪХ, рмбрм╛рмХрнНрмдрм░, рмернЗрм░рм╛рмкрм┐рм╖рнНрмЯ, рмирм░рнНрм╕рнНтАМ, рмкрнБрм░рнБрм╖, рмкрнБрм░рнБрм╖ рм╕рнНрн▒рм╛рм╕рнНрмернНрнЯ рмХрм░рнНрморнА, рм╕рнНрн▒рм╛рм╕рнНрмернНрнЯрм╕рнЗрммрм╛
ЁЯСйтАНтЪХ => ЁЯСйтАНтЪХ, рмбрм╛рмХрнНрмдрм░, рмернЗрм░рм╛рмкрм┐рм╖рнНрмЯ, рмирм░рнНрм╕рнНтАМ, рморм╣рм┐рм│рм╛, рморм╣рм┐рм│рм╛ рм╕рнНрн▒рм╛рм╕рнНрмернНрнЯ рмХрм░рнНрморнА, рм╕рнНрн▒рм╛рм╕рнНрмернНрнЯрм╕рнЗрммрм╛
ЁЯСитАНЁЯОУ => ЁЯСитАНЁЯОУ, рмкрнБрм░рнБрм╖, рмкрнБрм░рнБрм╖ рммрм┐рмжрнНрнЯрм╛рм░рнНрмернА, рммрм┐рмжрнНрнЯрм╛рм░рнНрмернА, рм╕рнНрмирм╛рмдрмХ
ЁЯСйтАНЁЯОУ => ЁЯСйтАНЁЯОУ, рммрм┐рмжрнНрнЯрм╛рм░рнНрмернА, рморм╣рм┐рм│рм╛, рморм╣рм┐рм│рм╛ рммрм┐рмжрнНрнЯрм╛рм░рнНрмернА, рм╕рнНрмирм╛рмдрмХ
ЁЯСитАНЁЯПл => ЁЯСитАНЁЯПл, рмЕрмзрнНрнЯрм╛рмкрмХ, рмЙрмкрмжрнЗрм╖рнНрмЯрм╛, рмкрнБрм░рнБрм╖, рмкрнБрм░рнБрм╖ рм╢рм┐рмХрнНрм╖рмХ, рм╢рм┐рмХрнНрм╖рмХ
ЁЯСйтАНЁЯПл => ЁЯСйтАНЁЯПл, рмЕрмзрнНрнЯрм╛рмкрмХ, рмЙрмкрмжрнЗрм╖рнНрмЯрм╛, рмкрнБрм░рнБрм╖, рморм╣рм┐рм│рм╛ рм╢рм┐рмХрнНрм╖рмХ, рм╢рм┐рмХрнНрм╖рмХ
ЁЯСитАНтЪЦ => ЁЯСитАНтЪЦ, рмкрнБрм░рнБрм╖, рмкрнБрм░рнБрм╖ рммрм┐рмЪрм╛рм░рмкрмдрм┐, рммрм┐рмЪрм╛рм░рмкрмдрм┐, рм╕рнНрмХрнЗрм▓рнНтАМрмЧрнБрмбрм┐рмХ
ЁЯСйтАНтЪЦ => ЁЯСйтАНтЪЦ, рммрм┐рмЪрм╛рм░рмкрмдрм┐, рморм╣рм┐рм│рм╛, рморм╣рм┐рм│рм╛ рммрм┐рмЪрм╛рм░рмкрмдрм┐, рм╕рнНрмХрнЗрм▓рнНтАМрмЧрнБрмбрм┐рмХ
ЁЯСитАНЁЯМ╛ => ЁЯСитАНЁЯМ╛, рмХрнГрм╖рмХ, рмкрнБрм░рнБрм╖, рмкрнБрм░рнБрм╖ рмХрнГрм╖рмХ, рморм╛рм│рнА, рм░рм╛рмЮрнНрмЪрм░рнНтАМ
ЁЯСйтАНЁЯМ╛ => ЁЯСйтАНЁЯМ╛, рмХрнГрм╖рмХ, рморм╣рм┐рм│рм╛, рморм╣рм┐рм│рм╛ рмХрнГрм╖рмХ, рморм╛рм│рнА, рм░рм╛рмЮрнНрмЪрм░рнНтАМ
ЁЯСитАНЁЯН│ => ЁЯСитАНЁЯН│, рмкрм╛рмЪрмХ, рмкрнБрм░рнБрм╖, рмкрнБрм░рнБрм╖ рмкрм╛рмЪрмХ, рморнБрмЦрнНрнЯ рмкрм╛рмЪрмХ
ЁЯСйтАНЁЯН│ => ЁЯСйтАНЁЯН│, рмкрм╛рмЪрм┐рмХрм╛, рморм╣рм┐рм│рм╛, рморм╣рм┐рм│рм╛ рмкрм╛рмЪрм┐рмХрм╛, рморнБрмЦрнНрнЯ рмкрм╛рмЪрмХ
ЁЯСитАНЁЯФз => ЁЯСитАНЁЯФз, рмЗрм▓рнЗрмХрнНрмЯрнНрм░рм┐рм╕рм┐рмЖрмирнНтАМ, рмкрм╛рмЗрмкрнНтАМ рморм┐рм╕рнНрмдрнНрм░рнА, рмкрнБрм░рнБрм╖, рмкрнБрм░рнБрм╖ рморнЗрмХрм╛рмирм┐рмХрнНтАМ, рммрнНрнЯрммрм╕рм╛рнЯрнА, рморнЗрмХрм╛рмирм┐рмХрнНтАМ
ЁЯСйтАНЁЯФз => ЁЯСйтАНЁЯФз, рмЗрм▓рнЗрмХрнНрмЯрнНрм░рм┐рм╕рм┐рмЖрмирнНтАМ, рмкрм╛рмЗрмкрнНтАМ рморм┐рм╕рнНрмдрнНрм░рнА, рммрнНрнЯрммрм╕рм╛рнЯрнА, рморм╣рм┐рм│рм╛, рморм╣рм┐рм│рм╛ рморнЗрмХрм╛рмирм┐рмХрнНтАМ, рморнЗрмХрм╛рмирм┐рмХрнНтАМ
ЁЯСитАНЁЯПн => ЁЯСитАНЁЯПн, рмФрмжрнНрнЯрнЛрмЧрм┐рмХ, рмХрм╛рм░рмЦрм╛рмирм╛, рмкрнБрм░рнБрм╖, рмкрнБрм░рнБрм╖ рмХрм╛рм░рмЦрм╛рмирм╛ рм╢рнНрм░рморм┐рмХ, рм╢рнНрм░рморм┐рмХ, рм╕рморм╛рммрнЗрм╢
ЁЯСйтАНЁЯПн => ЁЯСйтАНЁЯПн, рмФрмжрнНрнЯрнЛрмЧрм┐рмХ, рмХрм╛рм░рмЦрм╛рмирм╛, рморм╣рм┐рм│рм╛, рморм╣рм┐рм│рм╛ рмХрм╛рм░рмЦрм╛рмирм╛ рм╢рнНрм░рморм┐рмХ, рм╢рнНрм░рморм┐рмХ, рм╕рморм╛рммрнЗрм╢
ЁЯСитАНЁЯТ╝ => ЁЯСитАНЁЯТ╝, рмХрм╛рм░рнНрмпрнНрнЯрм╛рм│рнЯ, рмзрм│рм╛-рмЧрм│рм╛рммрмирнНрмз, рмкрм░рм┐рмЪрм╛рм│рмХ, рмкрнБрм░рнБрм╖, рмкрнБрм░рнБрм╖ рмХрм╛рм░рнНрмпрнНрнЯрм╛рм│рнЯ рмХрм░рнНрмормЪрм╛рм░рнА, рммрнНрнЯрммрм╕рм╛рнЯ, рм╕рнНрмермкрмдрм┐рммрм┐рмжрнНрнЯрм╛рммрм┐рмдрнНтАМ рммрм╛ рмЖрм░рнНрмХрм┐рмЯрнЗрмХрнНрмЯ
ЁЯСйтАНЁЯТ╝ => ЁЯСйтАНЁЯТ╝, рмХрм╛рм░рнНрмпрнНрнЯрм╛рм│рнЯ, рмзрм│рм╛-рмЧрм│рм╛рммрмирнНрмз, рмкрм░рм┐рмЪрм╛рм│рмХ, рммрнНрнЯрммрм╕рм╛рнЯ, рморм╣рм┐рм│рм╛, рморм╣рм┐рм│рм╛ рмХрм╛рм░рнНрмпрнНрнЯрм╛рм│рнЯ рмХрм░рнНрмормЪрм╛рм░рнА, рм╕рнНрмермкрмдрм┐рммрм┐рмжрнНрнЯрм╛рммрм┐рмдрнНтАМ рммрм╛ рмЖрм░рнНрмХрм┐рмЯрнЗрмХрнНрмЯ
ЁЯСитАНЁЯФм => ЁЯСитАНЁЯФм, рмЗрмЮрнНрмЬрм┐рмирм┐рнЯрм░рнНтАМ, рмЧрмгрм┐рмдрмЬрнНрмЮ, рмЬрнАрммрммрм┐рмЬрнНрмЮрм╛рмирнА, рмкрнБрм░рнБрм╖, рмкрнБрм░рнБрм╖ рммрнИрмЬрнНрмЮрм╛рмирм┐рмХ, рммрнИрмЬрнНрмЮрм╛рмирм┐рмХ, рмнрнМрмдрм┐рмХ рммрм┐рмЬрнНрмЮрм╛рмирнА, рм░рм╕рм╛рнЯрмирммрм┐рмдрнНтАМ
ЁЯСйтАНЁЯФм => ЁЯСйтАНЁЯФм, рмЗрмЮрнНрмЬрм┐рмирм┐рнЯрм░рнНтАМ, рмЧрмгрм┐рмдрмЬрнНрмЮ, рмЬрнАрммрммрм┐рмЬрнНрмЮрм╛рмирнА, рммрнИрмЬрнНрмЮрм╛рмирм┐рмХ, рмнрнМрмдрм┐рмХ рммрм┐рмЬрнНрмЮрм╛рмирнА, рморм╣рм┐рм│рм╛, рморм╣рм┐рм│рм╛ рммрнИрмЬрнНрмЮрм╛рмирм┐рмХ, рм░рм╕рм╛рнЯрмирммрм┐рмдрнНтАМ
ЁЯСитАНЁЯТ╗ => ЁЯСитАНЁЯТ╗, рмЗрмЮрнНрмЬрм┐рмирм┐рнЯрм░рнНтАМ, рмЧрмгрм┐рмдрмЬрнНрмЮ, рмЬрнАрммрммрм┐рмЬрнНрмЮрм╛рмирнА, рмкрнБрм░рнБрм╖, рмкрнБрм░рнБрм╖ рмЯрнЗрмХрнНрмирнЛрм▓рнЛрмЬрм┐рм╖рнНрмЯ, рммрнИрмЬрнНрмЮрм╛рмирм┐рмХ, рмнрнМрмдрм┐рмХ рммрм┐рмЬрнНрмЮрм╛рмирнА, рм░рм╕рм╛рнЯрмирммрм┐рмдрнНтАМ
ЁЯСйтАНЁЯТ╗ => ЁЯСйтАНЁЯТ╗, рмЗрмЮрнНрмЬрм┐рмирм┐рнЯрм░рнНтАМ, рмЧрмгрм┐рмдрмЬрнНрмЮ, рмЬрнАрммрммрм┐рмЬрнНрмЮрм╛рмирнА, рммрнИрмЬрнНрмЮрм╛рмирм┐рмХ, рмнрнМрмдрм┐рмХ рммрм┐рмЬрнНрмЮрм╛рмирнА, рморм╣рм┐рм│рм╛, рморм╣рм┐рм│рм╛ рмЯрнЗрмХрнНрмирнЛрм▓рнЛрмЬрм┐рм╖рнНрмЯ, рм░рм╕рм╛рнЯрмирммрм┐рмдрнНтАМ
ЁЯСитАНЁЯОд => ЁЯСитАНЁЯОд, рмЕрмнрм┐рмирнЗрмдрм╛, рмЧрм╛рнЯрм┐рмХ, рмкрнБрм░рнБрм╖, рмкрнБрм░рнБрм╖ рмЧрм╛рнЯрм┐рмХ, рмормирнЛрм░рмЮрнНрмЬрмирмХрм╛рм░рнА, рм░рмХрнНтАМ, рм╖рнНрмЯрм╛рм░рнНтАМ
ЁЯСйтАНЁЯОд => ЁЯСйтАНЁЯОд, рмЕрмнрм┐рмирнЗрмдрнНрм░рнА, рмЧрм╛рнЯрм┐рмХрм╛, рмормирнЛрм░рмЮрнНрмЬрмирмХрм╛рм░рнА, рморм╣рм┐рм│рм╛, рморм╣рм┐рм│рм╛ рмЧрм╛рнЯрм┐рмХрм╛, рм░рмХрнНтАМ, рм╖рнНрмЯрм╛рм░рнНтАМ
ЁЯСитАНЁЯОи => ЁЯСитАНЁЯОи, рмХрм│рм╛рмХрм╛рм░, рмкрнБрм░рнБрм╖, рмкрнБрм░рнБрм╖ рмХрм│рм╛рмХрм╛рм░, рмкрнНрнЯрм╛рм▓рнЗрмЯрнНтАМ
ЁЯСйтАНЁЯОи => ЁЯСйтАНЁЯОи, рмХрм│рм╛рмХрм╛рм░, рмкрнНрнЯрм╛рм▓рнЗрмЯрнНтАМ, рморм╣рм┐рм│рм╛, рморм╣рм┐рм│рм╛ рмХрм│рм╛рмХрм╛рм░
ЁЯСитАНтЬИ => ЁЯСитАНтЬИ, рмкрм╛рмЗрм▓рмЯрнНтАМ, рмкрнБрм░рнБрм╖, рмкрнБрм░рнБрм╖ рмкрм╛рмЗрм▓рмЯрнН, рмкрнНрм▓рнЗрмирнНтАМ
ЁЯСйтАНтЬИ => ЁЯСйтАНтЬИ, рмкрнБрм░рнБрм╖, рморм╣рм╛рмХрм╛рм╢рмЪрм╛рм░рнА, рморм╣рм┐рм│рм╛ рмкрм╛рмЗрм▓рмЯрнНтАМ, рм░рмХрнЗрмЯрнНтАМ
ЁЯСитАНЁЯЪА => ЁЯСитАНЁЯЪА, рмкрнБрм░рнБрм╖, рмкрнБрм░рнБрм╖ рморм╣рм╛рмХрм╛рм╢рмЪрм╛рм░рнА, рморм╣рм╛рмХрм╛рм╢рмЪрм╛рм░рнА, рм░рмХрнЗрмЯрнНтАМ
ЁЯСйтАНЁЯЪА => ЁЯСйтАНЁЯЪА, рморм╣рм╛рмХрм╛рм╢рмЪрм╛рм░рнА, рморм╣рм┐рм│рм╛, рморм╣рм┐рм│рм╛ рморм╣рм╛рмХрм╛рм╢рмЪрм╛рм░рнА, рм░рмХрнЗрмЯрнНтАМ
ЁЯСитАНЁЯЪТ => ЁЯСитАНЁЯЪТ, рмкрнБрм░рнБрм╖, рмкрнБрм░рнБрм╖ рмлрм╛рнЯрм╛рм░рмлрм╛рмЗрмЯрм░рнНтАМ, рмлрм╛рнЯрм╛рм░рмЯрнНрм░рмХрнНтАМ, рмлрм╛рнЯрм╛рм░рмлрм╛рмЗрмЯрм░рнНтАМ
ЁЯСйтАНЁЯЪТ => ЁЯСйтАНЁЯЪТ, рмлрм╛рнЯрм╛рм░рмЯрнНрм░рмХрнНтАМ, рмлрм╛рнЯрм╛рм░рмлрм╛рмЗрмЯрм░рнНтАМ, рморм╣рм┐рм│рм╛, рморм╣рм┐рм│рм╛ рмлрм╛рнЯрм╛рм░рмлрм╛рмЗрмЯрм░рнНтАМ
ЁЯСо => ЁЯСо, рмЕрмзрм┐рмХрм╛рм░рнА, рмкрнЛрм▓рм┐рм╕рнН, рмкрнЛрм▓рм┐рм╕рнНтАМ рмЕрмзрм┐рмХрм╛рм░рнА, рм▓рнЛрмХрморм╛рмирнЗ
ЁЯСотАНтЩВ => ЁЯСотАНтЩВ, рмЕрмзрм┐рмХрм╛рм░рнА, рмкрнБрм░рнБрм╖, рмкрнБрм░рнБрм╖ рмкрнЛрм▓рм┐рм╕рнН рмЕрмлрм┐рм╕рм░рнН, рмкрнЛрм▓рм┐рм╕рнНтАМ, рмкрнЛрм▓рм┐рм╕рнНтАМ рмЕрмлрм┐рм╕рм░рнНтАМ
ЁЯСотАНтЩА => ЁЯСотАНтЩА, рмЕрмзрм┐рмХрм╛рм░рнА, рмкрнЛрм▓рм┐рм╕рнНтАМ, рмкрнЛрм▓рм┐рм╕рнНтАМ рмЕрмлрм┐рм╕рм░рнНтАМ, рморм╣рм┐рм│рм╛, рморм╣рм┐рм│рм╛ рмкрнЛрм▓рм┐рм╕рнНтАМ рмЕрмзрм┐рмХрм╛рм░рнА
ЁЯХ╡ => ЁЯХ╡, рмЧрнБрмЗрмирнНрмжрм╛, рмЧрнБрмкрнНрмдрмЪрм░, рмбрм┐рмЯрнЗрмХрнНрмЯрм┐рмнрнНтАМ
ЁЯХ╡тАНтЩВ => ЁЯХ╡тАНтЩВ, рмЧрнБрмЗрмирнНрмжрм╛, рмЧрнБрмкрнНрмдрмЪрм░, рмбрм┐рмЯрнЗрмХрнНрмЯрм┐рмнрнНтАМ, рмкрнБрм░рнБрм╖, рмкрнБрм░рнБрм╖ рмбрм┐рмЯрнЗрмХрнНрмЯрм┐рмнрнНтАМ
ЁЯХ╡тАНтЩА => ЁЯХ╡тАНтЩА, рмЧрнБрмЗрмирнНрмжрм╛, рмЧрнБрмкрнНрмдрмЪрм░, рмбрм┐рмЯрнЗрмХрнНрмЯрм┐рмнрнНтАМ, рморм╣рм┐рм│рм╛, рморм╣рм┐рм│рм╛ рмбрм┐рмЯрнЗрмХрнНрмЯрм┐рмнрнНтАМ
ЁЯТВ => ЁЯТВ, рмЧрм╛рм░рнНрмб, рм▓рнЛрмХрморм╛рмирнЗ, рм╕рнБрм░рмХрнНрм╖рм╛ рмХрм░рнНрморнА, рм╕рнБрм░рмХрнНрм╖рм╛рмХрм░рнНрморнА
ЁЯТВтАНтЩВ => ЁЯТВтАНтЩВ, рмкрнБрм░рнБрм╖ рм╕рнБрм░рмХрнНрм╖рм╛ рмХрм░рнНрморнА, рм╕рнБрм░рмХрнНрм╖рм╛ рмХрм░рнНрморнА ред рмкрнБрм░рнБрм╖
ЁЯТВтАНтЩА => ЁЯТВтАНтЩА, рморм╣рм┐рм│рм╛ рм╕рнБрм░рмХрнНрм╖рм╛ рмХрм░рнНрморнА, рм╕рнБрм░рмХрнНрм╖рм╛ рмХрм░рнНрморнА ред рморм╣рм┐рм│рм╛
ЁЯС╖ => ЁЯС╖, рмирм┐рм░рнНрморм╛рмг, рмирм┐рм░рнНрморм╛рмг рм╢рнНрм░рморм┐рмХ, рм▓рнЛрмХрморм╛рмирнЗ, рм╢рнНрм░рморм┐рмХ
ЁЯС╖тАНтЩВ => ЁЯС╖тАНтЩВ, рмирм┐рм░рнНрморм╛рмг, рмкрнБрм░рнБрм╖, рмкрнБрм░рнБрм╖ рмирм┐рм░рнНрморм╛рмг рм╢рнНрм░рморм┐рмХ, рм╢рнНрм░рморм┐рмХ
ЁЯС╖тАНтЩА => ЁЯС╖тАНтЩА, рмирм┐рм░рнНрморм╛рмг, рморм╣рм┐рм│рм╛, рморм╣рм┐рм│рм╛ рмирм┐рм░рнНрморм╛рмг рм╢рнНрм░рморм┐рмХ, рм╢рнНрм░рморм┐рмХ
ЁЯд┤ => ЁЯд┤, рм░рм╛рмЬрмХрнБрморм╛рм░
ЁЯС╕ => ЁЯС╕, рмкрм░рнА рмХрм╛рм╣рм╛рмгрнА, рм░рм╛рмЬрмХрнБрморм╛рм░рнА, рм▓рнЛрмХрморм╛рмирнЗ
ЁЯС│ => ЁЯС│, рмкрмЧрмбрм┐, рмкрмЧрмбрм┐ рмкрм┐рмирнНрмзрм┐рмерм┐рммрм╛ рммрнНрнЯрмХрнНрмдрм┐
ЁЯС│тАНтЩВ => ЁЯС│тАНтЩВ, рмкрмЧрмбрм┐ рмкрм┐рмирнНрмзрм┐рмерм┐рммрм╛ рмкрнБрм░рнБрм╖, рмкрнБрм░рнБрм╖ ред рмкрмЧрмбрм┐
ЁЯС│тАНтЩА => ЁЯС│тАНтЩА, рмкрмЧрмбрм┐ ред рморм╣рм┐рм│рм╛, рмкрмЧрмбрм┐ рмкрм┐рмирнНрмзрм┐рмерм┐рммрм╛ рморм╣рм┐рм│рм╛
ЁЯС▓ => ЁЯС▓, рмЧрнБрмЖ рмкрм┐ рморм╛рмУ, рмЧрнБрмЖ рмкрм┐ рморм╛рмУ рм╕рм╣рм┐рмд рмкрнБрм░рнБрм╖, рмЪрм╛рмЗрмирм┐рмЬрнНтАМ рмЯрнЛрмкрм┐ рм╕рм╣рм┐рмд рмкрнБрм░рнБрм╖, рмкрнБрм░рнБрм╖, рм▓рнЛрмХрморм╛рмирнЗ
ЁЯзХ => ЁЯзХ, рмЯрм┐рмЪрнЗрм▓рнНтАМ, рморм╛рмгрнНрмЯрм┐рм▓рм╛, рм░рнБрморм╛рм▓ рм╕рм╣рм┐рмд рморм╣рм┐рм│рм╛, рм╣рм┐рмЬрм╛рмм, рм╣рнЗрмбрм╕рнНрмХрм╛рм░рнНрмл
ЁЯзФ => ЁЯзФ, рмжрм╛рмврм┐, рмжрм╛рмврм┐рмЖ рммрнНрнЯрмХрнНрмдрм┐
ЁЯС▒ => ЁЯС▒, рм▓рнЛрмХрморм╛рмирнЗ, рм╕рнБрмирнЗрм▓рм┐ рммрм░рнНрмгрнНрмг, рм╕рнБрмирнЗрм▓рм┐ рм░рмЩрнНрмЧрм░ рмХрнЗрм╢ рмерм┐рммрм╛ рммрнНрнЯрмХрнНрмдрм┐, рм╕рнБрмирнЗрм▓рм┐-рмХрнЗрм╢рмпрнБрмХрнНрмд рммрнНрнЯрмХрнНрмдрм┐
ЁЯС▒тАНтЩВ => ЁЯС▒тАНтЩВ, рмЧрнЛрм░рм╛, рмкрнБрм░рнБрм╖, рм╕рнБрмирнЗрм▓рм┐-рмХрнЗрм╢рмпрнБрмХрнНрмд рмкрнБрм░рнБрм╖
ЁЯС▒тАНтЩА => ЁЯС▒тАНтЩА, рмЧрнЛрм░рм╛, рморм╣рм┐рм│рм╛, рм╕рнБрмирнЗрм▓рм┐-рмХрнЗрм╢рмпрнБрмХрнНрмд рморм╣рм┐рм│рм╛
ЁЯд╡ => ЁЯд╡, рмЯрнБрмХрнНрм╕рнЗрмбрнЛ, рмЯрнБрмХрнНрм╕рнЗрмбрнЛрм░рнЗ рмкрнБрм░рнБрм╖, рмкрнБрм░рнБрм╖, рммрм░
ЁЯС░ => ЁЯС░, рмПрмХ рмУрмврмгрм┐ рмерм┐рммрм╛ рммрмзрнВ, рмУрмврмгрм┐, рмУрмврмгрм┐ рмкрмХрм╛рмЗрмерм┐рммрм╛ рммрмзрнБ, рммрмзрнВ, рммрм┐рммрм╛рм╣, рм▓рнЛрмХрморм╛рмирнЗ
ЁЯд░ => ЁЯд░, рмЧрм░рнНрмнрммрмдрнА ред рморм╣рм┐рм│рм╛, рмЧрм░рнНрмнрммрмдрнА рморм╣рм┐рм│рм╛
ЁЯд▒ => ЁЯд▒, рм╕рнНрмдрми ред рм╢рм┐рм╢рнБ ред рм▓рм╛рм│рми рмкрм╛рм│рми рмХрм░рм┐рммрм╛, рм╕рнНрмдрмирнНрнЯрмкрм╛рми рмХрм░рм╛рмЗрммрм╛
ЁЯС╝ => ЁЯС╝, рмжрнЗрммрмжрнВрмд, рмкрм░рнА рмХрм╛рм╣рм╛рмгрнА, рморнБрм╣рмБ, рм╢рм┐рм╢рнБ рмжрнЗрммрмжрнВрмд
ЁЯОЕ => ЁЯОЕ, рмЙрмдрнНрм╕рмм, рмЦрнНрм░рнАрм╖рнНрмЯрморм╛рм╕, рм╕рм╛рмгрнНрмЯрм╛, рм╕рм╛рмгрнНрмЯрм╛ рмХрнНрм▓рм╕рнНтАН, рм╕рм╛рмгрнНрмЯрм╛рмХрнНрм▓рм╕рнНтАМ
ЁЯд╢ => ЁЯд╢, рмЦрнНрм░рнАрм╖рнНрмЯрморм╛рм╕ ред рмЙрмдрнНрм╕рмм рмкрм╛рм│рми ред рморм╛рмЖ ред рм╢рнНрм░рнАрмормдрнА ред рмХрнНрм▓рм╕рнНтАН, рм╢рнНрм░рнАрмормдрнА рмХрнНрм▓рм╕рнНтАН
ЁЯзЩ => ЁЯзЩ, рмпрм╛рмжрнБрмХрм░, рмпрм╛рмжрнБрмХрм░ ред рмбрм╛рм╣рм╛рмгрнА ред рмдрм╛рмирнНрмдрнНрм░рм┐рмХ ред рмдрмирнНрмдрнНрм░рмХрм╛рм░рм┐рмгрнА
ЁЯзЩтАНтЩА => ЁЯзЩтАНтЩА, рмбрм╛рм╣рм╛рмгрнА ред рмдрмирнНрмдрнНрм░рмХрм╛рм░рм┐рмгрнА, рморм╣рм┐рм│рм╛ рмпрм╛рмжрнБрмХрм░
ЁЯзЩтАНтЩВ => ЁЯзЩтАНтЩВ, рмкрнБрм░рнБрм╖ рмпрм╛рмжрнБрмХрм░, рмпрм╛рмжрнБрмХрм░ ред рмдрм╛рмирнНрмдрнНрм░рм┐рмХ
ЁЯзЪ => ЁЯзЪ, рмдрм┐рмдрм╛рмирм┐рмЖ ред рмкрнБрмХрнНтАН ред рмУрммрнЗрм░рмирнНтАН, рмкрм░рнА
ЁЯзЪтАНтЩА => ЁЯзЪтАНтЩА, рмдрм┐рмдрм╛рмирм┐рмЖ, рморм╣рм┐рм│рм╛ рмкрм░рнА
ЁЯзЪтАНтЩВ => ЁЯзЪтАНтЩВ, рмкрнБрмХрнНтАН ред рмУрммрнЗрм░рмирнНтАН, рмкрнБрм░рнБрм╖ рмкрм░рнА
ЁЯзЫ => ЁЯзЫ, рмбрнНрм░рм╛рмХрнБрм▓рм╛ ред рмкрнНрм░рнЗрмдрм╛рмдрнНрморм╛, рмкрм┐рм╢рм╛рмЪ
ЁЯзЫтАНтЩА => ЁЯзЫтАНтЩА, рмкрнНрм░рнЗрмдрм╛рмдрнНрморм╛, рморм╣рм┐рм│рм╛ рмкрм┐рм╢рм╛рмЪ
ЁЯзЫтАНтЩВ => ЁЯзЫтАНтЩВ, рмбрнНрм░рм╛рмХрнБрм▓рм╛ ред рмкрнНрм░рнЗрмдрм╛рмдрнНрморм╛, рмкрнБрм░рнБрм╖ рмкрм┐рм╢рм╛рмЪ
ЁЯзЬ => ЁЯзЬ, рморм░рмкрм░рнНрм╕рми, рморм░рморнЗрмбрнНтАН ред рморм░рморнНрнЯрм╛рми ред рморм░рмУрморнНрнЯрм╛рми
ЁЯзЬтАНтЩА => ЁЯзЬтАНтЩА, рморм░рмУрморнНрнЯрм╛рми, рморм░рморнЗрмбрнНтАН
ЁЯзЬтАНтЩВ => ЁЯзЬтАНтЩВ, рмЯрнНрм░рм┐рмЯрнЛрмирнНтАН, рморм░рморнНрнЯрм╛рми
ЁЯзЭ => ЁЯзЭ, рмПрм▓рмлрнНтАН, рмХрнБрм╣рнБрмХ рм╕рморнНрммрмирнНрмзрнАрнЯ
ЁЯзЭтАНтЩА => ЁЯзЭтАНтЩА, рмХрнБрм╣рнБрмХ рм╕рморнНрммрмирнНрмзрнАрнЯ, рморм╣рм┐рм│рм╛ рмПрм▓рмлрнНтАН
ЁЯзЭтАНтЩВ => ЁЯзЭтАНтЩВ, рмХрнБрм╣рнБрмХ рм╕рморнНрммрмирнНрмзрнАрнЯ, рмкрнБрм░рнБрм╖ рмПрм▓рмлрнНтАН
ЁЯзЮ => ЁЯзЮ, рмЬрм┐рмирнНрми, рмЬрнЗрмирм┐
ЁЯзЮтАНтЩА => ЁЯзЮтАНтЩА, рмЬрм┐рмирнНрми, рморм╣рм┐рм│рм╛ рмЬрнЗрмирм┐
ЁЯзЮтАНтЩВ => ЁЯзЮтАНтЩВ, рмЬрм┐рмирнНрми, рмкрнБрм░рнБрм╖ рмЬрнЗрмирм┐
ЁЯзЯ => ЁЯзЯ, рмЬрнЛрморнНрммрм┐, рмкрнНрм░рнЗрмдрм╛рмдрнНрморм╛ ред рмЪрм╛рм▓рнБрмерм┐рммрм╛ рморнГрмд рм╢рм░рнАрм░
ЁЯзЯтАНтЩА => ЁЯзЯтАНтЩА, рмкрнНрм░рнЗрмдрм╛рмдрнНрморм╛ ред рмЪрм╛рм▓рнБрмерм┐рммрм╛ рморнГрмд рм╢рм░рнАрм░, рморм╣рм┐рм│рм╛ рмЬрнЛрморнНрммрм┐
ЁЯзЯтАНтЩВ => ЁЯзЯтАНтЩВ, рмкрнБрм░рнБрм╖ рмЬрнЛрморнНрммрм┐, рмкрнНрм░рнЗрмдрм╛рмдрнНрморм╛ ред рмЪрм╛рм▓рнБрмерм┐рммрм╛ рморнГрмд рм╢рм░рнАрм░
ЁЯЩН => ЁЯЩН, рмЗрмЩрнНрмЧрм┐рмд, рмХрнНрм░рнЛрмзрм┐рмд, рмХрнНрм░рнЛрмзрм┐рмд рммрнНрнЯрмХрнНрмдрм┐, рммрнНрнЯрмХрнНрмдрм┐, рммрнНрнЯрмХрнНрмдрм┐ рмнрнНрм░рнБрмХрнБрмЮрнНрмЪрми рмХрм░рнБрмЫрмирнНрмдрм┐
ЁЯЩНтАНтЩВ => ЁЯЩНтАНтЩВ, рмЕрмЩрнНрмЧрмнрмЩрнНрмЧрнА, рмкрнБрм░рнБрм╖, рмкрнБрм░рнБрм╖ рмнрнНрм░рнБрмХрнБрмЮрнНрмЪрми рмХрм░рнБрмЫрмирнНрмдрм┐, рмнрнНрм░рнБрмХрнБрмЮрнНрмЪрми рмХрм░рм┐рммрм╛
ЁЯЩНтАНтЩА => ЁЯЩНтАНтЩА, рмЕрмЩрнНрмЧрмнрмЩрнНрмЧрнА, рмнрнНрм░рнБрмХрнБрмЮрнНрмЪрми рмХрм░рм┐рммрм╛, рморм╣рм┐рм│рм╛, рморм╣рм┐рм│рм╛ рмнрнНрм░рнБрмХрнБрмЮрнНрмЪрми рмХрм░рнБрмЫрмирнНрмдрм┐
ЁЯЩО => ЁЯЩО, рмЗрмЩрнНрмЧрм┐рмд, рммрнНрнЯрмХрнНрмдрм┐, рммрнНрнЯрмХрнНрмдрм┐ рмУрмармХрнБ рмЧрнЛрмЬрмЙрмЫрмирнНрмдрм┐, рморнБрм╣рмБ рмлрнБрм▓рм╛рмЗрмерм┐рммрм╛ рммрнНрнЯрмХрнНрмдрм┐, рморнБрм╣рмБ рмлрнБрм▓рм╛рмЗрммрм╛
ЁЯЩОтАНтЩВ => ЁЯЩОтАНтЩВ, рмЕрмЩрнНрмЧрмнрмЩрнНрмЧрнА, рмУрма рмЧрнЛрмЬрнЗрмЗрммрм╛, рмкрнБрм░рнБрм╖, рмкрнБрм░рнБрм╖ рмУрмармХрнБ рмЧрнЛрмЬрмЙрмЫрмирнНрмдрм┐
ЁЯЩОтАНтЩА => ЁЯЩОтАНтЩА, рмЕрмЩрнНрмЧрмнрмЩрнНрмЧрнА, рмУрма рмЧрнЛрмЬрм╛рмЗрммрм╛, рморм╣рм┐рм│рм╛, рморм╣рм┐рм│рм╛ рмУрма рмЧрнЛрмЬрмЙрмЫрмирнНрмдрм┐
ЁЯЩЕ => ЁЯЩЕ, рмЗрмЩрнНрмЧрм┐рмд, рмирм╛, рмкрнНрм░рмдрм┐рммрмирнНрмзрм┐рмд, рммрнНрнЯрмХрнНрмдрм┐ рмирм╛ рмЗрмЩрнНрмЧрм┐рмд рмХрм░рнБрмЫрмирнНрмдрм┐, рмнрм▓ рмЗрмЩрнНрмЧрм┐рмд рмирм╛рм╣рм┐рмБ, рмнрм▓ рмирм╛рм╣рм┐рмБ, рморнБрм╣рмБ
ЁЯЩЕтАНтЩВ => ЁЯЩЕтАНтЩВ, рмЕрмЩрнНрмЧрмнрмЩрнНрмЧрнА, рмирм╛, рмирм┐рм╖рм┐рмжрнНрмз, рмирм┐рм╖рнЗрмзрм┐рмд, рмкрнБрм░рнБрм╖, рмкрнБрм░рнБрм╖ рмирм╛ рмЗрмЩрнНрмЧрм┐рмд рмХрм░рнБрмЫрмирнНрмдрм┐, рм╣рм╛рмд
ЁЯЩЕтАНтЩА => ЁЯЩЕтАНтЩА, рмЕрмЩрнНрмЧрмнрмЩрнНрмЧрнА, рмирм╛, рмирм┐рм╖рм┐рмжрнНрмз, рмирм┐рм╖рнЗрмзрм┐рмд, рмирнБрм╣рнЗрмБ, рморм╣рм┐рм│рм╛, рморм╣рм┐рм│рм╛ рмирм╛ рмЗрмЩрнНрмЧрм┐рмд рмХрм░рнБрмЫрмирнНрмдрм┐, рм╣рм╛рмд
ЁЯЩЖ => ЁЯЩЖ, рмЗрмЩрнНрмЧрм┐рмд, рмУрмХрнЗ рмЗрмЩрнНрмЧрм┐рмд, рммрнНрнЯрмХрнНрмдрм┐ рмУрмХрнЗ рмЗрмЩрнНрмЧрм┐рмд рмХрм░рнБрмЫрмирнНрмдрм┐, рморнБрм╣рмБ, рм╕рммрнБ рмарм┐рмХрнН рмЕрмЫрм┐
ЁЯЩЖтАНтЩВ => ЁЯЩЖтАНтЩВ, рмЕрмЩрнНрмЧрмнрмЩрнНрмЧрнА, рмУрмХрнЗ, рмкрнБрм░рнБрм╖, рмкрнБрм░рнБрм╖ рмУрмХрнЗ рмЗрмЩрнНрмЧрм┐рмд рмХрм░рнБрмЫрмирнНрмдрм┐, рм╣рм╛рмд
ЁЯЩЖтАНтЩА => ЁЯЩЖтАНтЩА, рмЕрмЩрнНрмЧрмнрмЩрнНрмЧрнА, рмУрмХрнЗ, рморм╣рм┐рм│рм╛, рморм╣рм┐рм│рм╛ рмУрмХрнЗ рмЗрмЩрнНрмЧрм┐рмд рмХрм░рнБрмЫрмирнНрмдрм┐, рм╣рм╛рмд
ЁЯТБ => ЁЯТБ, рммрнНрнЯрмХрнНрмдрм┐ рм╣рм╛рмд рмЕрммрмирмд рмХрм░рнБрмЫрмирнНрмдрм┐, рм▓рнЛрмХрморм╛рмирнЗ, рм╕рм╣рм╛рнЯрмдрм╛, рм╕рнВрмЪрмирм╛, рм╕рнВрмЪрмирм╛ рмбрнЗрм╕рнНрмХ
ЁЯТБтАНтЩВ => ЁЯТБтАНтЩВ, рмЕрммрмирмд рм╣рнЛрмЗрмерм┐рммрм╛ рм╣рм╛рмд, рмкрнБрм░рнБрм╖, рмкрнБрм░рнБрм╖ рм╣рм╛рмд рмЕрммрмирмд рмХрм░рнБрмЫрмирнНрмдрм┐, рм╕рм╛рм╕рм┐
ЁЯТБтАНтЩА => ЁЯТБтАНтЩА, рмЕрммрмирмд рм╣рнЛрмЗрмерм┐рммрм╛ рм╣рм╛рмд, рморм╣рм┐рм│рм╛, рморм╣рм┐рм│рм╛ рм╣рм╛рмд рмЕрммрмирмд рмХрм░рнБрмЫрмирнНрмдрм┐, рм╕рм╛рм╕рм┐
ЁЯЩЛ => ЁЯЩЛ, рмЗрмЩрнНрмЧрм┐рмд, рмЙрмкрм░рмХрнБ рм╣рм╛рмд рмЙрмарм╛рмЗрмерм┐рммрм╛ рммрнНрнЯрмХрнНрмдрм┐, рмЦрнБрм╕рнА, рмЦрнБрм╕рнАрмерм┐рммрм╛ рммрнНрнЯрмХрнНрмдрм┐, рммрнНрнЯрмХрнНрмдрм┐, рммрнНрнЯрмХрнНрмдрм┐ рм╣рм╛рмд рмЙрмарм╛рмЙрмЫрмирнНрмдрм┐, рм╣рм╛рмд рмЙрмкрм░рмХрнБ рмЙрмарм╛рмЗрммрм╛
ЁЯЩЛтАНтЩВ => ЁЯЩЛтАНтЩВ, рмЕрмЩрнНрмЧрмнрмЩрнНрмЧрнА, рмЙрмарм┐рмерм┐рммрм╛ рм╣рм╛рмд, рмкрнБрм░рнБрм╖, рмкрнБрм░рнБрм╖ рм╣рм╛рмд рмЙрмарм╛рмЙрмЫрмирнНрмдрм┐
ЁЯЩЛтАНтЩА => ЁЯЩЛтАНтЩА, рмЕрмЩрнНрмЧрмнрмЩрнНрмЧрнА, рмЙрмарм┐рмерм┐рммрм╛ рм╣рм╛рмд, рморм╣рм┐рм│рм╛, рморм╣рм┐рм│рм╛ рм╣рм╛рмд рмЙрмарм╛рмЙрмЫрмирнНрмдрм┐
ЁЯЩЗ => ЁЯЩЗ, рмЕрмдрм┐ рморнБрмгрнНрмб рмирнБрмЖрмБрмЗрммрм╛, рмЗрмЩрнНрмЧрм┐рмд, рмжрнБрмГрмЦрм┐рмд, рммрнНрнЯрмХрнНрмдрм┐, рммрнНрнЯрмХрнНрмдрм┐ рморнБрмгрнНрмб рмирнБрмЖрмБрмЙрмЫрмирнНрмдрм┐, рморнБрмБ рмжрнБрмГрмЦрм┐рмд рмЕрмЯрнЗ, рморнБрмгрнНрмб рмирнБрмЖрмБрмЗрммрм╛
ЁЯЩЗтАНтЩВ => ЁЯЩЗтАНтЩВ, рмЕрмЩрнНрмЧрмнрмЩрнНрмЧрнА, рмЕрмирнБрмЧрнНрм░рм╣, рмХрнНрм╖рморм╛, рмжрнБрмГрмЦрм┐рмд, рмкрнБрм░рнБрм╖, рмкрнБрм░рнБрм╖ рморнБрмгрнНрмб рмирнБрмЖрмБрмЙрмЫрмирнНрмдрм┐, рморнБрмгрнНрмб рмирнБрмЖрмБрмЗрммрм╛
ЁЯЩЗтАНтЩА => ЁЯЩЗтАНтЩА, рмЕрмЩрнНрмЧрмнрмЩрнНрмЧрнА, рмЕрмирнБрмЧрнНрм░рм╣, рмХрнНрм╖рморм╛, рмжрнБрмГрмЦрм┐рмд, рморм╣рм┐рм│рм╛, рморм╣рм┐рм│рм╛ рморнБрмгрнНрмб рмирнБрмЖрмБрмЙрмЫрмирнНрмдрм┐, рморнБрмгрнНрмб рмирнБрмЖрмБрмЗрммрм╛
ЁЯдж => ЁЯдж, рмЕрммрм┐рм╢рнНрн▒рм╛рм╕, рммрм┐рм░рмХрнНрмдрм┐, рммрнНрнЯрмХрнНрмдрм┐ рморнБрм╣рмБрм░рнЗ рмкрм╛рмкрнБрм▓рм┐ рморм╛рм░рнБрмЫрмирнНрмдрм┐, рморм╣рм┐рм│рм╛, рморнБрм╣рмБрм░рнЗ рмкрм╛рмкрнБрм▓рм┐ рморм╛рм░рм┐рммрм╛
ЁЯджтАНтЩВ => ЁЯджтАНтЩВ, рмЕрммрм┐рм╢рнНрн▒рм╛рм╕, рмкрнБрм░рнБрм╖, рмкрнБрм░рнБрм╖ рморнБрм╣рмБрм░рнЗ рмкрм╛рмкрнБрм▓рм┐ рморм╛рм░рнБрмЫрмирнНрмдрм┐, рммрм┐рм░рмХрнНрмдрм┐, рморнБрм╣рмБрм░рнЗ рмкрм╛рмкрнБрм▓рм┐ рморм╛рм░рм┐рммрм╛
ЁЯджтАНтЩА => ЁЯджтАНтЩА, рмЕрммрм┐рм╢рнНрн▒рм╛рм╕, рммрм┐рм░рмХрнНрмдрм┐, рморм╣рм┐рм│рм╛, рморм╣рм┐рм│рм╛ рморнБрм╣рмБрм░рнЗ рмкрм╛рмкрнБрм▓рм┐ рморм╛рм░рнБрмЫрмирнНрмдрм┐, рморнБрм╣рмБрм░рнЗ рмкрм╛рмкрнБрм▓рм┐ рморм╛рм░рм┐рммрм╛
ЁЯд╖ => ЁЯд╖, рмЕрмЬрнНрмЮрмдрм╛, рмЖрмЧрнНрм░рм╣рм╢рнВрмирнНрнЯрмдрм╛, рмЙрмжрм╛рм╕рнАрмирмдрм╛ рм╕рнВрмЪрм╛рмЗ рмХрм╛рмирнНрмз рм╣рм▓рм╛рмЗрммрм╛, рммрнНрнЯрмХрнНрмдрм┐ рмЙрмжрм╛рм╕рнАрмирмдрм╛ рм╕рнВрмЪрм╛рмЗ рмХрм╛рмирнНрмз рм╣рм▓рм╛рмЙрмЫрмирнНрмдрм┐, рм╕рмирнНрмжрнЗрм╣
ЁЯд╖тАНтЩВ => ЁЯд╖тАНтЩВ, рмЕрмЬрнНрмЮрмдрм╛, рмЖрмЧрнНрм░рм╣рм╢рнВрмирнНрнЯрмдрм╛, рмЙрмжрм╛рм╕рнАрмирмдрм╛ рм╕рнВрмЪрм╛рмЗ рмХрм╛рмирнНрмз рм╣рм▓рм╛рмЗрммрм╛, рмкрнБрм░рнБрм╖, рмкрнБрм░рнБрм╖ рмЙрмжрм╛рм╕рнАрмирмдрм╛ рм╕рнВрмЪрм╛рмЗ рмХрм╛рмирнНрмз рм╣рм▓рм╛рмЙрмЫрмирнНрмдрм┐, рм╕рмирнНрмжрнЗрм╣
ЁЯд╖тАНтЩА => ЁЯд╖тАНтЩА, рмЕрмЬрнНрмЮрмдрм╛, рмЖрмЧрнНрм░рм╣рм╢рнВрмирнНрнЯрмдрм╛, рмЙрмжрм╛рм╕рнАрмирмдрм╛ рм╕рнВрмЪрм╛рмЗ рмХрм╛рмирнНрмз рм╣рм▓рм╛рмЗрммрм╛, рморм╣рм┐рм│рм╛, рморм╣рм┐рм│рм╛ рмЙрмжрм╛рм╕рнАрмирмдрм╛ рм╕рнВрмЪрм╛рмЗ рмХрм╛рмирнНрмз рм╣рм▓рм╛рмЙрмЫрмирнНрмдрм┐, рм╕рмирнНрмжрнЗрм╣
ЁЯТЖ => ЁЯТЖ, рммрнНрнЯрмХрнНрмдрм┐ рморм╛рм▓рм┐рм╕рнНтАМ рмкрнНрм░рм╛рмкрнНрмд рмХрм░рнБрмЫрмирнНрмдрм┐, рморнБрм╣рмБрм░ рморнНрнЯрм╛рм╕рнЗрмЬрнНтАМ, рморнНрнЯрм╛рм╕рнЗрмЬрнНтАМ, рм╕рнЗрм▓рнБрми
ЁЯТЖтАНтЩВ => ЁЯТЖтАНтЩВ, рмкрнБрм░рнБрм╖, рмкрнБрм░рнБрм╖ рморм╛рм▓рм┐рм╕рнНтАМ рмкрнНрм░рм╛рмкрнНрмд рмХрм░рнБрмЫрмирнНрмдрм┐, рморм╛рм▓рм┐рм╕рнНтАМ, рморнБрм╣рмБ
ЁЯТЖтАНтЩА => ЁЯТЖтАНтЩА, рморм╣рм┐рм│рм╛, рморм╣рм┐рм│рм╛ рморм╛рм▓рм┐рм╕рнНтАМ рмкрнНрм░рм╛рмкрнНрмд рмХрм░рнБрмЫрмирнНрмдрм┐, рморм╛рм▓рм┐рм╕рнНтАМ, рморнБрм╣рмБ
ЁЯТЗ => ЁЯТЗ, рмХрнЗрм╢ рмХрм╛рмЯрм┐рммрм╛, рмкрм╛рм░рнНрм▓рм░рнНтАМ, рммрм┐рнЯрнБрмЯрм┐ рмкрм╛рм░рнНрм▓рм░рнНтАМ, рммрнНрнЯрмХрнНрмдрм┐ рм╣рнЗрнЯрм╛рм░рмХрмЯрнНтАМ рмХрм░рм╛рмЙрмЫрмирнНрмдрм┐, рм╕рнМрмирнНрмжрм░рнНрмпрнНрнЯ
ЁЯТЗтАНтЩВ => ЁЯТЗтАНтЩВ, рмкрнБрм░рнБрм╖, рмкрнБрм░рнБрм╖ рм╣рнЗрнЯрм╛рм░рмХрмЯрнНтАМ рмХрм░рм╛рмЙрмЫрмирнНрмдрм┐, рм╣рнЗрнЯрм╛рм░рмХрмЯрнНтАМ
ЁЯТЗтАНтЩА => ЁЯТЗтАНтЩА, рморм╣рм┐рм│рм╛, рморм╣рм┐рм│рм╛ рм╣рнЗрнЯрм╛рм░рмХрмЯрнНтАМ рмХрм░рм╛рмЙрмЫрмирнНрмдрм┐, рм╣рнЗрнЯрм╛рм░рмХрмЯрнНтАМ
ЁЯЪ╢ => ЁЯЪ╢, рмЪрм╛рм▓рм┐, рммрнГрмжрнНрмзрм┐, рммрнНрнЯрмХрнНрмдрм┐ рмЪрм╛рм▓рнБрмЫрмирнНрмдрм┐, рморм╣рм┐рм│рм╛
ЁЯЪ╢тАНтЩВ => ЁЯЪ╢тАНтЩВ, рмЪрм╛рм▓рм┐, рмкрнБрм░рнБрм╖, рмкрнБрм░рнБрм╖ рмЪрм╛рм▓рнБрмЫрмирнНрмдрм┐, рммрнГрмжрнНрмзрм┐
ЁЯЪ╢тАНтЩА => ЁЯЪ╢тАНтЩА, рмЪрм╛рм▓рм┐, рммрнГрмжрнНрмзрм┐, рморм╣рм┐рм│рм╛, рморм╣рм┐рм│рм╛ рмЪрм╛рм▓рнБрмЫрмирнНрмдрм┐
ЁЯПГ => ЁЯПГ, рмжрнМрмбрм┐рммрм╛, рммрнНрнЯрмХрнНрмдрм┐ рмжрнМрмбрнБрмЫрмирнНрмдрм┐, рморм╛рм░рм╛рмерми
ЁЯПГтАНтЩВ => ЁЯПГтАНтЩВ, рмжрнМрмб, рмжрнМрмбрм┐рммрм╛, рмкрнБрм░рнБрм╖, рмкрнБрм░рнБрм╖ рмжрнМрмбрнБрмЫрмирнНрмдрм┐, рморм╛рм░рм╛рмерми
ЁЯПГтАНтЩА => ЁЯПГтАНтЩА, рмжрнМрмб, рмжрнМрмбрм┐рммрм╛, рморм╣рм┐рм│рм╛, рморм╣рм┐рм│рм╛ рмжрнМрмбрнБрмЫрмирнНрмдрм┐, рморм╛рм░рм╛рмерми
ЁЯТГ => ЁЯТГ, рмирм░рнНрмдрнНрмдрмХ/рмирм░рнНрмдрнНрмдрмХрнА, рмирнГрмдрнНрнЯ, рморм╣рм┐рм│рм╛ рмирм╛рмЪрнБрмЫрмирнНрмдрм┐, рм▓рнЛрмХрморм╛рмирнЗ
ЁЯХ║ => ЁЯХ║, рмирм╛рмЪрм┐рммрм╛ ред рмкрнБрм░рнБрм╖, рмкрнБрм░рнБрм╖ рмирм╛рмЪ рмХрм░рнБрмЫрмирнНрмдрм┐
ЁЯСп => ЁЯСп, рмЦрм░рм┐рмЖ рмХрм╛рми рмерм┐рммрм╛ рм▓рнЛрмХрморм╛рмирнЗ, рмЭрм┐рмЕ рмкрм┐рм▓рм╛, рмбрнЗрмЩрнНрмЧрм╛ рмЭрм┐рмЕ, рморм╣рм┐рм│рм╛, рм▓рморнНрммрм╛ рмХрм╛рми, рм▓рнЛрмХрморм╛рмирнЗ
ЁЯСптАНтЩВ => ЁЯСптАНтЩВ, рмЦрм░рм┐рмЖ рмХрм╛рми, рмЦрм░рм┐рмЖ рмХрм╛рми рмерм┐рммрм╛ рмкрнБрм░рнБрм╖рморм╛рмирнЗ, рмирм░рнНрмдрнНрмдрмХ, рмкрм╛рм░рнНрмЯрм┐ рмХрм░рм┐рммрм╛, рмкрнБрм░рнБрм╖рморм╛рмирнЗ
ЁЯСптАНтЩА => ЁЯСптАНтЩА, рмЦрм░рм┐рмЖ рмХрм╛рми, рмЦрм░рм┐рмЖ рмХрм╛рми рмерм┐рммрм╛ рморм╣рм┐рм│рм╛рморм╛рмирнЗ, рмирм░рнНрмдрнНрмдрмХрнА, рмкрм╛рм░рнНрмЯрм┐ рмХрм░рм┐рммрм╛
ЁЯзЦ => ЁЯзЦ, рммрм╛рморнНрмл рмнрм░рнНрмдрнНрмдрм┐ рмкрнНрм░рмХрнЛрм╖рнНрма, рммрнНрнЯрмХрнНрмдрм┐ рммрм╛рморнНрмл рммрм╛рм╣рм╛рм░рнБрмерм┐рммрм╛ рмкрнНрм░рмХрнЛрм╖рнНрмарм░рнЗ рмЕрмЫрмирнНрмдрм┐, рм╕рмЙрмирм╛
ЁЯзЦтАНтЩА => ЁЯзЦтАНтЩА, рммрм╛рморнНрмл рмнрм░рнНрмдрнНрмдрм┐ рмкрнНрм░рмХрнЛрм╖рнНрма, рморм╣рм┐рм│рм╛ рммрм╛рморнНрмл рммрм╛рм╣рм╛рм░рнБрмерм┐рммрм╛ рмкрнНрм░рмХрнЛрм╖рнНрмарм░рнЗ рмЕрмЫрмирнНрмдрм┐, рм╕рмЙрмирм╛
ЁЯзЦтАНтЩВ => ЁЯзЦтАНтЩВ, рмкрнБрм░рнБрм╖ рммрм╛рморнНрмл рммрм╛рм╣рм╛рм░рнБрмерм┐рммрм╛ рмкрнНрм░рмХрнЛрм╖рнНрмарм░рнЗ рмЕрмЫрмирнНрмдрм┐, рммрм╛рморнНрмл рмнрм░рнНрмдрнНрмдрм┐ рмкрнНрм░рмХрнЛрм╖рнНрма, рм╕рмЙрмирм╛
ЁЯзЧ => ЁЯзЧ, рмЖрм░рнЛрм╣рмгрмХрм╛рм░рнА, рммрнНрнЯрмХрнНрмдрм┐ рмЖрм░рнЛрм╣рмг рмХрм░рнБрмЫрмирнНрмдрм┐
ЁЯзЧтАНтЩА => ЁЯзЧтАНтЩА, рмЖрм░рнЛрм╣рмгрмХрм╛рм░рнА, рморм╣рм┐рм│рм╛ рмЖрм░рнЛрм╣рмг рмХрм░рнБрмЫрмирнНрмдрм┐
ЁЯзЧтАНтЩВ => ЁЯзЧтАНтЩВ, рмЖрм░рнЛрм╣рмгрмХрм╛рм░рнА, рмкрнБрм░рнБрм╖ рмЖрм░рнЛрм╣рмг рмХрм░рнБрмЫрмирнНрмдрм┐
ЁЯзШ => ЁЯзШ, рмзрнНрнЯрм╛рми, рммрнНрнЯрмХрнНрмдрм┐ рмкрмжрнНрморм╛рм╕рми рм╕рнНрмерм┐рмдрм┐рм░рнЗ рмЕрмЫрмирнНрмдрм┐, рмпрнЛрмЧ
ЁЯзШтАНтЩА => ЁЯзШтАНтЩА, рмзрнНрнЯрм╛рми, рморм╣рм┐рм│рм╛ рмкрмжрнНрморм╛рм╕рми рм╕рнНрмерм┐рмдрм┐рм░рнЗ рмЕрмЫрмирнНрмдрм┐, рмпрнЛрмЧ
ЁЯзШтАНтЩВ => ЁЯзШтАНтЩВ, рмзрнНрнЯрм╛рми, рмкрнБрм░рнБрм╖ рмкрмжрнНрморм╛рм╕рми рм╕рнНрмерм┐рмдрм┐рм░рнЗ рмЕрмЫрмирнНрмдрм┐, рмпрнЛрмЧ
ЁЯЫА => ЁЯЫА, рммрнНрнЯрмХрнНрмдрм┐ рмЧрм╛рмзрнЛрмЙрмЫрмирнНрмдрм┐, рм╕рнНрмирм╛рми
ЁЯЫМ => ЁЯЫМ, рммрнНрнЯрмХрнНрмдрм┐ рм╢рнЗрмпрм░рнЗ рмЕрмЫрмирнНрмдрм┐, рм╢рнЛрмЗрммрм╛, рм╣рнЛрмЯрнЗрм▓рнНтАМ
ЁЯХ┤ => ЁЯХ┤, рмкрнБрм░рнБрм╖, рммрнНрнЯрммрм╕рм╛рнЯ, рм╕рнБрмЯрнНтАМ, рм╕рнБрмЯрнНтАМрм░рнЗ рмерм┐рммрм╛ рмкрнБрм░рнБрм╖ рм╢рнВрмирнНрнЯрм░рнЗ рмнрм╛рм╕рнБрмЫрмирнНрмдрм┐
ЁЯЧг => ЁЯЧг, рмХрмерм╛рмХрнБрм╣рм╛, рмХрмерм╛рмХрнБрм╣рм╛ рморнБрмгрнНрмб, рмХрм╣рм┐рммрм╛, рмЫрм╛рнЯрм╛рморнВрм░рнНрмдрнНрмдрм┐, рморнБрмгрнНрмб, рморнБрм╣рмБ
ЁЯСд => ЁЯСд, рмЫрм╛рнЯрм╛рморнВрм░рнНрмдрнНрмдрм┐, рмЫрм╛рнЯрм╛рморнВрм░рнНрмдрнНрмдрм┐рм░рнЗ рмлрм╛рмЯ, рмЫрм╛рнЯрм╛рморнВрм░рнНрмдрнНрмдрм┐рм░рнЗ рморм╕рнНрмдрмХ рмарм╛рм░рнБ рммрмХрнНрм╖ рмкрм░рнНрмпрнНрнЯрмирнНрмд, рморм╕рнНрмдрмХ рмарм╛рм░рнБ рммрмХрнНрм╖ рмкрм░рнНрмпрнНрнЯрмирнНрмд рмЪрм┐рмдрнНрм░, рм▓рнЛрмХрморм╛рмирнЗ
ЁЯСе => ЁЯСе, рмЫрм╛рнЯрм╛рморнВрм░рнНрмдрнНрмдрм┐, рмЫрм╛рнЯрм╛рморнВрм░рнНрмдрнНрмдрм┐рм░рнЗ рмлрм╛рмЯрмЧрнБрмбрм┐рмХ, рмЫрм╛рнЯрм╛рморнВрм░рнНрмдрнНрмдрм┐рм░рнЗ рморм╕рнНрмдрмХ рмарм╛рм░рнБ рммрмХрнНрм╖ рмкрм░рнНрмпрнНрнЯрмирнНрмд, рморм╕рнНрмдрмХ рмарм╛рм░рнБ рммрмХрнНрм╖ рмкрм░рнНрмпрнНрнЯрмирнНрмд рмЪрм┐рмдрнНрм░, рм▓рнЛрмХрморм╛рмирнЗ
ЁЯд║ => ЁЯд║, рмЦрмгрнНрмбрм╛ рмЪрм│рми рмХрм░рнБрмерм┐рммрм╛ рммрнНрнЯрмХрнНрмдрм┐ ред рмЦрмгрнНрмбрм╛ рмЪрм╛рм│рми рмХрм░рм┐рммрм╛ ред рмЦрмгрнНрмбрм╛, рммрнНрнЯрмХрнНрмдрм┐ рмЦрмгрнНрмбрм╛ рмЪрм╛рм│рми рмХрм░рнБрмЫрмирнНрмдрм┐
ЁЯПЗ => ЁЯПЗ, рмХрнНрм░рнАрмбрм╛, рмШрнЛрмбрм╛, рмШрнЛрмбрм╛ рмжрнМрмб, рмЬрмХрм┐, рмжрнМрмб, рмжрнМрмб рмШрнЛрмбрм╛
тЫ╖ => тЫ╖, рм╕рнНрмХрм╛рнЯрм░рнНтАН, рм╕рнНрмХрм┐ ред рммрм░рмл
ЁЯПВ => ЁЯПВ, рмХрнНрм░рнАрмбрм╛, рммрм░рмл рммрм╛рм╕рм╕рнНрмерм╛рми, рммрм░рмлрм░рнЗ рммрм╕рммрм╛рм╕ рмХрм░рнБрмерм┐рммрм╛ рммрнНрнЯрмХрнНрмдрм┐, рммрм░рмлрм╛рммрнГрмд, рм╕рнНрмирнЛрммрнЛрм░рнНрмбрм░рнНтАН
ЁЯПМ => ЁЯПМ, рммрм▓рнНтАН ред рмЧрм▓рнНрмл, рммрнНрнЯрмХрнНрмдрм┐ рмЧрм▓рнНрмл рмЦрнЗрм│рнБрмЫрмирнНрмдрм┐
ЁЯПМтАНтЩВ => ЁЯПМтАНтЩВ, рмЧрм▓рнНрмл ред рмкрнБрм░рнБрм╖, рмкрнБрм░рнБрм╖ рмЧрм▓рнНрмл рмЦрнЗрм│рнБрмЫрмирнНрмдрм┐
ЁЯПМтАНтЩА => ЁЯПМтАНтЩА, рмЧрм▓рнНрмл ред рморм╣рм┐рм│рм╛, рморм╣рм┐рм│рм╛ рмЧрм▓рнНрмл рмЦрнЗрм│рнБрмЫрмирнНрмдрм┐
ЁЯПД => ЁЯПД, рммрнНрнЯрмХрнНрмдрм┐ рм╕рм░рнНрмлрм┐рмВ рмХрм░рнБрмЫрмирнНрмдрм┐, рм╕рм░рнНрмлрм┐рмВ
ЁЯПДтАНтЩВ => ЁЯПДтАНтЩВ, рмкрнБрм░рнБрм╖ ред рм╕рм░рнНрмлрм┐рмВ рмХрм░рнБрмЫрмирнНрмдрм┐, рмкрнБрм░рнБрм╖ рм╕рм░рнНрмлрм┐рмВ рмХрм░рнБрмЫрмирнНрмдрм┐
ЁЯПДтАНтЩА => ЁЯПДтАНтЩА, рморм╣рм┐рм│рм╛ рм╕рм░рнНрмлрм┐рмВ рмХрм░рнБрмЫрмирнНрмдрм┐, рм╕рм░рнНрмлрм┐рмВ ред рморм╣рм┐рм│рм╛
ЁЯЪг => ЁЯЪг, рммрм╛рм╣рм╛рми, рммрнЛрмЯрнН, рммрнНрнЯрмХрнНрмдрм┐ рмЖрм╣рнБрм▓рм╛ рморм╛рм░рм┐ рмирнМрмХрм╛ рмЪрм│рм╛рмЙрмЫрмирнНрмдрм┐, рм░рнЛрммрнЛрмЯрнН
ЁЯЪгтАНтЩВ => ЁЯЪгтАНтЩВ, рмирнМрмХрм╛ ред рмкрнБрм░рнБрм╖ ред рмХрм╛рмдрморм░рм╛ рмирнМрмХрм╛
ЁЯЪгтАНтЩА => ЁЯЪгтАНтЩА, рмирнМрмХрм╛ ред рмЖрм╣рнБрм▓рм╛ рморм░рм╛ рмирнМрмХрм╛ ред рморм╣рм┐рм│рм╛, рморм╣рм┐рм│рм╛ рмЖрм╣рнБрм▓рм╛ рморм╛рм░рм┐ рмирнМрмХрм╛ рмЪрм│рм╛рмЙрмЫрмирнНрмдрм┐
ЁЯПК => ЁЯПК, рмкрм╣рмБрм░рм┐рммрм╛, рммрнНрнЯрмХрнНрмдрм┐ рмкрм╣рмБрм░рнБрмЫрмирнНрмдрм┐
ЁЯПКтАНтЩВ => ЁЯПКтАНтЩВ, рмкрнБрм░рнБрм╖ ред рмкрм╣рмБрм░рм┐рммрм╛, рмкрнБрм░рнБрм╖ рмкрм╣рмБрм░рнБрмЫрмирнНрмдрм┐
ЁЯПКтАНтЩА => ЁЯПКтАНтЩА, рмкрм╣рмБрм░рм┐рммрм╛ ред рморм╣рм┐рм│рм╛, рморм╣рм┐рм│рм╛ рмкрм╣рмБрм░рнБрмЫрмирнНрмдрм┐
тЫ╣ => тЫ╣, рммрм▓рнН, рммрнНрнЯрмХрнНрмдрм┐ рммрм▓рнНтАМрмХрнБ рммрм╛рмЙрмирнНрм╕ рмХрм░рм╛рмЙрмЫрмирнНрмдрм┐
тЫ╣тАНтЩВ => тЫ╣тАНтЩВ, рмкрнБрм░рнБрм╖ рммрм▓рнНтАМрмХрнБ рммрм╛рмЙрмирнНрм╕ рмХрм░рм╛рмЙрмЫрмирнНрмдрм┐, рммрм▓рнНтАМ ред рмкрнБрм░рнБрм╖
тЫ╣тАНтЩА => тЫ╣тАНтЩА, рммрм▓рнНтАМ рморм╣рм┐рм│рм╛, рморм╣рм┐рм│рм╛ рммрм▓рнНтАМрмХрнБ рммрм╛рмЙрмирнНрм╕ рмХрм░рм╛рмЙрмЫрмирнНрмдрм┐
ЁЯПЛ => ЁЯПЛ, рмЙрмдрнНрмдрнЛрм│рмирмХрм╛рм░рнА ред рмУрмЬрми ред рмЙрмдрнНрмдрнЛрм│рмирмХрм╛рм░рнА, рммрнНрнЯрмХрнНрмдрм┐ рмнрм╛рм░ рмЙрмарм╛рмЙрмЫрмирнНрмдрм┐
ЁЯПЛтАНтЩВ => ЁЯПЛтАНтЩВ, рмкрнБрм░рнБрм╖, рмкрнБрм░рнБрм╖ рмнрм╛рм░ рмЙрмарм╛рмЙрмЫрмирнНрмдрм┐, рмнрм╛рм░рнЛрмдрнНрмдрм│рмирмХрм╛рм░рнА
ЁЯПЛтАНтЩА => ЁЯПЛтАНтЩА, рмнрм╛рм░рнЛрмдрнНрмдрм│рмирмХрм╛рм░рнА, рморм╣рм┐рм│рм╛, рморм╣рм┐рм│рм╛ рмнрм╛рм░ рмЙрмарм╛рмЙрмЫрмирнНрмдрм┐
ЁЯЪ┤ => ЁЯЪ┤, рммрм╛рмЗрмХрнН, рммрнНрнЯрмХрнНрмдрм┐ рммрм╛рмЗрмХрнНтАМ рмЪрм│рм╛рмЙрмЫрмирнНрмдрм┐, рм╕рм╛рмЗрмХрнЗрм▓рнН рмЪрм╛рм│рмХ
ЁЯЪ┤тАНтЩВ => ЁЯЪ┤тАНтЩВ, рмкрнБрм░рнБрм╖, рмкрнБрм░рнБрм╖ рммрм╛рмЗрмХрнНтАМ рмЪрм│рм╛рмЙрмЫрмирнНрмдрм┐, рммрм╛рмЗрмХрнНтАМ рмЪрм│рм╛рмЗрммрм╛, рммрм╛рмЗрм╕рм╛рмЗрмХрнЗрм▓рнНтАМ, рм╕рм╛рмЗрмХрнЗрм▓рнНтАМ рмЪрм╛рм│рмХ
ЁЯЪ┤тАНтЩА => ЁЯЪ┤тАНтЩА, рммрм╛рмЗрмХрнНтАМ рмЪрм│рм╛рмЗрммрм╛, рммрм╛рмЗрм╕рм╛рмЗрмХрнЗрм▓рнНтАМ, рморм╣рм┐рм│рм╛, рморм╣рм┐рм│рм╛ рммрм╛рмЗрмХрнНтАМ рмЪрм│рм╛рмЙрмЫрмирнНрмдрм┐, рм╕рм╛рмЗрмХрнЗрм▓рнНтАМ рмЪрм╛рм│рмХ
ЁЯЪ╡ => ЁЯЪ╡, рмкрм░рнНрммрмд, рмкрнБрм░рнБрм╖, рммрм╛рмЗрмХрнНтАМ, рммрм╛рмЗрм╕рм╛рмЗрмХрнЗрм▓рнНтАМ, рммрнНрнЯрмХрнНрмдрм┐ рмкрм░рнНрммрмдрм░рнЗ рммрм╛рмЗрмХрнНтАМ рмЪрм│рм╛рмЙрмЫрмирнНрмдрм┐, рм╕рм╛рмЗрмХрнЗрм▓рнНтАМ рмЪрм╛рм│рмХ
ЁЯЪ╡тАНтЩВ => ЁЯЪ╡тАНтЩВ, рмкрм░рнНрммрмд, рмкрнБрм░рнБрм╖, рмкрнБрм░рнБрм╖ рмкрм░рнНрммрмдрм░рнЗ рммрм╛рмЗрмХрнНтАМ рмЪрм│рм╛рмЙрмЫрмирнНрмдрм┐, рммрм╛рмЗрмХрнНтАМ, рммрм╛рмЗрм╕рм╛рмЗрмХрнЗрм▓рнНтАМ, рм╕рм╛рмЗрмХрнЗрм▓рнНтАМ рмЪрм╛рм│рмХ
ЁЯЪ╡тАНтЩА => ЁЯЪ╡тАНтЩА, рммрм╛рмЗрмХрнНтАМ рмЪрм│рм╛рмЗрммрм╛, рммрм╛рмЗрм╕рм╛рмЗрмХрнЗрм▓рнНтАМ, рморм╣рм┐рм│рм╛, рморм╣рм┐рм│рм╛ рмкрм░рнНрммрмдрм░рнЗ рммрм╛рмЗрмХрнНтАМ рмЪрм▓рм╛рмЙрмЫрмирнНрмдрм┐, рм╕рм╛рмЗрмХрнЗрм▓рнНтАМ рмЪрм╛рм│рмХ
ЁЯПО => ЁЯПО, рмХрм╛рм░рнНтАМ, рм░рнЗрм╕рм┐рмВ, рм░рнЗрм╕рм┐рмВ рмХрм╛рм░рнНтАМ
ЁЯПН => ЁЯПН, рмормЯрм░рмЧрм╛рмбрм┐, рм░рнЗрм╕рм┐рмВ
ЁЯд╕ => ЁЯд╕, рмХрм╛рм░рнНрмЯрм╣рнБрмЗрм▓рнНтАМ, рмЬрм┐рморнНрмирм╛рм╖рнНрмЯрм┐рмХрнНрм╕, рммрнНрнЯрмХрнНрмдрм┐ рмХрм╛рм░рнНрмЯрм╣рнБрмЗрм▓рнНтАМ рмХрм░рнБрмЫрмирнНрмдрм┐
ЁЯд╕тАНтЩВ => ЁЯд╕тАНтЩВ, рмХрм╛рм░рнНрмЯрм╣рнБрмЗрм▓рнНтАМ, рмЬрм┐рморнНрмирм╛рм╖рнНрмЯрм┐рмХрнНрм╕, рмкрнБрм░рнБрм╖, рмкрнБрм░рнБрм╖ рмХрм╛рм░рнНрмЯрм╣рнБрмЗрм▓рнНтАМ рмХрм░рнБрмЫрмирнНрмдрм┐
ЁЯд╕тАНтЩА => ЁЯд╕тАНтЩА, рмХрм╛рм░рнНрмЯрм╣рнБрмЗрм▓рнНтАМ, рмЬрм┐рморнНрмирм╛рм╖рнНрмЯрм┐рмХрнНрм╕, рморм╣рм┐рм│рм╛, рморм╣рм┐рм│рм╛ рмХрм╛рм░рнНрмЯрм╣рнБрмЗрм▓рнНтАМ рмХрм░рнБрмЫрмирнНрмдрм┐
ЁЯд╝ => ЁЯд╝, рмХрнБрм╕рнНрмдрм┐ рм▓рмврм┐рммрм╛, рморм╣рм┐рм│рм╛, рм▓рнЛрмХрморм╛рмирнЗ рмХрнБрм╕рнНрмдрм┐ рм▓рмврнБрмЫрмирнНрмдрм┐
ЁЯд╝тАНтЩВ => ЁЯд╝тАНтЩВ, рмХрнБрм╕рнНрмдрм┐ рм▓рмврм┐рммрм╛, рмкрнБрм░рнБрм╖, рмкрнНрм░рнБрм░рнБрм╖рморм╛рмирнЗ рмХрнБрм╕рнНрмдрм┐ рм▓рмврнБрмЫрмирнНрмдрм┐
ЁЯд╝тАНтЩА => ЁЯд╝тАНтЩА, рмХрнБрм╕рнНрмдрм┐ рм▓рмврм┐рммрм╛, рморм╣рм┐рм│рм╛, рморм╣рм┐рм│рм╛рморм╛рмирнЗ рмХрнБрм╕рнНрмдрм┐ рм▓рмврнБрмЫрмирнНрмдрм┐
ЁЯд╜ => ЁЯд╜, рмЬрм│, рмкрнЛрм▓рнЛ, рммрнНрнЯрмХрнНрмдрм┐ рн▒рм╛рмЯрм░ рмкрнЛрм▓рнЛ рмЦрнЗрм│рнБрмЫрмирнНрмдрм┐
ЁЯд╜тАНтЩВ => ЁЯд╜тАНтЩВ, рмкрнБрм░рнБрм╖, рмкрнБрм░рнБрм╖ рн▒рм╛рмЯрм░ рмкрнЛрм▓рнЛ рмЦрнЗрм│рнБрмЫрмирнНрмдрм┐, рн▒рм╛рмЯрм░ рмкрнЛрм▓рнЛ
ЁЯд╜тАНтЩА => ЁЯд╜тАНтЩА, рморм╣рм┐рм│рм╛, рморм╣рм┐рм│рм╛ рн▒рм╛рмЯрм░ рмкрнЛрм▓рнЛ рмЦрнЗрм│рнБрмЫрмирнНрмдрм┐, рн▒рм╛рмЯрм░ рмкрнЛрм▓рнЛ
ЁЯд╛ => ЁЯд╛, рммрнНрнЯрмХрнНрмдрм┐ рм╣рнНрнЯрм╛рмгрнНрмбрммрм▓рнНтАМ рмЦрнЗрм│рнБрмЫрмирнНрмдрм┐, рморм╣рм┐рм│рм╛, рм╣рнНрнЯрм╛рмгрнНрмбрммрм▓рнНтАМ
ЁЯд╛тАНтЩВ => ЁЯд╛тАНтЩВ, рмкрнБрм░рнБрм╖, рмкрнБрм░рнБрм╖ рм╣рнНрнЯрм╛рмгрнНрмбрммрм▓рнНтАМ рмЦрнЗрм│рнБрмЫрмирнНрмдрм┐, рм╣рнНрнЯрм╛рмгрнНрмбрммрм▓рнНтАМ
ЁЯд╛тАНтЩА => ЁЯд╛тАНтЩА, рмирнМрмХрм╛ ред рмЖрм╣рнБрм▓рм╛ рморм░рм╛ рмирнМрмХрм╛ ред рморм╣рм┐рм│рм╛, рморм╣рм┐рм│рм╛, рм╣рнНрнЯрм╛рмгрнНрмбрммрм▓рнНтАМ
ЁЯд╣ => ЁЯд╣, рмПрмХрм╛рмзрм┐рмХ рмХрм╛рмо, рмжрмХрнНрм╖рмдрм╛, рммрнНрнЯрмХрнНрмдрм┐ рм╣рм╕рнНрмдрмХрнМрм╢рм│ рмжрнЗрмЦрм╛рмЙрмЫрмирнНрмдрм┐, рмнрм╛рм░рм╕рм╛рморнНрнЯ, рм╣рм╕рнНрмдрмХрнМрм╢рм│
ЁЯд╣тАНтЩВ => ЁЯд╣тАНтЩВ, рмПрмХрм╛рмзрм┐рмХ рмХрм╛рмо, рмкрнБрм░рнБрм╖, рмкрнБрм░рнБрм╖ рм╣рм╕рнНрмдрмХрнМрм╢рм│ рмжрнЗрмЦрм╛рмЙрмЫрмирнНрмдрм┐, рм╣рм╕рнНрмдрмХрнМрм╢рм│ рмХрм░рм┐рммрм╛
ЁЯд╣тАНтЩА => ЁЯд╣тАНтЩА, рмПрмХрм╛рмзрм┐рмХ рмХрм╛рмо, рморм╣рм┐рм│рм╛, рморм╣рм┐рм│рм╛ рм╣рм╕рнНрмдрмХрнМрм╢рм│ рмжрнЗрмЦрм╛рмЙрмЫрмирнНрмдрм┐, рм╣рм╕рнНрмдрмХрнМрм╢рм│ рмХрм░рм┐рммрм╛
ЁЯСл => ЁЯСл, рмжрморнНрмкрмдрм┐, рмкрнБрм░рнБрм╖, рмкрнБрм░рнБрм╖ рмУ рморм╣рм┐рм│рм╛, рморм╣рм┐рм│рм╛, рм▓рнЛрмХрморм╛рмирнЗ, рм╣рм╛рмд рмзрм░рм╛ рмзрм░рм┐ рм╣рнЛрмЗрмерм┐рммрм╛ рмкрнБрм░рнБрм╖ рмУ рморм╣рм┐рм│рм╛, рм╣рм╛рмд рмзрм░рм╛рмзрм░рм┐ рм╣рнЛрмЗрмерм┐рммрм╛ рмкрнБрм░рнБрм╖ рмПрммрмВ рморм╣рм┐рм│рм╛, рм╣рм╛рмд рмзрм░рм┐рмерм┐рммрм╛
ЁЯСм => ЁЯСм, рмжрморнНрмкрмдрм┐, рмжрнБрмЗ рмЬрмг рмкрнБрм░рнБрм╖, рмжрнБрмЗ рмЬрмг рмкрнБрм░рнБрм╖ рм╣рм╛рмд рмзрм░рм╛рмзрм░рм┐ рм╣рнЛрмЗрмЫрмирнНрмдрм┐, рмкрнБрм░рнБрм╖, рм▓рнЛрмХрморм╛рмирнЗ, рм╣рм╛рмд рмзрм░рм╛рмзрм░рм┐ рм╣рнЗрммрм╛, рм╣рм╛рмд рмзрм░рм╛рмзрм░рм┐ рм╣рнЛрмЗрмерм┐рммрм╛ рмжрнБрмЗ рмЬрмг рмкрнБрм░рнБрм╖
ЁЯСн => ЁЯСн, рмжрморнНрмкрмдрм┐, рмжрнБрмЗ рмЬрмг рморм╣рм┐рм│рм╛, рмжрнБрмЗ рмЬрмг рморм╣рм┐рм│рм╛ рм╣рм╛рмд рмзрм░рм╛рмзрм░рм┐ рм╣рнЛрмЗрмЫрмирнНрмдрм┐, рморм╣рм┐рм│рм╛, рм▓рнЛрмХрморм╛рмирнЗ, рм╣рм╛рмд рмзрм░рм╛рмзрм░рм┐ рм╣рнЗрммрм╛, рм╣рм╛рмд рмзрм░рм╛рмзрм░рм┐ рм╣рнЛрмЗрмерм┐рммрм╛ рмжрнБрмЗ рмЬрмг рморм╣рм┐рм│рм╛
ЁЯТП => ЁЯТП, рмЪрнБрморнНрммрми, рмЪрнБрморнНрммрми рмжрнЗрммрм╛, рмкрнНрм░рмгрнЯ, рм▓рнЛрмХрморм╛рмирнЗ
ЁЯТС => ЁЯТС, рмПрмХ рм╣рнГрмжрнЯ рмЪрм┐рмдрнНрм░ рм╕рм╣рм┐рмд рмкрнНрм░рнЗрморнА рмпрнБрмЧрм│, рмкрнНрм░рмгрнЯ, рмкрнНрм░рнЗрморнА рмпрнБрмЧрм│, рм▓рнЛрмХрморм╛рмирнЗ, рм╣рнГрмжрнЯ, рм╣рнГрмжрнЯ рм╕рм╣рм┐рмд рмкрнНрм░рнЗрморнА рмпрнБрмЧрм│
ЁЯСк => ЁЯСк, рмкрм░рм┐рммрм╛рм░
ЁЯд│ => ЁЯд│, рмХрнНрнЯрм╛рморнЗрм░рм╛, рмлрнЛрмирнНтАМ, рм╕рнЗрм▓рмлрм┐
ЁЯТк => ЁЯТк, рмХрморм┐рмХрнН, рмжрнГрмв, рмлрнНрм▓рнЗрмХрнНрм╕, рмлрнНрм▓рнЗрмХрнНрм╕рмбрнНтАМ рммрм╛рмЗрм╕рнЗрмкрнНрм╕, рммрм╛рмЗрм╕рнЗрмкрнН, рморм╛рмВрм╕рмкрнЗрм╕рнА, рморм╛рмВрм╕рмкрнЗрм╕рнА рмлрнНрм▓рнЗрмХрнНрм╕
ЁЯСИ => ЁЯСИ, рмЖрмЩрнНрмЧрнБрмарм┐, рмЖрмЩрнНрмЧрнБрмарм┐ рмирм┐рм░рнНрмжрнНрмжрнЗрм╢ рммрм╛рмормХрнБ, рммрм╛рмо рмЖрмЩрнНрмЧрнБрмарм┐, рммрм╛рмормХрнБ рм╕рнВрмЪрм╛рмЙрмерм┐рммрм╛ рм╣рм╛рмдрм░ рмкрмЫ рмкрмЯ рммрм┐рм╢рм┐ рмЖрмЩрнНрмЧрнБрмарм┐, рммрм┐рм╢рм┐ рмЖрмЩрнНрмЧрнБрмарм┐, рммрнНрнЯрм╛рмХрм╣рм╛рмгрнНрмб
ЁЯСЙ => ЁЯСЙ, рмЖрмЩрнНрмЧрнБрмарм┐, рмЖрмЩрнНрмЧрнБрмарм┐ рмирм┐рм░рнНрмжрнНрмжрнЗрм╢ рмбрм╛рм╣рм╛рмгрмХрнБ, рмбрм╛рм╣рм╛рмг рмЖрмЩрнНрмЧрнБрмарм┐, рмбрм╛рм╣рм╛рмгрмХрнБ рм╕рнВрмЪрм╛рмЙрмерм┐рммрм╛ рм╣рм╛рмдрм░ рмкрмЫ рмкрмЯ рммрм┐рм╢рм┐ рмЖрмЩрнНрмЧрнБрмарм┐, рммрм┐рм╢рм┐ рмЖрмЩрнНрмЧрнБрмарм┐, рммрнНрнЯрм╛рмХрм╣рм╛рмгрнНрмб
тШЭ => тШЭ, рмЖрмЩрнНрмЧрнБрмарнА, рмЗрмгрнНрмбрнЗрмХрнНрм╕, рмЙрмкрм░, рмЙрмкрм░ рмЖрмбрмХрнБ рм╕рнВрмЪрм╛рмЙрмерм┐рммрм╛ рммрм┐рм╢рм┐ рмЖрмЩрнНрмЧрнБрмарм┐, рмкрмПрмгрнНрмЯрнН, рм╣рм╛рмд
ЁЯСЖ => ЁЯСЖ, рмЖрмЩрнНрмЧрнБрмарм┐, рмЖрмЩрнНрмЧрнБрмарм┐ рмирм┐рм░рнНрмжрнНрмжрнЗрм╢ рмЙрмкрм░рмХрнБ, рмЙрмкрм░ рмЖрмбрмХрнБ рм╕рнВрмЪрм╛рмЙрмерм┐рммрм╛ рм╣рм╛рмдрм░ рмкрмЫ рмкрмЯ рммрм┐рм╢рм┐ рмЖрмЩрнНрмЧрнБрмарм┐, рмЙрмкрм░рмХрнБ рмЧрнЛрмЯрм┐рмП рмЖрмЩрнНрмЧрнБрмарм┐ рмХрм░рм┐рммрм╛, рммрм┐рм╢рм┐ рмЖрмЩрнНрмЧрнБрмарм┐, рммрнНрнЯрм╛рмХрм╣рм╛рмгрнНрмб
ЁЯЦХ => ЁЯЦХ, рмЖрмЩрнНрмЧрнБрмарм┐, рмормЭрм┐ рмЖрмЩрнНрмЧрнБрмарм┐, рм╣рм╛рмд
ЁЯСЗ => ЁЯСЗ, рмЖрмЩрнНрмЧрнБрмарм┐, рмЖрмЩрнНрмЧрнБрмарм┐ рмирм┐рм░рнНрмжрнНрмжрнЗрм╢ рмдрм│рмХрнБ, рмдрм│рмХрнБ рмЧрнЛрмЯрм┐рмП рмЖрмЩрнНрмЧрнБрмарм┐ рмХрм░рм┐рммрм╛, рмдрм│рмХрнБ рм╕рнВрмЪрм╛рмЙрмерм┐рммрм╛ рм╣рм╛рмдрм░ рмкрмЫ рмкрмЯ рммрм┐рм╢рм┐ рмЖрмЩрнНрмЧрнБрмарм┐, рммрм┐рм╢рм┐ рмЖрмЩрнНрмЧрнБрмарм┐, рммрнНрнЯрм╛рмХрм╣рм╛рмгрнНрмб
тЬМ => тЬМ, рмХрмБрмЗрмЪрм┐, рмЬрнЯрм▓рм╛рмн рм╕рнВрмЪрм╛рмЙрмерм┐рммрм╛ рм╣рм╛рмд, рмЬрм┐рмдрм┐рммрм╛, рмЬрм┐рмдрм┐рммрм╛ рм╣рм╛рмд, рм╣рмБ
ЁЯдЮ => ЁЯдЮ, рмЫрмХрм┐ ред рмЖрмЩрнНрмЧрнБрмарм┐ ред рм╣рм╛рмд ред рмнрм╛рмЧрнНрнЯ, рмЫрмХрм┐рмпрнБрмХрнНрмд рмЖрмЩрнНрмЧрнБрмарм┐рмЧрнБрмбрм┐рмХ
ЁЯЦЦ => ЁЯЦЦ, рмЖрмЩрнНрмЧрнБрмарм┐, рмнрм▓рмХрм╛рмирнНтАМ, рмнрм▓рмХрм╛рмирнНтАМ рм╕рм╛рм▓рнНрнЯрнБрмЯрнНтАМ, рм╕рнНрмкрмХрнНтАМ, рм╣рм╛рмд
ЁЯдШ => ЁЯдШ, рмЖрмЩрнНрмЧрнБрмарм┐, рм░рмХрнНтАМ-рмЕрмирнНтАМ, рм╢рм┐рмЩрнНрмЧ рмЪрм┐рм╣рнНрми, рм╕рм┐рмЩрнНрмЧ, рм╣рм╛рмд
ЁЯдЩ => ЁЯдЩ, рмХрм▓рнНтАМ, рмХрм▓рнНтАМ рморм┐ рм╣рнНрнЯрм╛рмгрнНрмб, рм╣рм╛рмд
ЁЯЦР => ЁЯЦР, рмЖрмЩрнНрмЧрнБрмарм┐, рмЖрмЩрнНрмЧрнБрмарм┐ рмлрм░рнНрмЪрм╛ рмпрм╛рмЗрмерм┐рммрм╛ рм╣рм╛рмд, рмлрм░рнНрмЪрм╛рмЗрммрм╛, рм╣рм╛рмд
тЬЛ => тЬЛ, рмЙрмарм╛ рмпрм╛рмЗрмерм┐рммрм╛ рм╣рм╛рмд, рм╣рм╛рмд
ЁЯСМ => ЁЯСМ, OK, OK рм╣рм╛рмд рмЪрм┐рм╣рнНрми, рм╣рм╛рмд
ЁЯСН => ЁЯСН, рмЙрмкрм░, рммрнБрмврм╛ рмЖрмЩрнНрмЧрнБрмарм┐, рм╕рмлрм│ рм╣рнЗрммрм╛ рмЪрм┐рм╣рнНрми
ЁЯСО => ЁЯСО, рмЕрм╕рмлрм│рмдрм╛ рмЪрм┐рм╣рнНрми, рмдрм│, рммрнБрмврм╛ рмЖрмЩрнНрмЧрнБрмарм┐
тЬК => тЬК, рмЙрмарм╛ рмпрм╛рмЗрмерм┐рммрм╛ рморнБрмарм╛, рмкрнНрм░рмерморнЗ рмЙрмарм╛рмЗрммрм╛, рм░рмХрнН
ЁЯСК => ЁЯСК, рмЯрм╛рмг рморнБрмарм╛, рморнБрмарм╛, рм╕рморнНрморнБрмЦрм░рнБ рмЖрм╕рнБрмерм┐рммрм╛ рморнБрмарм╛, рм╣рм╛рмд
ЁЯдЫ => ЁЯдЫ, рммрм╛рмо рмЖрмбрмХрнБ, рммрм╛рмо-рмЖрмбрмХрнБ рморнБрм╣рмБ рмХрм░рм┐рмерм┐рммрм╛ рморнБрмарм╛, рморнБрмарм╛
ЁЯдЬ => ЁЯдЬ, рмбрм╛рм╣рм╛рмг рмЖрмбрмХрнБ, рмбрм╛рм╣рм╛рмг-рмЖрмбрмХрнБ рморнБрм╣рмБ рмХрм░рм┐рмерм┐рммрм╛ рморнБрмарм╛, рморнБрмарм╛
ЁЯдЪ => ЁЯдЪ, рмЙрмарм╛ рмпрм╛рмЗрмерм┐рммрм╛ рм╣рм╛рмд рмкрмЫ, рмЙрмарм╛рмпрм╛рмЗрмЫрм┐, рм╣рм╛рмдрм░ рмкрмЫ рмнрм╛рмЧ
ЁЯСЛ => ЁЯСЛ, рмжрнЛрм│рм╛рнЯрморм╛рми рм╣рм╛рмд, рм╣рм▓рм╛рмЗрммрм╛, рм╣рм╛рмд, рм╣рм╛рмд рм╣рм▓рм╛рмЗрммрм╛
ЁЯдЯ => ЁЯдЯ, ILY, рмдрнБрмормХрнБ рмнрм▓рмкрм╛рмП рмЗрмЩрнНрмЧрм┐рмд, рм╣рм╛рмд
тЬН => тЬН, рм▓рнЗрмЦрм┐рммрм╛, рм▓рнЗрмЦрм┐рммрм╛ рм╣рм╛рмд, рм╣рм╛рмд
ЁЯСП => ЁЯСП, рмЪрм┐рм╣рнНрми, рмдрм╛рм│рм┐ рморм╛рм░рм┐рммрм╛, рмдрм╛рм│рм┐ рморм╛рм░рнБрмерм┐рммрм╛ рм╣рм╛рмдрмЧрнБрмбрм┐рмХ, рм╣рм╛рмд, рм╣рм╛рмдрм░рнЗ рмдрм╛рм│рм┐ рморм╛рм░рм┐рммрм╛
ЁЯСР => ЁЯСР, рмЦрнЛрм▓рм╛ рм╣рм╛рмд, рмЦрнЛрм▓рм╛ рм╣рм╛рмд рмЪрм┐рм╣рнНрми, рмЦрнЛрм▓рм╛ рм╣рм╛рмдрмЧрнБрмбрм┐рмХ, рмЦрнЛрм▓рм┐рммрм╛, рмЪрм┐рм╣рнНрми, рм╣рм╛рмд
ЁЯЩМ => ЁЯЩМ, рмЙрмарм┐рмерм┐рммрм╛ рм╣рм╛рмдрмЧрнБрмбрм┐рмХ, рмЙрмнрнЯ рм╣рм╛рмд, рмЦрнБрм╕рнА, рмЦрнБрм╕рнАрм░рнЗ рмЙрмнрнЯ рм╣рм╛рмд рмЙрмкрм░рмХрнБ рмЙрмарм╛рмЗрммрм╛, рм╣рнБрм░рнЗ
ЁЯд▓ => ЁЯд▓, рмкрм╛рмкрнБрм▓рм┐ рмПрмХрмдрнНрм░ рмЙрмкрм░рмХрнБ рмХрм░рм┐рммрм╛, рмкрнНрм░рм╛рм░рнНрмермирм╛
ЁЯЩП => ЁЯЩП, рмЗрмЩрнНрмЧрм┐рмд, рмкрнНрм░рм╛рм░рнНрмермирм╛, рмкрнНрм░рм╛рм░рнНрмермирм╛ рмХрм░рм┐рммрм╛, рмпрнЛрмб рм╣рм╕рнНрмд, рм╣рм╛рмд, рм╣рм╛рмд рмпрнЛрмбрм┐рммрм╛
ЁЯдЭ => ЁЯдЭ, рмХрм░рморм░рнНрмжрнНрмжрми, рм╕рм╣рмормд, рм╕рм╛рмХрнНрм╖рм╛рмд, рм╣рм▓рм╛рмЗрммрм╛, рм╣рм╛рмд
ЁЯТЕ => ЁЯТЕ, рмирмЦ, рмирмЦ рмкрм╛рм▓рм┐рм╕, рмирмЦ рмкрм╛рм▓рм┐рм╕рнНтАМ, рмирмЦ рмпрмдрнНрми, рмкрнНрм░рм╕рм╛рмзрми рм╕рм╛рмормЧрнНрм░рнА, рморм╛рмирм┐рмХрнНрнЯрнБрм░рнНтАМ
ЁЯСВ => ЁЯСВ, рмХрм╛рми, рм╢рм░рнАрм░
ЁЯСГ => ЁЯСГ, рмирм╛рмХ, рморнБрм╣рмБ, рм╢рм░рнАрм░
ЁЯСг => ЁЯСг, рмЪрм┐рм╣рнНрми, рмкрм╛рмж, рмкрм╛рмжрмЪрм┐рм╣рнНрми, рмкрм╛рмжрмЪрм┐рм╣рнНрмирмЧрнБрмбрм┐рмХ, рм╢рм░рнАрм░
ЁЯСА => ЁЯСА, рмЖрмЦрм┐, рмЖрмЦрм┐рмЧрнБрмбрм┐рмХ, рморнБрм╣рмБ
ЁЯСБ => ЁЯСБ, рмЖрмЦрм┐, рм╢рм░рнАрм░
ЁЯСБтАНЁЯЧи => ЁЯСБтАНЁЯЧи, рмЖрмЦрм┐, рмХрмерми рмлрнЛрмЯрмХрм╛ рммрм╛ рм╕рнНрмкрм┐рмЪрнНтАМ рммрммрнБрм▓рнНтАМ, рмХрмерми рмлрнЛрмЯрмХрм╛рм░рнЗ рмЖрмЦрм┐, рм╕рм╛рмХрнНрм╖рнА
ЁЯза => ЁЯза, рммрнБрмжрнНрмзрм┐рморм╛рми, рморм╕рнНрмдрм┐рм╖рнНрмХ
ЁЯСЕ => ЁЯСЕ, рмЬрм┐рмн, рм╢рм░рнАрм░
ЁЯСД => ЁЯСД, рмУрма, рмкрм╛рмЯрм┐
ЁЯТЛ => ЁЯТЛ, рмЪрнБрморнНрммрми ред рмУрма, рмЪрнБрморнНрммрми рмЪрм┐рм╣рнНрми
ЁЯТШ => ЁЯТШ, рмдрнАрм░, рмдрнАрм░ рм╕рм╣рм┐рмд рм╣рнГрмжрнЯ, рмкрнНрм░рнЗрмо, рмнрм╛рммрмирм╛, рм╣рнГрмжрнЯ, рм╣рнГрмжрнЯ рмПрммрмВ рмдрнАрм░
тЭд => тЭд, рм▓рм╛рм▓рнНтАМ рм╣рнГрмжрнЯ, рм╣рнГрмжрнЯ
ЁЯТУ => ЁЯТУ, рмкрнНрм░рнЗрмо, рмнрм╛рммрмирм╛, рм╕рнНрмкрмирнНрмжрми, рм╕рнНрмкрмирнНрмжрми рм╣рнЗрмЙрмерм┐рммрм╛ рм╣рнГрмжрнЯ, рм╕рнНрмкрмирнНрмжрм┐рмд рм╣рнГрмжрнЯ, рм╣рнГрмжрнЯ
ЁЯТФ => ЁЯТФ, рмнрмЧрнНрми, рмнрмЧрнНрми рм╣рнГрмжрнЯ, рмнрм╛рмЩрнНрмЧрм┐рммрм╛, рмнрм╛рммрмирм╛, рм╣рнГрмжрнЯ, рм╣рнГрмжрнЯ рмнрм╛рмЩрнНрмЧрм┐рмпрм┐рммрм╛
ЁЯТХ => ЁЯТХ, рмжрнБрмЗрмЯрм┐ рм╣рнГрмжрнЯ, рмкрнНрм░рнЗрмо, рмкрнНрм░рнЗрморнА, рмнрм╛рммрмирм╛
ЁЯТЦ => ЁЯТЦ, рмЪрмормХрнБрмерм┐рммрм╛ рм╣рнГрмжрнЯ, рмЪрмормдрнНрмХрм╛рм░, рмЭрмЯрмХрнБрмерм┐рммрм╛ рм╣рнГрмжрнЯ, рмкрнНрм░рнЗрмо, рмнрм╛рммрмирм╛, рм░рнЛрморм╛рмЮрнНрмЪрм┐рмд
ЁЯТЧ => ЁЯТЧ, рмкрнНрм░рнЗрмо, рммрмврнБрмерм┐рммрм╛ рм╣рнГрмжрнЯ, рммрм░рнНрмжрнНрмзрм┐рмд рм╣рнГрмжрнЯ, рмнрм╛рммрмирм╛, рм░рнЛрморм╛рмЮрнНрмЪрм┐рмд, рм╢рмЩрнНрмХрм╛рмЧрнНрм░рм╕рнНрмд, рм╣рнГрмжрнЯ
ЁЯТЩ => ЁЯТЩ, рмирнАрм│, рмирнАрм│ рм╣рнГрмжрнЯ
ЁЯТЪ => ЁЯТЪ, рм╕рммрнБрмЬ, рм╕рммрнБрмЬ рм╣рнГрмжрнЯ
ЁЯТЫ => ЁЯТЫ, рм╣рм│рмжрм┐рмЖ, рм╣рм│рмжрм┐рмЖ рм╣рнГрмжрнЯ
ЁЯзб => ЁЯзб, рмХрморм│рм╛, рмХрморм│рм╛ рм╣рнГрмжрнЯ
ЁЯТЬ => ЁЯТЬ, рммрм╛рмЗрмЧрмгрнА, рммрм╛рмЗрмЧрмгрнА рм╣рнГрмжрнЯ
ЁЯЦд => ЁЯЦд, рмХрм│рм╛, рмХрм│рм╛ рм╣рнГрмжрнЯ, рмжрнБрм╖рнНрмЯ, рмормирнНрмж
ЁЯТЭ => ЁЯТЭ, рмнрм╛рммрмирм╛, рмнрм╛рм▓рнЗрмгрнНрмЯрм╛рмЗрмирнНтАМ, рм░рм┐рммрмирнНтАМ, рм░рм┐рммрмирнНтАМ рмпрнБрмХрнНрмд рм╣рнГрмжрнЯ, рм░рм┐рммрмирнНтАМ рм╕рм╣рм┐рмд рм╣рнГрмжрнЯ, рм╣рнГрмжрнЯ
ЁЯТЮ => ЁЯТЮ, рмЕрмдрм┐ рм╕рнБрмирнНрмжрм░, рмЖрмжрм░рмгрнАрнЯ, рмХрммрм╛рм▓рм┐, рмШрнВрм░рнБрмерм┐рммрм╛ рм╣рнГрмжрнЯрмЧрнБрмбрм┐рмХ, рмШрнВрм░рнНрмгрнНрмгрнЯрморм╛рми, рмШрнВрм░рнНрмгрнНрмгрнЯрморм╛рми рм╣рнГрмжрнЯ, рмкрнНрм░рнЗрмо, рмнрм╛рммрмирм╛, рм╣рнГрмжрнЯ
ЁЯТЯ => ЁЯТЯ, рм╣рнГрмжрнЯ, рм╣рнГрмжрнЯ рм╕рм╛рмЬрм╕рмЬрнНрмЬрм╛
тЭг => тЭг, рмЪрм┐рм╣рнНрми, рммрм┐рм░рм╛рмормЪрм┐рм╣рнНрми, рммрм┐рм╕рнНрморнЯрм╕рнВрмЪрмХ, рмнрм╛рм░рнА рм╣рнГрмжрнЯ рммрм┐рм╕рнНрморнЯрм╕рнВрмЪрмХ рмЪрм┐рм╣рнНрми
ЁЯТМ => ЁЯТМ, рмПрмХ рм╣рнГрмжрнЯ рмЪрм┐рмдрнНрм░ рмерм╛рмЗ рморнЗрм▓рнНтАМ, рмЪрм┐рмарм┐, рмкрнНрм░рмгрнЯ, рмкрнНрм░рнЗрмо рмкрмдрнНрм░, рм╣рнГрмжрнЯ
ЁЯТд => ЁЯТд, zzz, рм╣рм╛рм╕рнНрнЯрнЛрмжрнНрмжрнАрмкрмХ ред рм╢рнЯрми
ЁЯТв => ЁЯТв, рмХрнНрм░рнЛрмз, рмХрнНрм░рнЛрмз рмЪрм┐рм╣рнНрми, рмХрнНрм░рнЛрмз рм╕рмЩрнНрмХрнЗрмд, рмХрнНрм░рнЛрмзрнА, рмнрм╛рммрмирм╛, рм╣рм╛рм╕рнНрнЯрнЛрмжрнНрмжрнАрмкрмХ
ЁЯТг => ЁЯТг, рммрнЛрморм╛, рм╣рм╛рм╕рнНрнЯрнЛрмжрнНрмжрнАрмкрмХ
ЁЯТе => ЁЯТе, рмзрмХрнНрмХрм╛, рммрнБрморнНтАМ ред рм╣рм╛рм╕рнНрнЯрнЛрмжрнНрмжрнАрмкрмХ
ЁЯТж => ЁЯТж, рмХрморм┐рмХрнН, рмЭрм╛рм│, рмЭрм╛рм│ рмЯрнЛрмкрм╛, рмЭрм╛рм│ рммрнБрмирнНрмжрм╛рмЧрнБрмбрм┐рмХ, рмЭрм╛рм│ рммрнЛрм╣рм┐рммрм╛, рмнрм╛рммрмирм╛
ЁЯТи => ЁЯТи, рмХрморм┐рмХрнН, рмЦрнБрммрнН рмЬрнЛрм░рм░рнЗ рмжрнМрмбрм┐рммрм╛, рмжрнМрмбрм┐ рмкрм│рм╛рмЗрммрм╛, рмжрнМрмбрм┐рммрм╛, рмкрм╛рмбрм┐рммрм╛, рмнрм╛рммрмирм╛
ЁЯТл => ЁЯТл, рмХрморм┐рмХрнН, рмЪрмкрм│, рмдрм╛рм░рм╛, рмдрм╛рм░рм╛ рмжрнЗрмЦрм┐рммрм╛, рммрм┐рмЪрм│рм┐рмд, рмнрм╛рммрмирм╛
ЁЯТм => ЁЯТм, рмХрмерми рммрнЗрм▓рнБрмирнН, рмХрморм┐рмХрнН, рмХрм╣рм┐рммрм╛ рммрммрм▓рнН, рмХрм╣рм┐рммрм╛ рммрнЗрм▓рнБрмирнН, рммрммрм▓рнН, рммрнЗрм▓рнБрмирнН, рм╕рмВрм│рм╛рмк, рм╕рмВрм│рм╛рмк рммрнЗрм▓рнБрмирнН
ЁЯЧи => ЁЯЧи, рмХрмерми, рммрм╛рмо рмХрмерми рмлрнЛрмЯрмХрм╛, рм╕рмВрм│рм╛рмк
ЁЯЧп => ЁЯЧп, рмХрнЛрмз, рмбрм╛рм╣рм╛рмг рмХрнНрм░рнЛрмз рмлрнЛрмЯрмХрм╛, рмкрм╛рмЧрм│, рмлрнЛрмЯрмХрм╛, рммрнЗрм▓рнБрмирнНтАМ
ЁЯТн => ЁЯТн, рмХрморм┐рмХрнН, рмкрнНрм░рмЧрм╛рмв рмЪрм┐рмирнНрмдрм╛ рммрнЗрм▓рнБрмирнНтАМ, рммрммрм▓рнН, рмнрм╛рммрмирм╛, рмнрм╛рммрмирм╛ рммрммрм▓рнН, рмнрм╛рммрмирм╛ рммрнЗрм▓рнБрмирнН
ЁЯХ│ => ЁЯХ│, рмЧрм╛рмд
ЁЯСУ => ЁЯСУ, рмЖрмЗрмЧрнНрм▓рм╛рм╕рнНтАМ, рмЪрм╖рморм╛, рмЪрм╖рморм╛рмЧрнБрмбрм┐рмХ, рмкрнЛрм╖рм╛рмХ рмкрм░рм┐рмЪрнНрмЫрмж
ЁЯХ╢ => ЁЯХ╢, рмЖрмЗрн▒рнЗрнЯрм╛рм░рнНтАМ, рмЖрмЦрм┐, рмЧрм╛рмв, рмЪрм╖рморм╛рмЧрнБрмбрм┐рмХ, рм╕рмирмЧрнНрм▓рм╛рм╕рнНтАМрмЧрнБрмбрм┐рмХ
ЁЯСФ => ЁЯСФ, рмирнЗрмХрмЯрм╛рмП, рмкрнЛрм╖рм╛рмХ рмкрм░рм┐рмЪрнНрмЫрмж
ЁЯСХ => ЁЯСХ, рмЯрм┐-рм╕рм╛рм░рнНрмЯрнНтАМ, рмкрнЛрм╖рм╛рмХ рмкрм░рм┐рмЪрнНрмЫрмж, рм╕рм╛рм░рнНрмЯрнНтАМ
ЁЯСЦ => ЁЯСЦ, рмЬрм┐рмирнНрм╕, рмЯрнНрм░рм╛рмЙрмЬрм░рнНтАМ, рмкрнЛрм╖рм╛рмХ рмкрм░рм┐рмЪрнНрмЫрмж, рмкрнНрнЯрм╛рмгрнНрмЯ
ЁЯзг => ЁЯзг, рммрнЗрмХ, рм╕рнНрмХрм╛рм░рнНрмлрнНтАМ
ЁЯзд => ЁЯзд, рмЧрнНрм▓рнЛрмнрнНрм╕, рм╣рм╛рмд
ЁЯзе => ЁЯзе, рмХрнЛрмЯрнНтАМ, рмЬрнНрнЯрм╛рмХрнЗрмЯрнНтАМ
ЁЯзж => ЁЯзж, рморнЛрмЬрм╛, рм╖рнНрмЯрмХрм┐рмВ
ЁЯСЧ => ЁЯСЧ, рмкрнЛрм╖рм╛рмХ, рмкрнЛрм╖рм╛рмХ рмкрм░рм┐рмЪрнНрмЫрмж
ЁЯСШ => ЁЯСШ, рмХрм┐рморнЛрмирнЛ, рмкрнЛрм╖рм╛рмХ рмкрм░рм┐рмЪрнНрмЫрмж
ЁЯСЩ => ЁЯСЩ, рмкрнЛрм╖рм╛рмХ рмкрм░рм┐рмЪрнНрмЫрмж ред рмкрм╣рмБрм░рм┐рммрм╛, рммрм┐рмХрм┐рмирм┐
ЁЯСЪ => ЁЯСЪ, рмкрнЛрм╖рм╛рмХ рмкрм░рм┐рмЪрнНрмЫрмж ред рморм╣рм┐рм│рм╛, рморм╣рм┐рм│рм╛рмЩрнНрмХ рмкрнЛрм╖рм╛рмХрмкрмдрнНрм░
ЁЯСЫ => ЁЯСЫ, рмХрмПрмирнНтАМ рмкрм░рнНрм╕рнН, рмкрм░рнНрм╕рнНтАМ, рмкрнЛрм╖рм╛рмХ рмкрм░рм┐рмЪрнНрмЫрмж, рморнБрмжрнНрм░рм╛
ЁЯСЬ => ЁЯСЬ, рмкрнЛрм╖рм╛рмХ рмкрм░рм┐рмЪрнНрмЫрмж, рммрнНрнЯрм╛рмЧрнН, рм╣рнНрнЯрм╛рмгрнНрмбрммрнНрнЯрм╛рмЧрнНтАМ
ЁЯСЭ => ЁЯСЭ, рмХрнНрм▓рмЪрнНтАМ рммрнНрнЯрм╛рмЧрнНтАМ, рмЫрнЛрмЯ рмерм│рм┐, рмкрнЛрм╖рм╛рмХ рмкрм░рм┐рмЪрнНрмЫрмж, рммрнНрнЯрм╛рмЧрнНтАМ
ЁЯЫН => ЁЯЫН, рммрнНрнЯрм╛рмЧрнНтАМ ред рм╣рнЛрмЯрнЗрм▓рнНтАМ ред рм╢рмкрм┐рмВ, рм╢рмкрм┐рмВ рммрнНрнЯрм╛рмЧрнНтАМрмЧрнБрмбрм┐рмХ
ЁЯОТ => ЁЯОТ, рммрм╕рнНрмдрм╛рмирм┐, рммрм┐рмжрнНрнЯрм╛рм│рнЯ, рммрм┐рмжрнНрнЯрм╛рм│рнЯ рммрм╕рнНрмдрм╛рмирм┐, рм╕рнНрмХрнБрм▓рнНтАМ рммрнНрнЯрм╛рмХрмкрнНрнЯрм╛рмХрнНтАМ, рм╕рнНрмХрнБрм▓рнНтАМ рммрнНрнЯрм╛рмЧрнНтАМ
ЁЯСЮ => ЁЯСЮ, рмЬрнЛрмдрм╛, рмкрнБрм░рнБрм╖рмЩрнНрмХ рмЬрнЛрмдрм╛, рмкрнЛрм╖рм╛рмХ рмкрм░рм┐рмЪрнНрмЫрмж
ЁЯСЯ => ЁЯСЯ, рмЬрнЛрмдрм╛, рмжрнМрмбрмХрнБрмж рм╕рморнНрммрмирнНрмзрм┐рмд рмЬрнЛрмдрм╛, рмжрнМрмбрм┐рммрм╛ рмЬрнЛрмдрм╛, рмирм░рмо рмдрм│ рмерм┐рммрм╛ рмЬрнЛрмдрм╛, рмкрнЛрм╖рм╛рмХ рмкрм░рм┐рмЪрнНрмЫрмж
ЁЯСа => ЁЯСа, рмЙрмЪрнНрмЪ-рмЧрнЛрмЗрмарм┐рмпрнБрмХрнНрмд рмЬрнЛрмдрм╛, рмЬрнЛрмдрм╛, рмкрнЛрм╖рм╛рмХ рмкрм░рм┐рмЪрнНрмЫрмж, рм╣рм╛рмЗ-рм╣рм┐рм▓рнН
ЁЯСб => ЁЯСб, рмЪрмкрм▓, рмкрнЛрм╖рм╛рмХ рмкрм░рм┐рмЪрнНрмЫрмж, рморм╣рм┐рм│рм╛, рморм╣рм┐рм│рм╛рмЩрнНрмХ рмЪрмкрм▓
ЁЯСв => ЁЯСв, рмкрнЛрм╖рм╛рмХ рмкрм░рм┐рмЪрнНрмЫрмж, рммрнБрмЯрнНтАМ, рморм╣рм┐рм│рм╛, рморм╣рм┐рм│рм╛рмЩрнНрмХ рмЬрнЛрмдрм╛, рморм╣рм┐рм│рм╛рмЩрнНрмХ рммрнБрмЯрнНтАМ
ЁЯСС => ЁЯСС, рмкрнЛрм╖рм╛рмХ рмкрм░рм┐рмЪрнНрмЫрмж, рморнБрмХрнБрмЯ
ЁЯСТ => ЁЯСТ, рмЯрнЛрмкрм┐, рмкрнЛрм╖рм╛рмХ рмкрм░рм┐рмЪрнНрмЫрмж, рморм╣рм┐рм│рм╛рмЩрнНрмХ рмЯрнЛрмкрм┐
ЁЯОй => ЁЯОй, рмЯрнЛрмкрм┐, рмормирнЛрм░рмЮрнНрмЬрми, рм▓рморнНрммрм╛ рмЯрнЛрмкрм┐
ЁЯОУ => ЁЯОУ, рмЙрмдрнНрм╕рмм, рмЯрнЛрмкрм┐, рм╕рнНрмирм╛рмдрмХ, рм╕рнНрмирм╛рмдрмХ рмЯрнЛрмкрм┐
ЁЯзв => ЁЯзв, рммрм┐рм▓рмбрнНтАМ рмЯрнЛрмкрм┐, рммрнЗрм╕рммрм▓рнНтАМ рмЯрнЛрмкрм┐
тЫС => тЫС, рмЙрмжрнНрмзрм╛рм░ рмХрм░рнНрморнАрмЩрнНрмХ рм╣рнЗрм▓рморнЗрмЯрнНтАМ, рмЫрмХрм┐ рмЪрм┐рм╣рнНрми, рмЯрнЛрмкрм┐, рморнБрм╣рмБ, рм╕рм╣рм╛рнЯрмХ рмкрмжрм╛рм░рнНрме, рм╣рнЗрм▓рморнЗрмЯрнНтАМ
ЁЯУ┐ => ЁЯУ┐, рмзрм░рнНрмо, рмкрнВрмЬрм╛ рморнЛрмдрм┐рморм╛рм│, рмкрнНрм░рм╛рм░рнНрмермирм╛, рморнЛрмдрм┐рморм╛рм│, рм▓рнБрмЧрм╛рмкрмЯрм╛, рм╣рм╛рм░
ЁЯТД => ЁЯТД, рмкрнНрм░рм╕рм╛рмзрми рм╕рм╛рмормЧрнНрм░рнА, рморнЗрмХрмЕрмкрнН, рм▓рм┐рмкрм╖рнНрмЯрм┐рмХрнНтАМ
ЁЯТН => ЁЯТН, рмкрнНрм░рмгрнЯ, рморнБрмжрм┐, рморнБрмжрнНрм░рм┐рмХрм╛
ЁЯТО => ЁЯТО, рмормгрм┐ рмкрмерм░, рм╣рнАрм░рм╛ ред рмормгрм┐ ред рммрм╣рнБрморнВрм▓рнНрнЯ рмкрмерм░
ЁЯР╡ => ЁЯР╡, рморм╛рмЩрнНрмХрмб, рморм╛рмЩрнНрмХрмб рморнБрм╣рмБ, рморнБрм╣рмБ
ЁЯРТ => ЁЯРТ, рморм╛рмЩрнНрмХрмб
ЁЯжН => ЁЯжН, рмЧрм░рм┐рм▓рм╛
ЁЯР╢ => ЁЯР╢, рмХрнБрмХрнБрм░, рмХрнБрмХрнБрм░ рморнБрм╣рмБ, рмкрнЛрм╖рм╛рмЬрмирнНрмдрнБ, рморнБрм╣рмБ
ЁЯРХ => ЁЯРХ, рмХрнБрмХрнБрм░, рмкрнЛрм╖рм╛рмЬрмирнНрмдрнБ
ЁЯРй => ЁЯРй, рмХрнБрмХрнБрм░, рм▓рнЛрморм╢ рмХрнБрмХрнБрм░
ЁЯР║ => ЁЯР║, рмЧрмзрм┐рмЖ, рмЧрмзрм┐рмЖ рморнБрм╣рмБ, рмЬрнАрмм, рморнБрм╣рмБ
ЁЯжК => ЁЯжК, рмХрнЛрмХрм┐рм╢рм┐рмЖрм│рм┐ рморнБрм╣рмБ, рморнБрм╣рмБ ред рмХрнЛрмХрм┐рм╢рм┐рмЖрм│рм┐
ЁЯР▒ => ЁЯР▒, рмЬрнАрмм, рммрм┐рм░рм╛рмбрм┐ рморнБрм╣рмБ, рммрм┐рм▓рнЗрмЗ, рммрм┐рм▓рнЗрмЗ рморнБрм╣рмБ, рморнБрм╣рмБ
ЁЯРИ => ЁЯРИ, рмкрм╢рнБ, рммрм┐рм░рм╛рмбрм┐, рммрм┐рм▓рнЗрмЗ
ЁЯжБ => ЁЯжБ, рморнБрм╣рмБ ред рм╕рм┐рмВрм╣ рм░рм╛рм╢рм┐ ред рм╕рм┐рмВрм╣ ред рм░рм╛рм╢рм┐рмЪрмХрнНрм░, рм╕рм┐рмВрм╣ рморнБрм╣рмБ
ЁЯРп => ЁЯРп, рмЬрнАрмм, рммрм╛рмШ, рммрм╛рмШ рморнБрм╣рмБ
ЁЯРЕ => ЁЯРЕ, рммрм╛рмШ
ЁЯРЖ => ЁЯРЖ, рмЪрм┐рмдрм╛рммрм╛рмШ
ЁЯР┤ => ЁЯР┤, рмШрнЛрмбрм╛, рмШрнЛрмбрм╛ рморнБрм╣рмБ, рмЬрнАрмм, рморнБрм╣рмБ
ЁЯРО => ЁЯРО, рмШрнЛрмбрм╛, рмкрм╢рнБ
ЁЯжД => ЁЯжД, рморнБрм╣рмБ ред рнЯрнБрмирм┐рмХрм░рнНрмгрнНрмг, рнЯрнБрмирм┐рмХрм░рнНрмгрнНрмг рморнБрм╣рмБ
ЁЯжУ => ЁЯжУ, рмЬрнЗрммрнНрм░рм╛, рмкрмЯрм╛ рмкрмЯрм╛ рмжрм╛рмЧ
ЁЯжМ => ЁЯжМ, рм╣рм░рм┐рмг
ЁЯРо => ЁЯРо, рмЧрм╛рмЗ, рмЧрм╛рмЗ рморнБрм╣рмБ, рморнБрм╣рмБ
ЁЯРВ => ЁЯРВ, рмкрм╢рнБ, рммрм│рмж
ЁЯРГ => ЁЯРГ, рмЬрм│, рмЬрм│ рмормЗрмБрм╖рм┐, рмормЗрмБрм╖рм┐
ЁЯРД => ЁЯРД, рмЧрм╛рмЗ
ЁЯР╖ => ЁЯР╖, рмШрнБрм╖рнБрм░рм┐, рмШрнБрм╖рнБрм░рм┐ рморнБрм╣рмБ, рморнБрм╣рмБ
ЁЯРЦ => ЁЯРЦ, рмШрнБрм╖рнБрм░рм┐, рмкрм╢рнБ
ЁЯРЧ => ЁЯРЧ, рмШрнБрм╖рнБрм░рм┐, рммрм╛рм░рм╛рм╣рм╛
ЁЯР╜ => ЁЯР╜, рмШрнБрм╖рнБрм░рм┐, рмШрнБрм╖рнБрм░рм┐ рмирм╛рмХ, рмЬрнАрмм, рморнБрм╣рмБ
ЁЯРП => ЁЯРП, рмЦрм╛рм╕рнБ рм╣рнЛрмЗрмирмерм┐рммрм╛ рморнЗрмгрнНрмврм╛, рмкрм╢рнБ
ЁЯРС => ЁЯРС, рморнЗрмгрнНрмврм╛ ред рморм╛рмЗ, рморнЗрмгрнНрмврнА
ЁЯРР => ЁЯРР, рмЫрнЗрм│рм┐, рмормХрм░, рм░рм╛рм╢рм┐рмЪрмХрнНрм░
ЁЯРк => ЁЯРк, рмПрмХ рмХрнБрмЬ рммрм┐рм╢рм┐рм╖рнНрмЯ рмЖрм░рммрнАрнЯ рмУрмЯ, рмПрмХ рмХрнБрмЬ рммрм┐рм╢рм┐рм╖рнНрмЯ рмУрмЯ, рмУрмЯ, рмХрнБрмЬ, рмкрм╢рнБ
ЁЯРл => ЁЯРл, рмУрмЯ, рмХрнБрмЬ, рмжрнБрмЗ рмХрнБрмЬ рммрм┐рм╢рм┐рм╖рнНрмЯ рмЖрм░рммрнАрнЯ рмУрмЯ, рмжрнБрмЗ рмХрнБрмЬ рммрм┐рм╢рм┐рм╖рнНрмЯ рмУрмЯ, рмжрнБрмЗ-рмХрнБрмЬ рммрм┐рм╢рм┐рм╖рнНрмЯ рмУрмЯ, рмкрм╢рнБ
ЁЯжТ => ЁЯжТ, рмЬрм┐рм░рм╛рмл, рмжрм╛рмЧрмЧрнБрмбрм┐рмХ
ЁЯРШ => ЁЯРШ, рм╣рм╛рмдрнА
ЁЯжП => ЁЯжП, рмЧрмгрнНрмбрм╛
ЁЯРн => ЁЯРн, рмЬрнАрмм, рморнБрм╣рмБ, рморнВрм╖рм╛, рморнВрм╖рм╛ рморнБрм╣рмБ
ЁЯРБ => ЁЯРБ, рморнВрм╖рм╛
ЁЯРА => ЁЯРА, рммрмб рморнВрм╖рм╛
ЁЯР╣ => ЁЯР╣, рмЬрнАрмм, рморнБрм╣рмБ, рм╣рм╛рморм╖рнНрмЯрм░рнНтАМ, рм╣рм╛рморм╖рнНрмЯрм░рнНтАМ рморнБрм╣рмБ
ЁЯР░ => ЁЯР░, рмЬрнАрмм, рмарнЗрмХрнБрмЖ, рмарнЗрмХрнБрмЖ рморнБрм╣рмБ, рморнБрм╣рмБ
ЁЯРЗ => ЁЯРЗ, рмЦрм░рм┐рмЖ, рмарнЗрмХрнБрмЖ, рмкрм╢рнБ
ЁЯР┐ => ЁЯР┐, рмЪрм┐рмкрморнБрмЩрнНрмХ
ЁЯжФ => ЁЯжФ, рмХрмгрнНрмЯрмХрморнЯ, рмЭрм┐рмЩрнНрмХ
ЁЯжЗ => ЁЯжЗ, рммрм╛рмжрнБрмбрм┐, рммрм╛рмжрнБрмбрм┐ ред рмкрм┐рм╢рм╛рмЪ
ЁЯР╗ => ЁЯР╗, рмнрм╛рм▓рнБ, рмнрм╛рм▓рнБ рморнБрм╣рмБ, рморнБрм╣рмБ
ЁЯРи => ЁЯРи, рмХрнЛрмЖрм▓рм╛, рмнрм╛рм▓рнБ
ЁЯР╝ => ЁЯР╝, рмЬрнАрмм, рмкрм╛рмгрнНрмбрм╛, рмкрм╛рмгрнНрмбрм╛ рморнБрм╣рмБ, рморнБрм╣рмБ
ЁЯР╛ => ЁЯР╛, рмЪрм┐рм╣рнНрми, рмЬрнАрмм, рмкрмВрмЭрм╛ рмЪрм┐рм╣рнНрмирмЧрнБрмбрм┐рмХ, рмкрмЮрнНрмЬрм╛, рмкрмЮрнНрмЬрм╛ рмЪрм┐рм╣рнНрми
ЁЯжГ => ЁЯжГ, рмдрнБрм░рнНрмХрнА, рмдрнБрм░рнНрмХрнА ред рмкрмХрнНрм╖рнА
ЁЯРФ => ЁЯРФ, рмХрнБрмХрнБрмбрм╛, рмкрм╢рнБ
ЁЯРУ => ЁЯРУ, рмЧрнГрм╣рмкрм╛рм│рм┐рмд рмЧрмЮрнНрмЬрм╛, рмкрм╢рнБ
ЁЯРг => ЁЯРг, рмЕрмгрнНрмбрм╛ рмлрнБрмЯрм╛рмЗрммрм╛ рмХрм╛рм░рнНрмпрнНрнЯ, рмЕрмгрнНрмбрм╛ рмлрнБрмЯрм╛рмЙрмерм┐рммрм╛ рмХрнБрмХрнБрмбрм╛, рмЕрмгрнНрмбрм╛рм░рнБ рммрм╛рм╣рм╛рм░рм┐рмерм┐рммрм╛ рмерм┐рммрм╛ рмХрнБрмХрнБрмбрм╛ рмЫрнБрмЖ, рмХрнБрмХрнБрмбрм╛, рмХрнБрмХрнБрмбрм╛ рмЫрнБрмЖ, рмЫрнЛрмЯ рмХрнБрмХрнБрмбрм╛ рмЫрнБрмЖ, рмЬрнАрмм, рм╢рм┐рм╢рнБ
ЁЯРд => ЁЯРд, рмХрнБрмХрнБрмбрм╛, рмХрнБрмХрнБрмбрм╛ рмЫрнБрмЖ, рмЫрнЛрмЯ рмХрнБрмХрнБрмбрм╛ рмЫрнБрмЖ, рмЫрнЛрмЯ рм╢рм┐рм╢рнБ рмХрнБрмХрнБрмбрм╛, рмЬрнАрмм, рм╢рм┐рм╢рнБ
ЁЯРе => ЁЯРе, рмЖрмЧрмХрнБ-рморнБрм╣рмБ рмХрм░рм┐рмерм┐рммрм╛ рмХрнБрмХрнБрмбрм╛ рмЫрнБрмЖ, рмХрнБрмХрнБрмбрм╛, рмХрнБрмХрнБрмбрм╛ рмЫрнБрмЖ, рмЫрнЛрмЯ рмХрнБрмХрнБрмбрм╛ рмЫрнБрмЖ, рмЬрнАрмм, рморнБрм╣рмБ рммрм╛рм╣рм╛рм░рмХрнБ рммрм╛рм╣рм░ рмХрм░рм┐рмерм┐рммрм╛ рмЫрнЛрмЯ рмХрнБрмХрнБрмбрм╛ рмЫрнБрмЖ, рм╢рм┐рм╢рнБ
ЁЯРж => ЁЯРж, рмкрмХрнНрм╖рнА
ЁЯРз => ЁЯРз, рмЬрнАрмм, рмкрнЗрмЩрнНрмЧрнБрмЗрмирнНтАН
ЁЯХК => ЁЯХК, рмХрмкрнЛрмд, рмкрмХрнНрм╖рнА ред рмЙрмбрм┐рммрм╛ ред рм╢рм╛рмирнНрмдрм┐
ЁЯжЕ => ЁЯжЕ, рмЗрмЧрм▓рнНтАН, рмЗрмЧрм▓рнНтАН ред рмкрмХрнНрм╖рнА
ЁЯжЖ => ЁЯжЖ, рммрмдрмХ, рммрмдрмХ ред рмкрмХрнНрм╖рнА
ЁЯжЙ => ЁЯжЙ, рмкрнЗрмЪрм╛, рмкрнЗрмЪрм╛ ред рмЬрнНрмЮрм╛рмирнА ред рмкрмХрнНрм╖рнА
ЁЯР╕ => ЁЯР╕, рммрнЗрмЩрнНрмЧ, рммрнЗрмЩрнНрмЧ рморнБрм╣рмБ, рморнБрм╣рмБ
ЁЯРК => ЁЯРК, рмХрнБрморнНрмнрнАрм░
ЁЯРв => ЁЯРв, рмХрмЗрмБрмЫ, рмХрмЪрнНрмЫрмк, рмЯрнЗрм░рм╛рмкрм┐рмирнН
ЁЯжО => ЁЯжО, рмЭрм┐рмЯрм┐рмкрм┐рмЯрм┐, рмЭрм┐рмЯрм┐рмкрм┐рмЯрм┐ ред рм╕рм░рнАрм╕рнГрмк
ЁЯРН => ЁЯРН, рм╕рм╛рмк
ЁЯР▓ => ЁЯР▓, рмЬрнАрмм, рмбрнНрм░рм╛рмЧрмирнНтАМ, рмбрнНрм░рм╛рмЧрмирнНтАМ рморнБрм╣рмБ, рморнБрм╣рмБ
ЁЯРЙ => ЁЯРЙ, рмбрнНрм░рм╛рмЧрмирнНтАМ, рмкрм░рнА рмХрм╛рм╣рм╛рмгрнА
ЁЯжХ => ЁЯжХ, рмбрм┐рмкрнНрм▓рнЛрмбрнЛрмХрм╕рнНтАН, рммрнНрм░рм╛рмЪрм┐рм╕рм╛рм░рм╕рнНтАН, рммрнНрм░рнЛрмгрнНрмЯрнЛрм╕рм╛рм░рм╕рнНтАН, рм╕рнМрм░рнЛрмкрмб
ЁЯжЦ => ЁЯжЦ, рмЯрм╛рмЗрм░рм╛рмирнЛрм╕рм╛рм░рм╕рнНтАН рм░рнЗрмХрнНрм╕, рмЯрм┐-рм░рнЗрмХрнНрм╕
ЁЯР│ => ЁЯР│, рмЬрм│ рммрм┐рмЪрнНрмЫрнБрм░рм┐рмд рмХрм░рнБрмерм┐рммрм╛ рмдрм┐рморм┐, рмЬрнЛрм░рм░рнЗ рмирм┐рм░рнНрмЧрмд рм╣рнЗрммрм╛, рмдрм┐рморм┐, рморнБрм╣рмБ
ЁЯРЛ => ЁЯРЛ, рмдрм┐рморм┐
ЁЯРм => ЁЯРм, рмбрм▓рмлрм┐рмирнНтАМ, рмлрнНрм▓рм┐рмкрм░рнНтАМ
ЁЯРЯ => ЁЯРЯ, рморм╛рмЫ, рморнАрми рм░рм╛рм╢рм┐, рм░рм╛рм╢рм┐рмЪрмХрнНрм░
ЁЯРа => ЁЯРа, рмЙрм╖рнНрмо рмормгрнНрмбрм│рнАрнЯ, рмЧрнНрм░рнАрм╖рнНрмормормгрнНрмбрм│рнАрнЯ рморм╛рмЫ, рморм╛рмЫ
ЁЯРб => ЁЯРб, рммрнНрм▓рнЛрмлрм┐рм╢рнНтАН, рморм╛рмЫ
ЁЯжИ => ЁЯжИ, рм╢рм╛рм░рнНрмХрнНтАМ, рм╢рм╛рм░рнНрмХрнНтАМ ред рморм╛рмЫ
ЁЯРЩ => ЁЯРЩ, рмЕрмХрнНрмЯрнЛрмкрм╕рнНтАМ
ЁЯРЪ => ЁЯРЪ, рмХрнБрмгрнНрмбрм│рм╛рмХрм╛рм░ рм╢рм╛рморнБрмХрм╛, рм╢рм░рнНрмкрм┐рм│, рм╢рм╛рморнБрмХрм╛
ЁЯжА => ЁЯжА, рмХрмЩрнНрмХрмбрм╛, рмХрм░рнНрмХрмЯ ред рм░рм╛рм╢рм┐рмЪрмХрнНрм░
ЁЯжР => ЁЯжР, рмЪрм┐рмЩрнНрмЧрнБрмбрм┐, рмЪрм┐рмЩрнНрмЧрнБрмбрм┐ ред рмЫрнЛрмЯ ред рм╢рнЗрм▓рмлрм┐рм╢рнНтАН ред рмЦрм╛рмжрнНрнЯ
ЁЯжС => ЁЯжС, рм╕рнНрмХрнБрмЗрмбрнНтАН, рм╕рнНрмХрнБрмЗрмбрнНтАН ред рморнЛрм▓рнБрм╕рнНрмХ ред рмЦрм╛рмжрнНрнЯ
ЁЯРМ => ЁЯРМ, рмЧрнЗрмгрнНрмбрм╛
ЁЯжЛ => ЁЯжЛ, рмкрнНрм░рмЬрм╛рмкрмдрм┐, рмкрнНрм░рмЬрм╛рмкрмдрм┐ ред рмХрнАрмЯ ред рм╕рнБрмирнНрмжрм░
ЁЯРЫ => ЁЯРЫ, рмУрмбрм╢, рмХрнАрмЯ
ЁЯРЬ => ЁЯРЬ, рмХрнАрмЯ, рмкрм┐рморнНрмкрнБрмбрм┐
ЁЯРЭ => ЁЯРЭ, рмЬрнАрмм, рмормзрнБрмормХрнНрм╖рм┐рмХрм╛, рморм╣рнБрморм╛рмЫрм┐
ЁЯРЮ => ЁЯРЮ, рмЧрнЛрммрм░рмкрнЛрмХ, рмЬрнАрмм, рморм╛рмЗ, рморм╛рмЗ рмУрмбрм╢, рморм╛рмЗ рмЧрнЛрммрм░ рмкрнЛрмХ, рморм╛рмЗ рмЧрнЛрммрм░рмкрнЛрмХ
ЁЯжЧ => ЁЯжЧ, рмЭрм┐рмЩрнНрмХрм╛рм░рм┐, рмЭрм┐рмгрнНрмЯрм┐рмХрм╛
ЁЯХ╖ => ЁЯХ╖, рмХрнАрмЯ, рммрнБрмврм┐рмЖрмгрнА
ЁЯХ╕ => ЁЯХ╕, рммрнБрмврм┐рмЖрмгрнА ред рмЬрм╛рм▓, рммрнБрмврм┐рмЖрмгрнА рмЬрм╛рм▓
ЁЯжВ => ЁЯжВ, рмХрмЩрнНрмХрмбрм╛рммрм┐рмЫрм╛, рммрм┐рмЫрм╛ ред рммрнГрм╢рнНрмЪрм┐рмХ ред рм░рм╛рм╢рм┐рмЪрмХрнНрм░
ЁЯТР => ЁЯТР, рмкрнБрм╖рнНрмкрмЧрнБрмЪрнНрмЫ, рмкрнНрм░рмгрнЯ, рмлрнБрм▓, рмлрнБрм▓рмдрнЛрмбрм╛
ЁЯМ╕ => ЁЯМ╕, рмЪрнЗрм░рм┐, рмЪрнЗрм░рм┐ рммрнНрм▓рнЛрм╕рморнН, рмЪрнЗрм░рнА рмлрнБрм▓ рмХрмв, рмлрнБрм▓, рмлрнБрм▓ рмжрнЗрмЦрм┐рммрм╛
ЁЯТо => ЁЯТо, рмзрм│рм╛ рмлрнБрм▓, рмлрнБрм▓
ЁЯП╡ => ЁЯП╡, рмЙрмжрнНрмнрм┐рмж, рмЧрнЛрм▓рм╛рмк рмЖрмХрм╛рм░рм░ рмХрм╛рм░рнБрмХрм╛рм░рнНрмпрнНрнЯ
ЁЯМ╣ => ЁЯМ╣, рмЧрнЛрм▓рм╛рмк, рмлрнБрм▓
ЁЯеА => ЁЯеА, рмлрнБрм▓ ред рмормЙрм│рм┐ рмкрмбрм┐рмЫрм┐, рмормЙрм│рм┐ рмкрмбрм┐рмерм┐рммрм╛ рмлрнБрм▓
ЁЯМ║ => ЁЯМ║, рмлрнБрм▓, рм╣рм┐рммрм┐рм╕рмХрм╕рнНтАН
ЁЯМ╗ => ЁЯМ╗, рмлрнБрм▓, рм╕рнВрм░рнНрмпрнНрнЯрморнБрмЦрнА
ЁЯМ╝ => ЁЯМ╝, рмлрнБрм▓, рмлрнБрм▓ рмХрмв, рммрнНрм▓рнЛрмЬрморнН
ЁЯМ╖ => ЁЯМ╖, рмдрнБрм▓рм┐рмкрнНтАН, рмлрнБрм▓
ЁЯМ▒ => ЁЯМ▒, рмЪрм╛рм░рм╛, рмЫрнЛрмЯ, рмдрм│рм┐
ЁЯМ▓ => ЁЯМ▓, рмЧрмЫ, рмЪрм┐рм░рм╣рм░рм┐рмд рмЧрмЫ
ЁЯМ│ => ЁЯМ│, рмкрм░рнНрмгрнНрмгрмкрм╛рмдрм┐, рмкрм░рнНрмгрнНрмгрмкрм╛рмдрм┐ рммрнГрмХрнНрм╖, рмкрм░рнНрмгрнНрмгрморнЛрмЪрм┐ рмЧрмЫ, рммрнГрмХрнНрм╖
ЁЯМ┤ => ЁЯМ┤, рмЧрмЫ, рмдрм╛рм│, рмдрм╛рм│ рмЧрмЫ
ЁЯМ╡ => ЁЯМ╡, рмХрм╛рмХрнНтАМрмЯрм╕рнН, рмЧрмЫ, рмирм╛рмЧрмлрнЗрмгрнА
ЁЯМ╛ => ЁЯМ╛, рмХрнЗрмгрнНрмбрм╛, рмзрм╛рми, рмзрм╛рми рмХрм│рнЗрмЗ, рмзрм╛рми рмХрнЗрмгрнНрмбрм╛, рмзрм╛рми рмЧрмЫ
ЁЯМ┐ => ЁЯМ┐, рмЬрмбрм┐ рммрнБрмЯрм┐, рмкрмдрнНрм░
тШШ => тШШ, рмЙрмжрнНрмнрм┐рмж, рмдрнНрм░рм┐рмкрмдрнНрм░ рмЙрмжрнНрмнрм┐рмж
ЁЯНА => ЁЯНА, рмШрм╛рм╕, рмЪрм╛рм░рм┐, рмЪрм╛рм░рм┐ рмкрмдрнНрм░ рммрм┐рм╢рм┐рм╖рнНрмЯ рмШрм╛рм╕, рмЪрм╛рм░рм┐ рмкрмдрнНрм░ рммрм┐рм╢рм┐рм╖рнНрмЯ рмдрнГрмг, рмкрмдрнНрм░, рмнрм╛рмЧрнНрнЯ рм╢рм╛рм│рм┐
ЁЯНБ => ЁЯНБ, рмкрмдрнНрм░, рмлрм╛рм▓рнЗрмирнН рмкрмдрнНрм░, рморм╛рмкрм▓рнН рмкрмдрнНрм░, рморнНрнЯрм╛рмкрм▓рнНтАН рмкрмдрнНрм░
ЁЯНВ => ЁЯНВ, рмЭрмбрм┐ рмкрмбрм┐рмерм┐рммрм╛, рмЭрмбрм┐ рмкрмбрм┐рмерм┐рммрм╛ рмкрмдрнНрм░, рмкрмдрнНрм░
ЁЯНГ => ЁЯНГ, рмкрмдрнНрм░, рмкрмдрнНрм░ рмЙрмбрм┐рммрм╛, рмкрммрми рммрм╣рм┐рммрм╛, рмкрммрми рммрнЛрм╣рм┐рммрм╛, рмкрммрмирм░рнЗ рм╣рм▓рнБрмерм┐рммрм╛ рмкрмдрнНрм░, рммрм╛рнЯрнБ
ЁЯНЗ => ЁЯНЗ, рмЕрмЩрнНрмЧрнБрм░, рмЖрмЩрнНрмЧрнБрм░, рмлрм│
ЁЯНИ => ЁЯНИ, рмЦрм░рмнрнБрмЬ, рмлрм│
ЁЯНЙ => ЁЯНЙ, рмдрм░рмнрнБрмЬ, рмлрм│
ЁЯНК => ЁЯНК, рмХрморм│рм╛, рмЯрнНрнЯрм╛рмЩрнНрмЧрнЗрм░рм╛рмЗрмирнНтАН, рмирм╛рм░рмВрмЧрнА, рмлрм│
ЁЯНЛ => ЁЯНЛ, рмЯрмнрм╛, рмлрм│, рм▓рнЗрморнНрммрнБ
ЁЯНМ => ЁЯНМ, рмХрмжрм│рнА, рмлрм│
ЁЯНН => ЁЯНН, рмлрм│, рм╕рмкрнБрм░рм┐
ЁЯНО => ЁЯНО, рмПрмкрм▓рнН, рмлрм│, рм▓рм╛рм▓ рм╕рнЗрмУ, рм▓рм╛рм▓рнН, рм▓рм╛рм▓рнН рмПрмкрм▓рнН
ЁЯНП => ЁЯНП, рмПрмкрм▓рнН, рмлрм│, рм╕рммрнБрмЬ, рм╕рммрнБрмЬ рмПрмкрм▓рнН, рм╕рммрнБрмЬ рм╕рнЗрмУ
ЁЯНР => ЁЯНР, рмкрнЗрмЕрм░рнНтАН, рмлрм│
ЁЯНС => ЁЯНС, рмкрм┐рмЪрнНтАН, рмлрм│
ЁЯНТ => ЁЯНТ, рмЪрнЗрм░рм┐, рмЪрнЗрм░рнА, рмлрм│
ЁЯНУ => ЁЯНУ, рм╖рнНрмЯрнНрм░рммрнЗрм░рнА, рм╖рнНрмЯрнНрм░рммрнЗрм░рнА рмлрм│
ЁЯеЭ => ЁЯеЭ, рмХрм┐рн▒рм┐ ред рмлрм│ ред рмЦрм╛рмжрнНрнЯ, рмХрм┐рн▒рм┐ рмлрм│
ЁЯНЕ => ЁЯНЕ, рмЯрморм╛рмЯ, рмкрмирм┐рмкрм░рм┐рммрм╛
ЁЯее => ЁЯее, рмдрм╛рм│ ред рмкрм┐рмирм╛ рмХрнЛрм▓рм╛рмбрм╛, рмирмбрм┐рмЖ
ЁЯеС => ЁЯеС, рмЖрмнрнЛрмХрм╛рмбрнЛ, рмЖрмнрнЛрмХрм╛рмбрнЛ ред рмлрм│ ред рмЦрм╛рмжрнНрнЯ
ЁЯНЖ => ЁЯНЖ, рмкрм░рм┐рммрм╛, рммрм╛рмЗрмЧрмг
ЁЯеФ => ЁЯеФ, рмЖрм│рнБ, рмЖрм│рнБ ред рмкрмирм┐рмкрм░рм┐рммрм╛ ред рмЦрм╛рмжрнНрнЯ
ЁЯеХ => ЁЯеХ, рмЧрм╛рмЬрм░, рмЧрм╛рмЬрм░ ред рмкрмирм┐рмкрм░рм┐рммрм╛ ред рмЦрм╛рмжрнНрнЯ
ЁЯМ╜ => ЁЯМ╜, рмХрм╛рмо, рмормХрм╛, рмормХрм╛ рмХрнЗрмгрнНрмбрм╛
ЁЯМ╢ => ЁЯМ╢, рмЧрм░рмо ред рмЧрнЛрм▓рморм░рм┐рмЪ, рмЧрм░рмо рмЧрнЛрм▓рморм░рм┐рмЪ
ЁЯеТ => ЁЯеТ, рмХрм╛рмХрнБрмбрм┐, рмХрм╛рмХрнБрмбрм┐ ред рмЖрмЪрм╛рм░ ред рмкрм░рм┐рмкрм░рм┐рммрм╛ ред рмЦрм╛рмжрнНрнЯ
ЁЯеж => ЁЯеж, рммрмг рммрмирнНрмзрм╛рмХрнЛрммрм┐, рммрнНрм░рмХрнЛрм▓рм┐
ЁЯНД => ЁЯНД, рмЫрмдрнБ
ЁЯеЬ => ЁЯеЬ, рмЪрм┐рмирм╛рммрм╛рмжрм╛рмо, рмЪрм┐рмирм╛рммрм╛рмжрм╛рмо ред рммрм╛рмжрм╛рмо ред рмЦрм╛рмжрнНрнЯ ред рмкрмирм┐рмкрм░рм┐рммрм╛
ЁЯМ░ => ЁЯМ░, рмЙрмжрнНрмнрм┐рмж, рмЪрнЗрм╖рнНрмЯрмирмЯрнНтАН
ЁЯНЮ => ЁЯНЮ, рмкрм╛рмЙрмБрм░рнБрмЯрм┐, рм░рнЗрм╖рнНрмЯрнБрм░рм╛рмгрнНрмЯрнН
ЁЯеР => ЁЯеР, рмХрнНрм░рнЛрмЗрм╕рм╛рмгрнНрмЯ, рмХрнНрм░рнЛрмЗрм╕рм╛рмгрнНрмЯ ред рмХрнНрм░рнЗрм╕рнЗрмгрнНрмЯ рм░рнЛрм▓рнНтАН ред рмлрнНрм░рнЗрмЮрнНрмЪ ред рмЦрм╛рмжрнНрнЯ ред рмкрм╛рмЙрмБрм░рнБрмЯрм┐
ЁЯеЦ => ЁЯеЦ, рммрм╛рмЧрнБрмПрмЯрнЗ ред рмкрм╛рмЙрмБрм░рнБрмЯрм┐ ред рмлрнНрм░рнЗрмЮрнНрмЪ ред рмЦрм╛рмжрнНрнЯ, рммрм╛рмЧрнБрмПрмЯрнЗ рмкрм╛рмЙрмБрм░рнБрмЯрм┐
ЁЯеи => ЁЯеи, рмХрнБрмгрнНрмбрм│рм╛рмХрм╛рм░, рмкрнНрм░рнЗрмЯрмЬрнЗрм▓рнНтАН
ЁЯеЮ => ЁЯеЮ, рмкрм╛рмирмХрнЗрмХрнНтАН, рм╣рмЯрмХрнЗрмХрнНтАН ред рмХрнНрм░рнЗрмкрм┐ ред рмкрм╛рмирмХрнЗрмХрнНтАН ред рмЦрм╛рмжрнНрнЯ
ЁЯзА => ЁЯзА, рмЫрнЗрмирм╛, рмЫрнЗрмирм╛ рммрм╛рмбрм┐
ЁЯНЦ => ЁЯНЦ, рм╣рм╛рмб ред рморм╛рмВрм╕, рм╣рм╛рмбрм░рнЗ рмерм┐рммрм╛ рморм╛рмВрм╕
ЁЯНЧ => ЁЯНЧ, рмХрнБрмХрнБрмбрм╛ рмЧрнЛрмб, рмЧрнЛрмб, рмкрм▓рнБрмЯрнНрм░рм┐, рм░рнЗрм╖рнНрмЯрнБрм░рм╛рмгрнНрмЯрнН
ЁЯей => ЁЯей, рмкрм░рнНрмХрмЪрмкрнНтАН ред рм▓рнНрнЯрм╛рморнНрммрмЪрмкрнНтАН ред рмЪрмкрнНтАН ред рм╖рнНрмЯрнАрмХрнНтАН, рморм╛рмВрм╕ рмЦрмгрнНрмб
ЁЯеУ => ЁЯеУ, рммрм╛рмХрмирнНтАН, рммрм╛рмХрмирнНтАН ред рморм╛рмВрм╕ ред рмЦрм╛рмжрнНрнЯ
ЁЯНФ => ЁЯНФ, рммрм░рнНрмЧрм░рнН, рм░рнЗрм╖рнНрмЯрнБрм░рм╛рмгрнНрмЯрнН, рм╣рм╛рморммрм░рнНрмЧрм░рнНтАН, рм╣рм╛рморнНтАМрммрм░рнНрмЧрм░рнН
ЁЯНЯ => ЁЯНЯ, рмлрнНрм░рм╛рмЗрм╕рнН, рмлрнНрм░рнЗрмЮрнНрмЪ рмлрм╛рмЗрмЬрнНтАН, рмлрнНрм░рнЗрмЮрнНрмЪ рмлрнНрм░рм╛рмЗрм╕рнН, рм░рнЗрм╖рнНрмЯрнБрм░рм╛рмгрнНрмЯрнН
ЁЯНХ => ЁЯНХ, рмЦрмгрнНрмб, рмкрм┐рмЬрм╛, рмкрм┐рмЬрм╛ рмЦрмгрнНрмб, рмлрм┐рмЬрнНрмЬрм╛, рм░рнЗрм╖рнНрмЯрнБрм░рм╛рмгрнНрмЯрнН
ЁЯМн => ЁЯМн, рмлрнНрм░рм╛рмЩрнНрмХрмлрм░рнНрмЯрм░рнНтАН ред рм╣рмЯрмбрмЧрнНтАН ред рмХрм┐рморм╛, рм╣рмЯрнНтАН рмбрмЧрнНтАН
ЁЯек => ЁЯек, рмкрм╛рмЙрмБрм░рнБрмЯрм┐, рм╕рнНрнЯрм╛рмгрнНрмбрн▒рм┐рмЪрнНтАН
ЁЯМо => ЁЯМо, рмЯрм╛рмХрнЛ, рморнЗрмХрнНрм╕рм┐рмХрм╛рмирнНтАН
ЁЯМп => ЁЯМп, рммрнБрм░рм┐рмЯрнЛ, рморнЗрмХрнНрм╕рм┐рмХрм╛рмирнНтАН ред рм░рм╛рмкрнНтАН
ЁЯеЩ => ЁЯеЩ, рмХрнЗрммрм╛рммрнНтАН, рмЦрм╛рмжрнНрнЯ, рмЪрмЯрмХрм╛ рмкрм╛рмЙрмБрм░рнБрмЯрм┐, рмЬрм╛рмЗрм░рнЛ, рмкрм╛рм▓рм╛рмлрнЗрм▓рнНтАН, рмкрнБрм░ рмжрм┐рмЖрмпрм╛рмЗрмерм┐рммрм╛ рмЪрмЯрмХрм╛ рмкрм╛рмЙрмБрм░рнБрмЯрм┐, рмкрнВрм░ рмжрм┐рмЖрмпрм╛рмЗрмерм┐рммрм╛
ЁЯеЪ => ЁЯеЪ, рмЕрмгрнНрмбрм╛, рмЕрмгрнНрмбрм╛ ред рмЦрм╛рмжрнНрнЯ
ЁЯН│ => ЁЯН│, рмнрм╛рмЬрм┐рммрм╛ рмХрмбрнЗрмЗ, рм░рнЗрм╖рнНрмЯрнБрм░рм╛рмгрнНрмЯрнН, рм░рнЛрм╖рнЗрмЗ
ЁЯеШ => ЁЯеШ, рмЕрмЧрмнрнАрм░ рмЦрм╛рмжрнНрнЯ рмдрм╛рн▒рм╛, рмкрм╛рмПрм▓рм╛ ред рмХрнНрнЯрм╛рм╕рнЗрм░рнЛрм▓рнНтАН ред рмдрм╛рн▒рм╛ ред рмЕрмЧрмнрнАрм░ ред рмЦрм╛рмжрнНрнЯ
ЁЯН▓ => ЁЯН▓, рмЦрм╛рмжрнНрнЯрм░рнЗ рмнрм░рнНрмдрнНрмдрм┐ рмкрм╛рмдрнНрм░, рмкрм╛рмдрнНрм░ рмЦрм╛рмжрнНрнЯ, рм░рнЗрм╖рнНрмЯрнБрм░рм╛рмгрнНрмЯрнН, рм╕рмирнНрмдрнБрм│рм╛
ЁЯег => ЁЯег, рмЪрм╛рмормЪ рм╕рм╣рм┐рмд рмЧрм┐рмирм╛, рмкрнНрм░рм╛рмдрмГрмнрнЛрмЬрми ред рмЦрм╛рмжрнНрнЯрм╢рм╕рнНрнЯ ред рмХрмЩрнНрмЧрнА
ЁЯеЧ => ЁЯеЧ, рм╕рммрнБрмЬ ред рм╕рм╛рм▓рм╛рмб ред рмЦрм╛рмжрнНрнЯ, рм╕рммрнБрмЬ рм╕рм╛рм▓рм╛рмб
ЁЯН┐ => ЁЯН┐, рмкрмкрмХрм░рнНрмирнНтАМ
ЁЯел => ЁЯел, рмбрммрм╛, рмбрммрм╛ рмЦрм╛рмжрнНрнЯ
ЁЯН▒ => ЁЯН▒, рммрм╛рмХрнНрм╕, рммрнЗрмгрнНрмЯрнЛ, рммрнЗрмгрнНрмЯрнЛ рммрмХрнНрм╕, рммрнЗрмгрнНрмЯрнЛ рммрм╛рмХрнНрм╕, рм░рнЗрм╖рнНрмЯрнБрм░рм╛рмгрнНрмЯрнН
ЁЯНШ => ЁЯНШ, рмнрм╛рмд, рмнрм╛рмд рмлрнЛрмЯрмХрм╛, рм░рм╛рмЗрм╕рнН рмХрнНрм░рм╛рмХрм░рнН
ЁЯНЩ => ЁЯНЩ, рмУрмирм┐рмЧрнНрм░рм┐, рмнрм╛рмд, рмнрм╛рмд рмЧрнБрм│рм╛, рм░рм╛рмЗрм╕рнН рммрм▓рнН, рм░рнЗрм╖рнНрмЯрнБрм░рм╛рмгрнНрмЯрнН
ЁЯНЪ => ЁЯНЪ, рмнрм╛рмд, рм░рмирнНрмзрм╛ рмнрм╛рмд, рм░рнЗрм╖рнНрмЯрнБрм░рм╛рмгрнНрмЯрнН
ЁЯНЫ => ЁЯНЫ, рмдрм░рмХрм╛рм░рнА, рмдрм░рмХрм╛рм░рнА рмнрм╛рмд, рмнрм╛рмд, рмнрм╛рмд рмдрм░рмХрм╛рм░рнА, рм░рнЗрм╖рнНрмЯрнБрм░рм╛рмгрнНрмЯрнН
ЁЯНЬ => ЁЯНЬ, рмПрмХ рмкрм╛рмдрнНрм░ рмирнБрмбрм▓рнНрм╕, рмирнБрмбрнБрм▓рнН, рмирнБрмбрнБрм▓рнНрм╕, рммрм╛рмЙрм▓рнН, рммрм╛рморнНрмл рммрм╛рм╣рм╛рм░рнБрмерм┐рммрм╛ рмЧрм┐рмирм╛, рм░рм╛рморнЗрмирнН, рм░рнЗрм╖рнНрмЯрнБрм░рм╛рмгрнНрмЯрнН, рм╖рнНрмЯрм┐рмормВ
ЁЯНЭ => ЁЯНЭ, рмкрм╛рм╕рнНрмдрм╛, рм░рнЗрм╖рнНрмЯрнБрм░рм╛рмгрнНрмЯрнН, рм╕рмкрм╛рмШрнЗрмЯрнНрмЯрм┐, рм╕рнНрмкрм╛рмШрнЗрмЯрм┐
ЁЯНа => ЁЯНа, рмХрмирнНрмжрморнВрм│, рмЫрмгрм╛ рм╣рнЛрмЗрмерм┐рммрм╛, рмЫрмгрм╛ рм╣рнЛрмЗрмерм┐рммрм╛ рмЖрм│рнБ, рмЫрмгрм╛ рм╣рнЛрмЗрмерм┐рммрм╛ рмХрмирнНрмжрморнВрм│, рмкрнЛрмбрм╛ рмХрмирнНрмжрморнВрм│, рморм┐рмарм╛, рм░рнЗрм╖рнНрмЯрнБрм░рм╛рмгрнНрмЯрнН
ЁЯНв => ЁЯНв, рмУрмбрнЗрмирнНтАН, рмХрм╛рмарм┐, рм░рнЗрм╖рнНрмЯрнБрм░рм╛рмгрнНрмЯрнН, рм╖рнНрмЯрм┐рмХрнНтАМрм░рнЗ рм╕рм╛рморнБрмжрнНрм░рм┐рмХ рмЦрм╛рмжрнНрнЯ, рм╕рм╛рморнБрмжрнНрм░рм┐рмХ рмЦрм╛рмжрнНрнЯ
ЁЯНг => ЁЯНг, рм░рнЗрм╖рнНрмЯрнБрм░рм╛рмгрнНрмЯрнН, рм╕рнБрм╢рм┐, рм╕рнБрм╕рм┐
ЁЯНд => ЁЯНд, рмЪрм┐рмЩрнНрмЧрнБрмбрм┐, рмЫрмгрм╛ рм╣рнЛрмЗрмерм┐рммрм╛ рмЪрм┐рмЩрнНрмЧрнБрмбрм┐, рмнрмЬрм╛ рмЪрм┐рмЩрнНрмЧрнБрмбрм┐, рм░рнЗрм╖рнНрмЯрнБрм░рм╛рмгрнНрмЯрнН
ЁЯНе => ЁЯНе, рмнрмЙрмБрм░рнА рмерм┐рммрм╛ рморм╛рмЫ рмкрм┐рмарм╛, рморм╛рмЫ, рморм╛рмЫ рмХрнЗрмХрнН, рм░рнЗрм╖рнНрмЯрнБрм░рм╛рмгрнНрмЯрнН, рм╕рнНрм╡рм┐рм░рнНрм▓рнН рм╕рм╣рм┐рмд рморм╛рмЫ рмХрнЗрмХрнН
ЁЯНб => ЁЯНб, рмбрм╛рмЩрнНрмЧрнЛ, рморнЛрмЪрм┐, рморнЛрмЪрм┐рммрм▓рнН, рм░рнЗрм╖рнНрмЯрнБрм░рм╛рмгрнНрмЯрнН, рм╖рнНрмЯрм┐рмХрнНтАМрм░рнЗ рморнЛрмЪрм┐ рммрм▓рнН
ЁЯеЯ => ЁЯеЯ, рмПрмормкрм╛рмирм╛рмбрм╛, рмЧрм┐рнЯрнЛрмЬрм╛, рмЬрм┐рмЖрмУрмЬрм┐, рмбрморнНрмкрм▓рм┐рмВ, рмкрмЯрм╖рнНрмЯрм┐рмХрм░рнНтАН, рмкрм┐рмПрм░рнЛрмЧрм┐
ЁЯеа => ЁЯеа, рмлрм░рнНрмЪрнБрмирнНтАН рмХрнБрмХрнА, рмнрммрм┐рм╖рнНрнЯрмдрммрм╛рмгрнА
ЁЯеб => ЁЯеб, рмирнЗрмЗрмпрм┐рммрм╛ рммрм╛рмХрнНрм╕, рм╢рм╛рморнБрмХрм╛ рммрм╛рм▓рнНтАНрмЯрм┐
ЁЯНж => ЁЯНж, рмЖрмЗрм╕рнН рмХрнНрм░рм┐рморнН, рмХрнНрм░рм┐рморнН, рмирм░рмо рмЖрмЗрм╕рнНтАН рмХрнНрм░рм┐рморнНтАН, рм░рнЗрм╖рнНрмЯрнБрм░рм╛рмгрнНрмЯрнН, рм╕рмлрнНрмЯ рмЖрмЗрм╕рнН рмХрнНрм░рм┐рморнН, рм╕рмлрнНрмЯ рм╕рм░рнНрмнрнН
ЁЯНз => ЁЯНз, рмЧрнЛрм▓рм╛, рмЪрнБрм╕рнНтАМрмХрм┐, рммрм░рмл, рм░рнЗрм╖рнНрмЯрнБрм░рм╛рмгрнНрмЯрнН
ЁЯНи => ЁЯНи, рмЖрмЗрм╕рнНтАН рмХрнНрм░рм┐рморнНтАН, рмХрнНрм░рм┐рморнНтАМ, рммрм░рмл, рм░рнЗрм╖рнНрмЯрнБрм░рм╛рмгрнНрмЯрнН
ЁЯНй => ЁЯНй, рмбрнБрмирмЯрнНтАМ, рмбрнЛрмирмЯрнНтАН, рм░рнЗрм╖рнНрмЯрнБрм░рм╛рмгрнНрмЯрнН
ЁЯНк => ЁЯНк, рмХрнБрмХрм┐, рмХрнБрмХрнА, рм░рнЗрм╖рнНрмЯрнБрм░рм╛рмгрнНрмЯрнН
ЁЯОВ => ЁЯОВ, рмЙрмдрнНрм╕рмм, рмХрнЗрмХрнНтАМ, рмЬрмирнНрмормжрм┐рми, рмЬрмирнНрмормжрм┐рми рмХрнЗрмХрнНтАН
ЁЯН░ => ЁЯН░, рмХрмЪрнЛрмбрм┐, рмХрмЯрм╛ рмпрм╛рмЗрмерм┐рммрм╛ рмХрнЗрмХрнНтАМ, рмХрнЗрмХрнНтАМ, рм░рнЗрм╖рнНрмЯрнБрм░рм╛рмгрнНрмЯрнН, рм╕рм░рнНрмЯрмХрнЗрмХрнНтАН
ЁЯез => ЁЯез, рмкрм╛рмЗ, рмкрнЗрм╖рнНрмЯрнНрм░рм┐ ред рмкрнВрм░рмг
ЁЯНл => ЁЯНл, рмЪрмХрм▓рнЗрмЯрнНтАМ, рмЪрмХрм▓рнЗрмЯрнНтАН рммрм╛рм░рнНтАН, рммрм╛рм░рнНтАМ, рм░рнЗрм╖рнНрмЯрнБрм░рм╛рмгрнНрмЯрнН
ЁЯНм => ЁЯНм, рмХрнНрнЯрм╛рмгрнНрмбрм┐, рм░рнЗрм╖рнНрмЯрнБрм░рм╛рмгрнНрмЯрнН
ЁЯНн => ЁЯНн, рмХрнНрнЯрм╛рмгрнНрмбрм┐, рм░рнЗрм╖рнНрмЯрнБрм░рм╛рмгрнНрмЯрнН, рм▓рм▓рм┐рмкрмкрнНтАН
ЁЯНо => ЁЯНо, рмХрм╖рнНрмЯрм╛рм░рнНрмб, рмХрм╖рнНрмЯрм╛рм░рнНрмбрнНтАМ, рмкрнБрмбрм┐рмВ, рм░рнЗрм╖рнНрмЯрнБрм░рм╛рмгрнНрмЯрнН
ЁЯНп => ЁЯНп, рмкрм╛рмдрнНрм░, рморм╣рнБ, рморм╣рнБ рмкрм╛рмдрнНрм░, рм░рнЗрм╖рнНрмЯрнБрм░рм╛рмгрнНрмЯрнН, рм╣рмирм┐рмкрмЯрнНтАМ
ЁЯН╝ => ЁЯН╝, рмХрнНрм╖рнАрм░, рмкрм╛рмирнАрнЯ, рммрнЛрмдрм▓, рм╢рм┐рм╢рнБ рммрнЛрмдрм▓
ЁЯеЫ => ЁЯеЫ, рмХрнНрм╖рнАрм░ рмЧрнНрм▓рм╛рм╕, рмЧрнНрм▓рм╛рм╕ ред рмХрнНрм╖рнАрм░ ред рмкрм╛рмирнАрнЯ
тШХ => тШХ, рмЧрм░рмо рм╕рнБрм╕рнНрн▒рм╛рмжрнБ рмкрм╛рмирнАрнЯ, рм╕рнБрм╕рнНрн▒рм╛рмжрнБ рмкрм╛рмирнАрнЯ ред рмХрмлрм┐ ред рмкрм╛рмирнАрнЯ ред рмЧрм░рмо ред рммрм╛рморнНрмл рммрм╛рм╣рм╛рм░рнБрмерм┐рммрм╛ ред рмЪрм╛
ЁЯН╡ => ЁЯН╡, рмХрмкрнЗ рмЪрм╛, рмЪрм╛, рмЪрм╛ рмХрмкрнНтАМ, рмкрм╛рмирнАрнЯ, рммрнЗрмгрнНрмЯ рмирмерм┐рммрм╛ рмЪрм╛ рмХрмкрнНтАН
ЁЯН╢ => ЁЯН╢, рмХрмкрнНтАМ, рмкрм╛рмирнАрнЯ, рммрм╛рм░рнН, рммрнЛрмдрм▓, рм░рнЗрм╖рнНрмЯрнБрм░рм╛рмгрнНрмЯрнН, рм╕рнЗрмХрнНтАН, рм╕рнЗрмХрнНтАМ рммрнЛрмдрм▓ рмПрммрмВ рмХрмкрнНтАМ
ЁЯН╛ => ЁЯН╛, рмкрмкрм┐рмВ рмХрм░рнНрмХрнНтАН рм╕рм╣рм┐рмд рммрнЛрмдрм▓, рммрм╛рм░рнНтАН ред рммрнЛрмдрм▓ ред рмХрм░рнНрмХрнНтАН ред рмкрм╛рмирнАрнЯ ред рмкрмкрм┐рмВ
ЁЯН╖ => ЁЯН╖, рмЧрнНрм▓рм╛рм╕рнНтАМ, рмкрм╛рмирнАрнЯ, рммрм╛рм░рнН, рм░рнЗрм╖рнНрмЯрнБрм░рм╛рмгрнНрмЯрнН, рм╕рнБрм░рм╛, рм╕рнБрм░рм╛ рмЧрнНрм▓рм╛рм╕рнНтАН, рм╕рнБрм░рм╛рмнрм░рнНрмдрнНрмдрм┐ рмЧрнНрм▓рм╛рм╕рнНтАМ
ЁЯН╕ => ЁЯН╕, рмХрмХрмЯрнЗрм▓рнНтАМ, рмХрмХрмЯрнЗрм▓рнНтАН рмЧрнНрм▓рм╛рм╕рнНтАН, рммрм╛рм░рнН, рм░рнЗрм╖рнНрмЯрнБрм░рм╛рмгрнНрмЯрнН
ЁЯН╣ => ЁЯН╣, рмЧрнНрм░рнАрм╖рнНрмо рмормгрнНрмбрм│ рм╕рморнНрммрмирнНрмзрнАрнЯ, рмЧрнНрм░рнАрм╖рнНрмо рмормгрнНрмбрм│ рм╕рморнНрммрмирнНрмзрнАрнЯ рмкрм╛рмирнАрнЯ, рмЧрнНрм░рнАрм╖рнНрмормормгрнНрмбрм│рнАрнЯ рмкрм╛рмирнАрнЯ, рмкрм╛рмирнАрнЯ, рммрм╛рм░рнН, рм░рнЗрм╖рнНрмЯрнБрм░рм╛рмгрнНрмЯрнН
ЁЯН║ => ЁЯН║, рммрм╛рм░рнН, рмормЧрнНтАМ, рмормж, рмормж рмормЧ, рмормж рмормЧрнНтАМ, рм░рнЗрм╖рнНрмЯрнБрм░рм╛рмгрнНрмЯрнН
ЁЯН╗ => ЁЯН╗, рмЯрмг рмЯрмг рм╢рммрнНрмж рм╣рнЗрмЙрмерм┐рммрм╛ рмормж рмормЧрмЧрнБрмбрм┐рмХ, рммрм╛рм░рнН, рмормЧрнНтАМ, рмормЧрнНтАМрмЧрнБрмбрм┐рмХ, рмормж, рмормж рмормЧрнНтАМрмЧрнБрмбрм┐рмХ, рм░рнЗрм╖рнНрмЯрнБрм░рм╛рмгрнНрмЯрнН
ЁЯеВ => ЁЯеВ, рмЯрмг рмЯрмг рм╢рммрнНрмж рм╣рнЗрмЙрмерм┐рммрм╛ рмЧрнНрм▓рм╛рм╕рнНтАНрмЧрнБрмбрм┐рмХ, рмЯрмг рмЯрмг рм╢рммрнНрмж рм╣рнЗрммрм╛ ред рмЧрнНрм▓рм╛рм╕рнНтАН ред рмкрм╛рмирнАрнЯ ред рмЙрмдрнНрм╕рмм рмкрм╛рм│рми рмХрм░рм┐рммрм╛
ЁЯеГ => ЁЯеГ, рмЧрнНрм▓рм╛рм╕рнНтАН ред рмЯрморнНрммрм▓рм░рнНтАН ред рм╣рнНрн▒рм┐рм╕рнНрмХрм┐ ред рмормж ред рм╕рмЯрнНтАН, рмЯрморнНрммрм▓рм░рнНтАН рмЧрнНрм▓рм╛рм╕рнНтАН
ЁЯед => ЁЯед, рм╖рнНрмЯрнНрм░ рм╕рм╣рм┐рмд рмХрмкрнНтАН, рм╕рнЛрмбрм╛ ред рмЬрнБрм╕рнНтАН
ЁЯев => ЁЯев, рмЪрмкрм╖рнНрмЯрм┐рмХрнНтАН, рм╣рм╛рм╢рм┐
ЁЯН╜ => ЁЯН╜, рмкрнНрм▓рнЗрмЯрнНтАН рм╕рм╣рм┐рмд рмХрмгрнНрмЯрм╛ рмЪрм╛рмормЪ рмУ рмЫрнБрм░рнА, рм░рнЛрм╖рнЗрмЗ ред рмХрмгрнНрмЯрм╛ рмЪрм╛рмормЪ ред рмЫрнБрм░рнА ред рмкрнНрм▓рнЗрмЯрнНтАН
ЁЯН┤ => ЁЯН┤, рмХрмгрнНрмЯрм╛ рмЪрм╛рмормЪ рмПрммрмВ рмЫрнБрм░рнА, рм░рнЛрм╖рнЗрмЗ ред рмХрмгрнНрмЯрм╛ рмЪрм╛рмормЪ
ЁЯеД => ЁЯеД, рмЪрм╛рмормЪ, рмЪрм╛рмормЪ ред рмЯрнЗрммрнБрм▓рн▒рнЗрнЯрм╛рм░
ЁЯФк => ЁЯФк, рмЪрм╛рмХрнБ, рмЫрнБрм░рнА, рм░рнЛрм╖рнЗрмЗрм╢рм╛рм│ рмЫрнБрм░рнА
ЁЯП║ => ЁЯП║, рмЖрморнНрмлрнЛрм░рм╛, рмХрнБрморнНрмнрм░рм╛рм╢рм┐, рмкрм╛рмирнАрнЯ, рмормЧ, рмпрмирнНрмдрнНрм░рмкрм╛рмдрм┐ ред рмЕрм╕рнНрмдрнНрм░рм╢рм╕рнНрмдрнНрм░ ред рм░рм╛рм╢рм┐рмЪрмХрнНрм░, рм░рнЛрм╖рнЗрмЗ
ЁЯМН => ЁЯМН, рмЖрмлрнНрм░рм┐рмХрм╛, рмкрнГрмерм┐рммрнА, рммрм┐рм╢рнНрм╡, рнЯрнБрм░рнЛрмк, рнЯрнБрм░рнЛрмкрнНтАМ-рмЖрмлрнНрм░рм┐рмХрм╛ рмжрнЗрмЦрм╛рмЙрмерм┐рммрм╛ рмЧрнНрм▓рнЛрммрнНтАМ
ЁЯМО => ЁЯМО, рмЖрморнЗрм░рм┐рмХрм╛, рмЖрморнЗрм░рм┐рмХрм╛ рмжрнЗрмЦрм╛рмЙрмерм┐рммрм╛ рмЧрнНрм▓рнЛрммрнНтАМ, рмЖрморнЗрм░рм┐рмХрнАрнЯ, рмкрнГрмерм┐рммрнА, рммрм┐рм╢рнНрм╡
ЁЯМП => ЁЯМП, рмЕрм╖рнНрмЯрнНрм░рнЗрм▓рм┐рмЖ, рмПрм╕рм┐рмЖ, рмПрм╕рм┐рмЖ-рмЕрм╖рнНрмЯрнНрм░рнЗрм▓рм┐рмЖ рмжрнЗрмЦрм╛рмЙрмерм┐рммрм╛ рмЧрнНрм▓рнЛрммрнНтАМ, рмкрнГрмерм┐рммрнА, рммрм┐рм╢рнНрм╡
ЁЯМР => ЁЯМР, рмжрнНрм░рм╛рмШрм┐рморм╛, рмжрнНрм░рм╛рмШрм┐рморм╛рмЧрнБрмбрм┐рмХ рмерм┐рммрм╛ рмЧрнНрм▓рнЛрммрнНтАМ, рмкрнГрмерм┐рммрнА
ЁЯЧ║ => ЁЯЧ║, рммрм┐рм╢рнНрн▒, рммрм┐рм╢рнНрн▒ рморм╛рмирмЪрм┐рмдрнНрм░, рморм╛рмирмЪрм┐рмдрнНрм░
ЁЯЧ╛ => ЁЯЧ╛, рмЬрм╛рмкрм╛рмирм░ рморм╛рмирмЪрм┐рмдрнНрм░, рмЬрм╛рмкрм╛рмирнН, рморнНрнЯрм╛рмкрнН, рморнНрнЯрм╛рмкрнН рмЕрмлрнН рмЬрм╛рмкрм╛рмирнН
ЁЯПФ => ЁЯПФ, рмдрнБрм╖рм╛рм░, рмдрнБрм╖рм╛рм░рм╛рмЫрмирнНрми рмкрм░рнНрммрмд, рмермгрнНрмбрм╛, рмкрм░рнНрммрмд
тЫ░ => тЫ░, рмкрм░рнНрммрмд
ЁЯМЛ => ЁЯМЛ, рмЖрмЧрнНрмирнЗрнЯрмЧрм┐рм░рм┐, рмЖрмЧрнНрмирнЗрнЯрмЧрм┐рм░рм┐ рммрм┐рм╕рнНрмлрнЛрмЯ, рмЖрмЧрнНрмирнЗрнЯрмЧрнАрм░
ЁЯЧ╗ => ЁЯЧ╗, рмкрм╛рм╣рм╛рмб, рморм╛рмЙрмгрнНрмЯ рмлрнБрмЬрм┐, рморм╛рмЙрмгрнНрмЯрнН. рмлрнБрмЬрм┐
ЁЯПХ => ЁЯПХ, рм╢рм┐рммрм┐рм░ рм╕рнНрмерм╛рмкрми рмХрм░рм┐рммрм╛
ЁЯПЦ => ЁЯПЦ, рмЫрмдрм╛ рм╕рм╣рм┐рмд рммрнЗрм│рм╛рмнрнВрморм┐
ЁЯПЬ => ЁЯПЬ, рморм░рнБрмнрнВрморм┐
ЁЯПЭ => ЁЯПЭ, рмжрнНрм╡рнАрмк, рморм░рнБрмнрнВрморм┐, рморм░рнБрмнрнВрморм┐ рмжрнНрн▒рнАрмк
ЁЯПЮ => ЁЯПЮ, рмЙрмжрнНрнЯрм╛рми, рмЬрм╛рмдрнАрнЯ рмЙрмжрнНрнЯрм╛рми
ЁЯПЯ => ЁЯПЯ, рм╖рнНрмЯрм╛рмбрм┐рнЯрмо
ЁЯПЫ => ЁЯПЫ, рмкрнНрм░рм╛рмЪрнАрми, рмкрнНрм░рм╛рмЪрнАрми рмЕрмЯрнНрмЯрм╛рм│рм┐рмХрм╛
ЁЯПЧ => ЁЯПЧ, рмЕрмЯрнНрмЯрм╛рм│рм┐рмХрм╛ рмирм┐рм░рнНрморм╛рмг, рмирм┐рм░рнНрморм╛рмг
ЁЯПШ => ЁЯПШ, рмШрм░рмЧрнБрмбрм┐рмХ
ЁЯПЩ => ЁЯПЩ, рм╕рм╣рм░, рм╕рм╣рм░рнА рмкрм░рм┐рмжрнГрм╢рнНрнЯ
ЁЯПЪ => ЁЯПЪ, рмШрм░, рмкрм░рм┐рмдрнНрнЯрмХрнНрмд, рмкрм░рм┐рмдрнНрнЯрмХрнНрмд рмШрм░
ЁЯПа => ЁЯПа, рмЕрмЯрнНрмЯрм╛рм│рм┐рмХрм╛, рмШрм░
ЁЯПб => ЁЯПб, рмЕрмЯрнНрмЯрм╛рм│рм┐рмХрм╛, рмПрмХ рммрмЧрм┐рмЪрм╛ рмерм┐рммрм╛ рмШрм░, рмЧрнГрм╣, рммрмЧрм┐рмЪрм╛, рммрмЧрм┐рмЪрм╛ рмерм┐рммрм╛ рмШрм░
ЁЯПв => ЁЯПв, рмЕрмЯрнНрмЯрм╛рм│рм┐рмХрм╛, рмХрм╛рм░рнНрмпрнНрнЯрм╛рм│рнЯ, рмХрм╛рм░рнНрмпрнНрнЯрм╛рм│рнЯ рмЕрмЯрнНрмЯрм╛рм│рм┐рмХрм╛
ЁЯПг => ЁЯПг, рмЕрмЯрнНрмЯрм╛рм│рм┐рмХрм╛, рмЬрм╛рмкрм╛рмирнА, рмЬрм╛рмкрм╛рмирнА рмбрм╛рмХ рмШрм░, рмЬрм╛рмкрм╛рмирнА рмбрм╛рмХрмШрм░, рмбрм╛рмХ, рмбрм╛рмХрмШрм░
ЁЯПд => ЁЯПд, рмЕрмЯрнНрмЯрм╛рм│рм┐рмХрм╛, рмбрм╛рмХ, рмбрм╛рмХ рмШрм░, рмбрм╛рмХрмШрм░, рнЯрнБрм░рнЛрмкрнАрнЯ, рнЯрнБрм░рнЛрмкрнАрнЯ рмбрм╛рмХрмШрм░
ЁЯПе => ЁЯПе, рмЕрмЯрнНрмЯрм╛рм│рм┐рмХрм╛, рмбрм╛рмХрнНрмдрм░рмЦрм╛рмирм╛
ЁЯПж => ЁЯПж, рммрнНрнЯрм╛рмЩрнНрмХ, рммрнНрнЯрм╛рмЩрнНрмХ рмЕрмЯрнНрмЯрм╛рм│рм┐рмХрм╛
ЁЯПи => ЁЯПи, рмЕрмЯрнНрмЯрм╛рм│рм┐рмХрм╛, рм╣рнЛрмЯрнЗрм▓рнНтАМ
ЁЯПй => ЁЯПй, рмЕрмЯрнНрмЯрм╛рм│рм┐рмХрм╛, рмкрм╕рмирнНрмжрм░ рм╣рнЛрмЯрнЗрм▓рнНтАМ, рмкрнНрм░рнЗрмо рм╣рнЛрмЯрнЗрм▓рнНтАМ, рмнрм▓ рмкрм╛рмЗрммрм╛, рм╣рнЛрмЯрнЗрм▓рнНтАМ
ЁЯПк => ЁЯПк, рмЕрмЯрнНрмЯрм╛рм│рм┐рмХрм╛, рмЙрмкрмпрнЛрмЧрнА рмкрмжрм╛рм░рнНрме, рмЙрмкрмпрнЛрмЧрнА рм╖рнНрмЯрнЛрм░рнНтАМ, рмХрмирмнрнЗрмирм┐рмПрмирнНрм╕ рм╖рнНрмЯрнЛрм░рнНтАМ, рм╖рнНрмЯрнЛрм░рнНтАМ
ЁЯПл => ЁЯПл, рмЕрмЯрнНрмЯрм╛рм│рм┐рмХрм╛, рммрм┐рмжрнНрнЯрм╛рм│рнЯ, рммрм┐рмжрнНрнЯрм╛рм│рнЯ рмЕрмЯрнНрмЯрм╛рм│рм┐рмХрм╛
ЁЯПм => ЁЯПм, рммрм┐рмнрм╛рмЧ, рммрм┐рмнрм╛рмЧрнАрнЯ рм╖рнНрмЯрнЛрм░рнНтАМ, рм╖рнНрмЯрнЛрм░рнНтАМ
ЁЯПн => ЁЯПн, рмЕрмЯрнНрмЯрм╛рм│рм┐рмХрм╛, рмХрм╛рм░рмЦрм╛рмирм╛
ЁЯПп => ЁЯПп, рмЕрмЯрнНрмЯрм╛рм│рм┐рмХрм╛, рмЬрм╛рмкрм╛рмирнА рмжрнБрм░рнНрмЧ, рмжрнБрм░рнНрмЧ
ЁЯП░ => ЁЯП░, рмЕрмЯрнНрмЯрм╛рм│рм┐рмХрм╛, рмжрнБрм░рнНрмЧ, рнЯрнБрм░рнЛрмкрнАрнЯ рмжрнБрм░рнНрмЧ
ЁЯТТ => ЁЯТТ, рмкрнНрм░рмгрнЯ, рммрм┐рммрм╛рм╣, рммрм┐рммрм╛рм╣ рммрнЗрмжрнА, рммрнЗрмжрнА
ЁЯЧ╝ => ЁЯЧ╝, рмЯрм╛рн▒рм╛рм░рнН, рмЯрнЛрмХрм┐рмУ рмЯрм╛рн▒рм╛рм░, рмЯрнЛрмХрм┐рнЯрнЛ, рмЯрнЛрмХрм┐рнЯрнЛ рмЯрм╛рн▒рм╛рм░рнН
ЁЯЧ╜ => ЁЯЧ╜, рм▓рм┐рммрм░рнНрмЯрм┐, рм╖рнНрмЯрм╛рмЪрнНрнЯрнБ рмЕрмлрнНтАМ рм▓рм┐рммрм░рнНрмЯрм┐, рм╖рнНрмЯрнЗрмЪрнНрнЯрнБ, рм╖рнНрмЯрнЗрмЪрнНрнЯрнБ рмЕрмлрнН рм▓рм┐рммрм░рнНрмЯрм┐
тЫк => тЫк, рмХрнЛрмарм╛, рмЪрм░рнНрмЪрнН, рмЪрм░рнНрмЪрнНрмЪ
ЁЯХМ => ЁЯХМ, рмЗрм╕рм▓рм╛рмо, рмзрм░рнНрмо, рморм╕рмЬрм┐рмжрнН, рморнБрм╕рм▓рморм╛рми
ЁЯХН => ЁЯХН, рмЗрм╣рнБрмжрнА рмзрм░рнНрмо рм╕рморнНрммрмирнНрмзрнАрнЯ, рмЬрнНрнЯрнБ, рмзрм░рнНрмо, рмормирнНрмжрм┐рм░, рм╕рм┐рмирм╛рмЧрнЛрмЧрнБрмП
тЫй => тЫй, рмзрм░рнНрмо, рмкрммрм┐рмдрнНрм░рм╕рнНрмерм│, рм╢рм┐рмгрнНрмЯрнЛ, рм╢рм┐рмгрнНрмЯрнЛ рмкрммрм┐рмдрнНрм░рм╕рнНрмерм│
ЁЯХЛ => ЁЯХЛ, рмЗрм╕рм▓рм╛рмо, рмХрм╛рммрм╛, рмзрм░рнНрмо, рморнБрм╕рм▓рморм╛рми
тЫ▓ => тЫ▓, рмЭрм░рмгрм╛, рмлрм╛рмЙрмгрнНрмЯрнЗрмирнН
тЫ║ => тЫ║, рмЯрнЗрмгрнНрмЯрнН, рмдрморнНрммрнБ, рм╢рм┐рммрм┐рм░
ЁЯМБ => ЁЯМБ, рмХрнБрм╣рнБрмбрм┐, рмХрнБрм╣рнБрмбрм┐рмЖ
ЁЯМГ => ЁЯМГ, рмдрм╛рм░рм╛, рмдрм╛рм░рм╛ рмЧрм╣рмгрм░рнЗ рм░рм╛рмдрм┐, рм░рм╛рмдрм┐, рм░рм╛рмдрнНрм░ рмдрм╛рм░рм╛
ЁЯМД => ЁЯМД, рмкрм░рнНрммрмдрморм╛рм│рм╛рм░рнЗ рм╕рнВрм░рнНрмпрнНрнЯрнЛрмжрнЯ, рмкрм╛рм╣рм╛рмб, рмкрм╛рм╣рм╛рмб рмЙрмкрм░рнЗ рм╕рнВрм░рнНрмпрнНрнЯрмЙрмжрнЯ, рм╕рмЦрм╛рм│рнБрмЖ рм╕рнВрм░рнНрмпрнНрнЯ, рм╕рнВрм░рнНрмпрнНрнЯрмЙрмжрнЯ
ЁЯМЕ => ЁЯМЕ, рм╕рмЦрм╛рм│рнБрмЖ рм╕рнВрм░рнНрмпрнНрнЯ, рм╕рнВрм░рнНрмпрнНрнЯрмЙрмжрнЯ, рм╕рнВрм░рнНрмпрнНрнЯрнЛрмжрнЯ
ЁЯМЖ => ЁЯМЖ, рмХрнЛрмарм╛, рмкрнНрм░рмжрнЛрм╖ рм╕рморнЯрм░рнЗ рм╕рм╣рм░рм░ рмкрм░рм┐рмжрнГрм╢рнНрнЯ, рмормирнЛрм░рмо рмжрнГрм╢рнНрнЯ, рм╕рмирнНрмзрнНрнЯрм╛, рм╕рмирнНрмзрнНрнЯрм╛рмХрм╛рм│, рм╕рмирнНрмзрнНрнЯрм╛рмХрм╛рм│ рм╕рм╣рм░, рм╕рм╣рм░, рм╕рнВрм░рнНрмпрнНрнЯрм╛рм╕рнНрмд
ЁЯМЗ => ЁЯМЗ, рмХрнЛрмарм╛, рмХрнЛрмарм╛ рмЙрмкрм░рнЗ рм╕рнВрм░рнНрмпрнНрнЯрм╛рм╕рнНрмд, рм╕рмирнНрмзрнНрнЯрм╛рмХрм╛рм│, рм╕рнВрм░рнНрмпрнНрнЯрм╛рм╕рнНрмд
ЁЯМЙ => ЁЯМЙ, рм░рм╛рмдрм┐рм░рнЗ рмкрнЛрм▓, рм░рм╛рмдрнНрм░, рм░рм╛рмдрнНрм░ рммрнНрм░рм┐рмЬрнН, рм░рм╛рмдрнНрм░рм░рнЗ рммрнНрм░рм┐рм░рнНрмЬрнН
тЩи => тЩи, рмЙрм╖рнНрмо рмкрнНрм░рм╕рммрмгрмЧрнБрмбрм┐рмХ, рмЧрм░рмо, рмЭрм░рмгрм╛рмЧрнБрмбрм┐рмХ, рммрм╛рморнНрмл рммрм╛рм╣рм╛рм░рм┐рммрм╛
ЁЯММ => ЁЯММ, рмЖрмХрм╛рм╢рмЧрмЩрнНрмЧрм╛, рмЫрм╛рнЯрм╛рмкрме
ЁЯОа => ЁЯОа, рмШрнВрм░рнНрмгрнНрмгрмирм╢рнАрм│ рммрм╛рм╣рмХ рмпрмирнНрмдрнНрм░, рмШрнВрм░рнНрмгрнНрмгрнЯрморм╛рми рмШрнЛрмбрм╛, рмШрнЛрмбрм╛, рммрм╛рм╣рмХ рмШрнЛрмбрм╛, рмормирнЛрм░рмЮрнНрмЬрми
ЁЯОб => ЁЯОб, рмЖрморнЛрмж рмЙрмжрнНрнЯрм╛рми, рмШрнВрм░рнНрмгрнНрмгрмирм╢рнАрм│, рмЪрмХ, рмлрнЗрм░рм┐рм╕рнН рм╣рнНрн▒рм┐рм▓рнН, рммрмб рмШрнВрм░рнНрмгрнНрмгрмирм╢рнАрм│ рмЪрмХ, рмормирнЛрм░рмЮрнНрмЬрми
ЁЯОв => ЁЯОв, рмЖрморнЛрмж рмЙрмжрнНрнЯрм╛рми, рмормирнЛрм░рмЮрнНрмЬрми, рм░рнЛрм▓рм░рнНтАМ, рм░рнЛрм▓рм░рнНтАМ рмХрнЛрм╖рнНрмЯрм░рнНтАМ
ЁЯТИ => ЁЯТИ, рмкрнЛрм▓рнН, рммрм╛рм░рнНрммрм░рнНтАМ, рммрм╛рм░рнНрммрм░рнНтАМ рмкрнЛрм▓рнНтАМ, рммрм╛рм░рнНрммрм░рнНтАМ рм╢рмкрнНтАМ
ЁЯОк => ЁЯОк, рмдрморнНрммрнБ, рмормирнЛрм░рмЮрнНрмЬрми, рм╕рм░рнНрмХрм╕тАМ, рм╕рм░рнНрмХрм╕тАМ рмдрморнНрммрнБ, рм╕рм░рнНрмХрм╕рнНтАМ рмдрморнНрммрнБ
ЁЯОн => ЁЯОн, рмХрм│рм╛, рмкрнНрм░рмжрм░рнНрм╢рми рмХрм░рм┐рммрм╛, рмкрнНрм░рмжрм░рнНрм╢рми рмХрм│рм╛, рмкрнНрм░рмжрм░рнНрм╢рмирмХрм╛рм░рнА рмХрм│рм╛, рмормирнЛрм░рмЮрнНрмЬрми, рморнБрм╣рмБ рмЖрммрм░рмг
ЁЯЦ╝ => ЁЯЦ╝, рмХрм│рм╛, рмЪрм┐рмдрнНрм░, рмЪрм┐рмдрнНрм░рмХрм│рм╛, рмлрнНрм░рнЗрморнНтАМ, рмлрнНрм░рнЗрморнНтАМрмпрнБрмХрнНрмд рмЪрм┐рмдрнНрм░, рм╕рмВрмЧрнНрм░рм╣рм╛рм│рнЯ
ЁЯОи => ЁЯОи, рмЕрм╕рнНрмерм╛рнЯрнА рм╢рмпрнНрнЯрм╛, рмХрм│рм╛, рмХрм│рм╛рмХрм╛рм░, рмХрм│рм╛рмХрм╛рм░ рм╢рмпрнНрнЯрм╛, рм░рмЩрнНрмЧ, рм░рмЩрнНрмЧ рм╢рмпрнНрнЯрм╛, рм╢рм┐рм│рнНрмкрнАрмЩрнНрмХ рмЖрмзрм╛рм░
ЁЯО░ => ЁЯО░, рмЦрнЗрм│, рм╕рнНрм▓рмЯрнНтАМ, рм╕рнНрм▓рмЯрнНтАМ рморнЗрм╕рм┐рмирнНтАМ
ЁЯЪВ => ЁЯЪВ, рмЯрнНрм░рнЗрмирнН, рммрм╛рм╣рм╛рми, рм▓рнЛрмХрнЛрморнЛрмЯрм┐рмнрнНтАМ, рм╖рнНрмЯрм┐рморнН рм▓рнЛрмХрнЛрморнЛрмЯрм┐рмнрнН
ЁЯЪГ => ЁЯЪГ, рмЗрм▓рнЗрмХрнНрмЯрнНрм░рм┐рмХрнН, рмЗрм▓рнЗрмХрнНрмЯрнНрм░рм┐рмХрнН рмЯрнНрм░рнЗрмирнН, рмЯрнНрм░рм╛рморнН, рмЯрнНрм░рнЗрмирнН, рммрм╛рм╣рм╛рми, рм░рнЗрм▓рн▒рнЗ, рм░рнЗрм▓рн▒рнЗ рмХрм╛рм░рнНтАМ
ЁЯЪД => ЁЯЪД, рмЕрмзрм┐рмХ-рмЧрмдрм┐рм╢рнАрм│ рмЯрнНрм░рнЗрмирнН, рмЙрмЪрнНрмЪ-рмЧрмдрм┐ рммрм┐рм╢рм┐рм╖рнНрмЯ рмЯрнНрм░рнЗрмирнНтАМ, рмЯрнНрм░рнЗрмирнН, рммрм╛рм╣рм╛рми, рм╕рм┐рмВрмирмХрм╛рмирм╕рнЗрмирнН
ЁЯЪЕ => ЁЯЪЕ, рмЕрмзрм┐рмХ-рмЧрмдрм┐рм╢рнАрм│ рмЯрнНрм░рнЗрмирнН, рмЯрнНрм░рнЗрмирнН, рммрм╛рм╣рм╛рми, рммрнБрм▓рнЗрмЯрнНтАМ рмЯрнНрм░рнЗрмирнНтАМ, рммрнБрм▓рнЗрмЯрнН рмирнЛрмЬрнН, рм╕рм┐рмВрмирмХрм╛рмирм╕рнЗрмирнН, рм╕рм┐рмВрмирмХрм╛рмирм╕рнЗрмирнН рм╕рм╣рм┐рмд рммрнБрм▓рнЗрмЯрнН рмирнЛрмЬрнН
ЁЯЪЖ => ЁЯЪЖ, рмЯрнНрм░рнЗрмирнНтАМ, рммрм╛рм╣рм╛рми, рм░рнЗрм▓рн▒рнЗ
ЁЯЪЗ => ЁЯЪЗ, рммрм╛рм╣рм╛рми, рморнЗрмЯрнНрм░рнЛ, рм╕рммрнНтАМрн▒рнЗ
ЁЯЪИ => ЁЯЪИ, рммрм╛рм╣рм╛рми, рм░рнЗрм│, рм▓рм╛рмЗрмЯрнН, рм▓рм╛рмЗрмЯрнН рм░рнЗрм│, рм╣рм╛рм▓рмХрм╛ рмЯрнНрм░рнЗрмирнНтАМ
ЁЯЪЙ => ЁЯЪЙ, рмЯрнНрм░рнЗрмирнН, рмЯрнНрм░рнЗрмирнН рм╖рнНрмЯрнЗрм╕рмирнН, рм╖рнНрмЯрнЗрм╕рмирнНтАМ
ЁЯЪК => ЁЯЪК, рмЯрнНрм░рм╛рморнН, рммрм╛рм╣рм╛рми
ЁЯЪЭ => ЁЯЪЭ, рммрм╛рм╣рм╛рми, рмормирнЛрм░рнЗрм▓рнНтАМ, рморнЛрмирнЛрм░рнЗрм▓рнН
ЁЯЪЮ => ЁЯЪЮ, рмХрм╛рм░рнН, рмкрм░рнНрммрмд рм░рнЗрм│рн▒рнЗ, рммрм╛рм╣рм╛рми, рморм╛рмЙрмгрнНрмЯрнЗрмирнН, рморм╛рмЙрмгрнНрмЯрнЗрмирнН рмХрнЗрммрм▓рнН рмХрм╛рм░рнН, рморм╛рмЙрмгрнНрмЯрнЗрмирнН рм░рнЗрм▓рн▒рнЗ, рм░рнЗрм▓рн▒рнЗ
ЁЯЪЛ => ЁЯЪЛ, рмХрм╛рм░рнН, рмЯрнНрм░рм╛рморнН, рмЯрнНрм░рм╛рморнНтАМ рмХрм╛рм░рнНтАМ, рммрм╛рм╣рм╛рми
ЁЯЪМ => ЁЯЪМ, рммрм╕рнНтАМ, рммрм╛рм╣рм╛рми
ЁЯЪН => ЁЯЪН, рмЖрм╕рнБрмерм┐рммрм╛, рмЖрм╕рнБрмерм┐рммрм╛ рммрм╕рнН, рммрм╕рнН, рммрм╛рм╣рм╛рми, рм╕рморнНрморнБрмЦрм░рнБ рмЖрм╕рнБрмерм┐рммрм╛ рммрм╕рнНтАМ
ЁЯЪО => ЁЯЪО, рмЯрнНрм░рм▓рм┐рммрм╕рнНтАМ, рмЯрнНрм░рнЛрм▓рм┐, рмЯрнНрм░рнЛрм▓рм┐ рммрм╕рнН, рммрм╕рнН, рммрм╛рм╣рм╛рми
ЁЯЪР => ЁЯЪР, рммрм╕рнН, рммрм╛рм╣рм╛рми, рморм┐рмирм┐ рммрм╕рнН, рморм┐рмирм┐рммрм╕рнНтАМ
ЁЯЪС => ЁЯЪС, рмЖрморнНрммрнБрм▓рм╛рмирнНрм╕, рмЖрморнНрм╡рнБрм▓рнЗрмирнНрм╕, рммрм╛рм╣рм╛рми
ЁЯЪТ => ЁЯЪТ, рмЗрмЮрнНрмЬрм┐рмирнН, рмлрм╛рнЯрм╛рм░рнН, рмлрм╛рнЯрм╛рм░рнНтАМ рмЗрмЮрнНрмЬрм┐рмирнНтАМ, рмлрм╛рнЯрм╛рм░рнН рмЯрнНрм░рмХрнН, рммрм╛рм╣рм╛рми
ЁЯЪУ => ЁЯЪУ, рмкрнЗрмЯрнНрм░рнЛрм▓рнН рмХрм╛рм░рнН, рмкрнЛрм▓рм┐рм╕рнН, рмкрнЛрм▓рм┐рм╕рнН рмХрм╛рм░рнНтАМ, рммрм╛рм╣рм╛рми
ЁЯЪФ => ЁЯЪФ, рмЖрм╕рм┐рммрм╛рмХрнБрмерм┐рммрм╛ рмкрнЛрм▓рм┐рм╕рнН рмХрм╛рм░рнН, рмкрнЛрм▓рм┐рм╕рнН, рмкрнЛрм▓рм┐рм╕рнН рмХрм╛рм░рнН, рммрм╛рм╣рм╛рми, рм╕рморнНрморнБрмЦрм░рнБ рмЖрм╕рнБрмерм┐рммрм╛ рмкрнЛрм▓рм┐рм╕рнНтАМ рмХрм╛рм░рнНтАМ
ЁЯЪХ => ЁЯЪХ, рмЯрнЗрмХрнНрм╕рм┐, рмЯрнНрнЯрм╛рмХрнНрм╕рм┐, рммрм╛рм╣рм╛рми
ЁЯЪЦ => ЁЯЪЦ, рмЖрм╕рм┐рммрм╛рмХрнБрмерм┐рммрм╛ рмЯрнЗрмХрнНрм╕рм┐, рмЯрнЗрмХрнНрм╕рм┐, рммрм╛рм╣рм╛рми, рм╕рморнНрморнБрмЦрм░рнБ рмЖрм╕рнБрмерм┐рммрм╛ рмЯрнНрнЯрм╛рмХрнНрм╕рм┐
ЁЯЪЧ => ЁЯЪЧ, рмЕрмЯрнЛрморнЛрммрм╛рмЗрм▓рнНтАМ, рмХрм╛рм░рнН
ЁЯЪШ => ЁЯЪШ, рмЕрмЯрнЛрморнЛрммрм╛рмЗрм▓рнН, рмЖрм╕рм┐рммрм╛рмХрнБрмерм┐рммрм╛, рмЖрм╕рм┐рммрм╛рмХрнБрмерм┐рммрм╛ рмЕрмЯрнЛрморнЛрммрм╛рмЗрм▓рнН, рмЖрм╕рм┐рммрм╛рмХрнБрмерм┐рммрм╛ рмХрм╛рм░рнН, рмХрм╛рм░рнН, рммрм╛рм╣рм╛рми, рм╕рморнНрморнБрмЦрм░рнБ рмЖрм╕рнБрмерм┐рммрм╛ рмЕрмЯрнЛрморнЛрммрм╛рмЗрм▓рнН
ЁЯЪЩ => ЁЯЪЩ, рмЖрм░рнНтАМрмнрм┐, рмХрм╛рм░рнН, рмХрнНрм░рнАрмбрм╛ рмЙрмкрмпрнЛрмЧрнА рмпрм╛рми, рмкрнБрмирмГрм╕рнГрм╖рнНрмЯрм┐рмЬрмирм┐рмд рммрм╛рм╣рм╛рми, рммрм╛рм╣рм╛рми
ЁЯЪЪ => ЁЯЪЪ, рмЯрнНрм░рмХрнН, рмбрнЗрм▓рм┐рмнрнЗрм░рм┐ рмЯрнНрм░рмХрнН, рммрм╛рм╣рм╛рми, рммрм┐рмдрм░рмг рмЯрнНрм░рмХрнНтАМ
ЁЯЪЫ => ЁЯЪЫ, рмЖрм░рнНрмЯрм┐рмХрнБрм▓рнЗрмЯрнЗрмбрнНтАМ рм▓рм░рм┐, рмЯрнНрм░рмХрнН, рмЯрнНрм░рм▓рм░рнН, рммрм╛рм╣рм╛рми, рмпрнЛрмбрм┐ рм╣рнЛрмЗрмерм┐рммрм╛ рм▓рм░рм┐, рм▓рм░рм┐, рм╕рнЗрморм┐
ЁЯЪЬ => ЁЯЪЬ, рмЯрнНрм░рм╛рмХрнНрмЯрм░рнН, рммрм╛рм╣рм╛рми
ЁЯЪ▓ => ЁЯЪ▓, рммрм╛рмЗрмХрнН, рммрм╛рмЗрм╕рм╛рмЗрмХрнЗрм▓рнН
ЁЯЫ┤ => ЁЯЫ┤, рмХрм┐рмХрнНтАМ, рмХрм┐рмХрнНтАМ рм╕рнНрмХрнБрмЯрм░рнНтАМ, рм╕рнНрмХрнБрмЯрм░рнНтАМ
ЁЯЫ╡ => ЁЯЫ╡, рморнЛрмЯрм░, рморнЛрмЯрм░ рм╕рнНрмХрнБрмЯрм░рнНтАМ, рм╕рнНрмХрнБрмЯрм░рнНтАМ
ЁЯЪП => ЁЯЪП, рммрм╕рнН, рммрм╕рнН рм╖рнНрмЯрмкрнНтАМ, рм╖рнНрмЯрмкрнН
ЁЯЫг => ЁЯЫг, рмормЯрм░рмЧрм╛рмбрм┐ рмпрм┐рммрм╛ рмкрм╛рмЗрмБ рм╕рнНрн▒рмдрмирнНрмдрнНрм░ рм░рм╛рм╕рнНрмдрм╛, рм░рм╛рмЬрмкрме, рм░рм╛рм╕рнНрмдрм╛
ЁЯЫд => ЁЯЫд, рм░рнЗрм▓рн▒рнЗ ред рмЯрнНрм░рнЗрмирнНтАМ, рм░рнЗрм│рмкрме
тЫ╜ => тЫ╜, рмЗрмирнНрмзрми рмкрморнНрмк, рмЧрнНрнЯрм╛рм╕рнН, рмЧрнНрнЯрм╛рм╕рнН рм╖рнНрмЯрнЗрм╕рмирнН, рмлрм┐рнЯрнБрмПрм▓рнН, рмлрм┐рнЯрнБрмПрм▓рнН рмкрморнНрмкрнН, рм╖рнНрмЯрнЗрм╕рмирнН
ЁЯЪи => ЁЯЪи, рмкрнЛрм▓рм┐рм╕рнН рмХрм╛рм░рнН, рмкрнЛрм▓рм┐рм╕рнНтАМ рмХрм╛рм░рнН рмЖрм▓рнЛрмХ, рмкрнЛрм▓рм┐рм╕рнН рммрм┐рмХрнЛрмирнН, рмкрнЛрм▓рм┐рм╕рнН рм▓рм╛рмЗрмЯрнН, рм▓рм╛рм▓рнН рммрмдрм┐
ЁЯЪе => ЁЯЪе, рмЯрнНрм░рм╛рмлрм┐рмХрнН, рмЯрнНрм░рм╛рмлрм┐рмХрнН рм▓рм╛рмЗрмЯрнН, рмЯрнНрм░рм╛рмлрм┐рмХрнН рм╕рм┐рмЧрнНтАМрмирм╛рм▓рнН, рмнрнВрм╕рморм╛рмирнНрмдрм░ рмЯрнНрм░рм╛рмлрм┐рмХрнН рм▓рм╛рмЗрмЯрнН, рмнрнВрм╕рморм╛рмирнНрмдрм░ рммрм┐рм╢рм┐рм╖рнНрмЯ рмЯрнНрм░рм╛рмлрм┐рмХрнНтАМ рмЖрм▓рнЛрмХ, рм▓рм╛рмЗрмЯрнН
ЁЯЪж => ЁЯЪж, рмЯрнНрм░рм╛рмлрм┐рмХрнН, рмЯрнНрм░рм╛рмлрм┐рмХрнН рм▓рм╛рмЗрмЯрнН, рмЯрнНрм░рм╛рмлрм┐рмХрнН рм╕рм┐рмЧрнНтАМрмирм╛рм▓рнН, рмнрнВрм▓рморнНрмм рммрм┐рм╢рм┐рм╖рнНрмЯ рмЯрнНрм░рм╛рмлрм┐рмХрнНтАМ рмЖрм▓рнЛрмХ, рмнрнВрм▓рморнНрм╡ рмЯрнНрм░рм╛рмлрм┐рмХрнН рм▓рм╛рмЗрмЯрнН, рм▓рм╛рмЗрмЯрнН
ЁЯЪз => ЁЯЪз, рмЪрм┐рм╣рнНрми, рмирм┐рм░рнНрморм╛рмг, рмирм┐рм░рнНрморм╛рмг рмЪрм┐рм╣рнНрми, рмирм┐рм░рнНрморм╛рмгрмзрм┐рми
ЁЯЫС => ЁЯЫС, рмЕрм╖рнНрмЯрмнрнБрмЬ рммрм┐рм╢рм┐рм╖рнНрмЯ рмЖрмХрнГрмдрм┐, рмЪрм┐рм╣рнНрми, рм╕рнНрмермЧрм┐рмд, рм╕рнНрмермЧрм┐рмд рмЪрм┐рм╣рнНрми
тЪУ => тЪУ, рмЖрмЩрнНрмХрм░рнН, рмПрмЩрнНрмХрм░рнН, рмЪрм┐рм╣рнНрми
тЫ╡ => тЫ╡, рмбрмЩрнНрмЧрм╛, рмирнМрмХрм╛, рмкрм╛рм▓ рмЯрмгрм╛ рмбрмЩрнНрмЧрм╛, рм░рм┐рм╕рм░рнНрмЯрнН, рм╕рморнБрмжрнНрм░ рм░рм┐рм╕рм░рнНрмЯрнН, рм╕рнЗрм▓рнНтАМрммрнЛрмЯрнНтАМ
ЁЯЫ╢ => ЁЯЫ╢, рмирнМрмХрм╛, рм╕рм░рнБрмЖ рм╣рм╛рм▓рмХрм╛ рмбрмЩрнНрмЧрм╛
ЁЯЪд => ЁЯЪд, рмирнМрмХрм╛, рм╕рнНрмкрм┐рмбрнНтАМрммрнЛрмЯрнНтАМ
ЁЯЫ│ => ЁЯЫ│, рмЬрм╛рм╣рм╛рмЬ, рмпрм╛рмдрнНрм░рнА, рмпрм╛рмдрнНрм░рнАрммрм╛рм╣рм┐ рмЬрм╛рм╣рм╛рмЬ
тЫ┤ => тЫ┤, рмбрмЩрнНрмЧрм╛, рмирнМрмХрм╛, рмпрм╛рмдрнНрм░рнА
ЁЯЫе => ЁЯЫе, рмирнМрмХрм╛ ред рморнЛрмЯрм░рммрнЛрмЯрнНтАМ, рморнЛрмЯрм░ рммрнЛрмЯрнНтАМ
ЁЯЪв => ЁЯЪв, рмЬрм╛рм╣рм╛рмЬ, рммрм╛рм╣рм╛рми, рм╕рм┐рмкрнН
тЬИ => тЬИ, рмЙрмбрм╛рмЬрм╛рм╣рм╛рмЬ, рммрм┐рморм╛рми
ЁЯЫй => ЁЯЫй, рмЙрмбрм╛рмЬрм╛рм╣рм╛рмЬ, рмЫрнЛрмЯ рммрм┐рморм╛рми, рммрм┐рморм╛рми
ЁЯЫл => ЁЯЫл, рмЙрмбрм╛рмЬрм╛рм╣рм╛рмЬ, рмЪрнЗрмХрнНтАМ-рмЗрмирнН, рмкрнНрм░рм╕рнНрмерм╛рми, рмкрнНрм░рм╕рнНрмерм╛рмирмЧрнБрмбрм┐рмХ, рммрм┐рморм╛рми, рммрм┐рморм╛рми рмкрнНрм░рм╕рнНрмерм╛рми
ЁЯЫм => ЁЯЫм, рмЕрммрмдрм░рмг рмХрм░рнБрмЫрм┐, рмЖрмЧрморми, рмЙрмбрм╛рмЬрм╛рм╣рм╛рмЬ, рмкрм╣рмЮрнНрмЪрнБрмЫрм┐, рммрм┐рморм╛рми, рммрм┐рморм╛рми рмЖрмЧрморми
ЁЯТ║ => ЁЯТ║, рмЪрнЗрнЯрм╛рм░рнН, рм╕рм┐рмЯрнН
ЁЯЪБ => ЁЯЪБ, рммрм╛рм╣рм╛рми, рм╣рнЗрм▓рм┐рмХрнЗрмкрнНрмЯрм░рнН
ЁЯЪЯ => ЁЯЪЯ, рммрм╛рм╣рм╛рми, рм░рнЗрм▓рн▒рнЗ, рм╕рм╕рмкрнЗрмирм╕рмирнНтАМ рм░рнЗрм▓рн▒рнЗ, рм╕рм╕рнНтАМрмкрнЗрмирнНтАМрм╕рмирнН, рм╕рм╕рнНтАМрмкрнЗрмирнНтАМрм╕рмирнН рм░рнЗрм▓рн▒рнЗ
ЁЯЪа => ЁЯЪа, рмХрм╛рм░рнН, рмХрнЗрммрнБрм▓рнН, рмкрм░рнНрммрмд рмХрнЗрммрнБрм▓рнНтАМрморм╛рм░рнНрмЧ, рммрм╛рм╣рм╛рми, рморм╛рмЙрмгрнНрмЯрнЗрмирнН, рморм╛рмЙрмгрнНрмЯрнЗрмирнН рмХрнЗрммрм▓рнНтАМрн▒рнЗ, рморм╛рмЙрмгрнНрмЯрнЗрмирнН рмХрнЗрммрнБрм▓рнН рмХрм╛рм░рнН
ЁЯЪб => ЁЯЪб, рмПрм░рм┐рмПрм▓рнН, рмПрм░рм┐рмПрм▓рнН рмЯрнНрм░рм╛рморнНтАМрн▒рнЗ, рмХрнЗрммрнБрм▓рнН рмХрм╛рм░рнН, рмЧрнЛрмирмбрнЛрм▓рм╛, рмЯрнНрм░рм╛рморнНтАМрн▒рнЗ, рммрм╛рнЯрммрнАрнЯ рмЯрнНрм░рм╛рморнНтАМрморм╛рм░рнНрмЧ, рммрм╛рм╣рм╛рми, рм░рнЛрмкрн▒рнЗ
ЁЯЫ░ => ЁЯЫ░, рморм╣рм╛рмХрм╛рм╢, рм╕рнНрнЯрм╛рмЯрнЗрм▓рм╛рмЗрмЯрнНтАМ
ЁЯЪА => ЁЯЪА, рммрм╛рм╣рм╛рми, рм░рмХрнЗрмЯрнНтАМ
ЁЯЫ╕ => ЁЯЫ╕, UFO, рмлрнНрм▓рм╛рмЗрмВ рм╕рм╕рм░рнНтАМ
ЁЯЫО => ЁЯЫО, рммрнЗрм▓рм╣рмкрнНтАМ рммрнЗрм▓рнНтАМ, рммрнЗрм▓рнНтАМ, рммрнЗрм▓рнНтАМрм╣рмкрнНтАМ, рм╣рнЛрмЯрнЗрм▓рнНтАМ
ЁЯЪк => ЁЯЪк, рмХрммрм╛рмЯ, рмжрнНрм╡рм╛рм░
ЁЯЫП => ЁЯЫП, рм╢рнЗрмп, рм╢рнЛрмЗрммрм╛, рм╣рнЛрмЯрнЗрм▓рнНтАМ
ЁЯЫЛ => ЁЯЫЛ, рмХрм╛рмЙрмЪрнНтАМ, рмХрм╛рмЙрмЪрнНтАМ рмПрммрмВ рммрмдрм┐, рммрмдрм┐, рм╣рнЛрмЯрнЗрм▓рнНтАМ
ЁЯЪ╜ => ЁЯЪ╜, рмЯрмПрм▓рнЗрмЯрнН, рмкрм╛рмЗрмЦрм╛рмирм╛
ЁЯЪ┐ => ЁЯЪ┐, рм╕рм╛рн▒рм╛рм░рнН
ЁЯЫБ => ЁЯЫБ, рмЧрм╛рмзрнБрмЖ рмХрнБрмгрнНрмб рммрм╛ рммрм╛рмермЯрммрнНтАМ, рммрм╛рмернНтАМрмЯрммрнН
тМЫ => тМЫ, рмЖрн▒рм╛рм░рмЧрнНрм▓рм╛рм╕рнНтАМ рм╕рморм╛рмкрнНрмд рм╣рнЛрмЗрмЫрм┐, рмЖрн▒рм╛рм░рнНтАМрмЧрнНрм▓рм╛рм╕рнН, рммрм╛рм▓рм┐
тП│ => тП│, рмЖрн▒рм╛рм░рмЧрнНрм▓рм╛рм╕рнНтАМ рм╕рморм╛рмкрнНрмд рм╣рнЛрмЗрмирм╛рм╣рм┐рмБ, рмЯрм╛рмЗрморм░рнН, рм╕рнЗрмгрнНрмбрнН рмЯрм╛рмЗрморм░рнН, рм╕рнЗрмгрнНрмбрнН рм╣рм╛рн▒рм╛рм░рнНтАМрмЧрнНрм▓рм╛рм╕рнН, рм╣рм╛рн▒рм╛рм░рнНтАМрмЧрнНрм▓рм╛рм╕рнН
тМЪ => тМЪ, рмШрмбрм┐, рмШрмгрнНрмЯрм╛, рм╣рм╛рмд рмШрмгрнНрмЯрм╛
тП░ => тП░, рмЖрм▓рм╛рм░рнНрмо рмШрмгрнНрмЯрм╛, рмЖрм▓рнНтАМрм░рм╛рморнН, рмЖрм▓рнНтАМрм░рм╛рморнН рмШрмгрнНрмЯрм╛, рмШрмгрнНрмЯрм╛
тП▒ => тП▒, рмШрмгрнНрмЯрм╛, рм╖рнНрмЯрмкрнНтАМрн▒рм╛рмЪрнНтАМ
тП▓ => тП▓, рмШрмгрнНрмЯрм╛, рмЯрм╛рмЗрморм░рнНтАМ, рмЯрм╛рмЗрморм░рнНтАМ рмШрмгрнНрмЯрм╛
ЁЯХ░ => ЁЯХ░, рмШрмгрнНрмЯрм╛, рморм╛рмгрнНрмЯрнЗрм▓рмкрм┐рм╕рнНтАМ рмШрмгрнНрмЯрм╛
ЁЯХЫ => ЁЯХЫ, 12 рмШрмЯрм┐рмХрм╛, 12:00, рмШрмгрнНрмЯрм╛, рммрм╛рм░, рммрм╛рм░рмЯрм╛
ЁЯХз => ЁЯХз, 12:30, рмШрмгрнНрмЯрм╛, рммрм╛рм░рмЯрм╛-рмдрм┐рм░рм┐рм╢, рммрм╛рм░рмЯрм╛-рмдрм┐рм░рм┐рм╢рм┐
ЁЯХР => ЁЯХР, 1 рмШрмЯрм┐рмХрм╛, 1:00, рмПрмХ, рмЧрнЛрмЯрм╛рмП, рмШрмгрнНрмЯрм╛
ЁЯХЬ => ЁЯХЬ, 1:30, рмПрмХ-рмдрм┐рм░рм┐рм╢рм┐, рмЧрнЛрмЯрм╛рмП-рмдрм┐рм░рм┐рм╢, рмШрмгрнНрмЯрм╛
ЁЯХС => ЁЯХС, 2 рмШрмЯрм┐рмХрм╛, 2:00, рмШрмгрнНрмЯрм╛, рмжрнБрмЗ, рмжрнБрмЗрмЯрм╛
ЁЯХЭ => ЁЯХЭ, 2:30, рмШрмгрнНрмЯрм╛, рмжрнБрмЗрмЯрм╛-рмдрм┐рм░рм┐рм╢, рмжрнБрмЗрмЯрм╛-рмдрм┐рм░рм┐рм╢рм┐
ЁЯХТ => ЁЯХТ, 3 рмШрмЯрм┐рмХрм╛, 3:00, рмШрмгрнНрмЯрм╛, рмдрм┐рмирм┐, рмдрм┐рмирм┐рмЯрм╛
ЁЯХЮ => ЁЯХЮ, 3:30, рмШрмгрнНрмЯрм╛, рмдрм┐рмирм┐рмЯрм╛-рмдрм┐рм░рм┐рм╢, рмдрм┐рмирм┐рмЯрм╛-рмдрм┐рм░рм┐рм╢рм┐
ЁЯХУ => ЁЯХУ, 4 рмШрмЯрм┐рмХрм╛, 4:00, рмШрмгрнНрмЯрм╛, рмЪрм╛рм░рм┐, рмЪрм╛рм░рм┐рмЯрм╛
ЁЯХЯ => ЁЯХЯ, 4:30, рмШрмгрнНрмЯрм╛, рмЪрм╛рм░рм┐рмЯрм╛-рмдрм┐рм░рм┐рм╢, рмЪрм╛рм░рм┐рмЯрм╛-рмдрм┐рм░рм┐рм╢рм┐
ЁЯХФ => ЁЯХФ, 5 рмШрмЯрм┐рмХрм╛, 5:00, рмШрмгрнНрмЯрм╛, рмкрм╛рмЮрнНрмЪ, рмкрм╛рмЮрнНрмЪрмЯрм╛
ЁЯХа => ЁЯХа, 5:30, рмШрмгрнНрмЯрм╛, рмкрм╛рмЮрнНрмЪрмЯрм╛-рмдрм┐рм░рм┐рм╢, рмкрм╛рмЮрнНрмЪрмЯрм╛-рмдрм┐рм░рм┐рм╢рм┐
ЁЯХХ => ЁЯХХ, 6 рмШрмЯрм┐рмХрм╛, 6:00, рмШрмгрнНрмЯрм╛, рмЫрмЕ, рмЫрмЕрмЯрм╛
ЁЯХб => ЁЯХб, 6:30, рмШрмгрнНрмЯрм╛, рмЫрмЕрмЯрм╛-рмдрм┐рм░рм┐рм╢, рмЫрмЕрмЯрм╛-рмдрм┐рм░рм┐рм╢рм┐
ЁЯХЦ => ЁЯХЦ, 7 рмШрмЯрм┐рмХрм╛, 7:00, рмШрмгрнНрмЯрм╛, рм╕рм╛рмд, рм╕рм╛рмдрмЯрм╛
ЁЯХв => ЁЯХв, 7:30, рмШрмгрнНрмЯрм╛, рм╕рм╛рмдрмЯрм╛-рмдрм┐рм░рм┐рм╢, рм╕рм╛рмдрмЯрм╛-рмдрм┐рм░рм┐рм╢рм┐
ЁЯХЧ => ЁЯХЧ, 8 рмШрмЯрм┐рмХрм╛, 8:00, рмЖрма, рмЖрмармЯрм╛, рмШрмгрнНрмЯрм╛
ЁЯХг => ЁЯХг, 8:30, рмЖрмармЯрм╛-рмдрм┐рм░рм┐рм╢, рмЖрмармЯрм╛-рмдрм┐рм░рм┐рм╢рм┐, рмШрмгрнНрмЯрм╛
ЁЯХШ => ЁЯХШ, 9 рмШрмЯрм┐рмХрм╛, 9:00, рмШрмгрнНрмЯрм╛, рмирмЕ, рмирмЕрмЯрм╛
ЁЯХд => ЁЯХд, 9:30, рмШрмгрнНрмЯрм╛, рмирмЕрмЯрм╛-рмдрм┐рм░рм┐рм╢рм┐
ЁЯХЩ => ЁЯХЩ, 10 рмШрмЯрм┐рмХрм╛, 10:00, рмШрмгрнНрмЯрм╛, рмжрм╢, рмжрм╢рмЯрм╛
ЁЯХе => ЁЯХе, 10:30, рмШрмгрнНрмЯрм╛, рмжрм╢рмЯрм╛-рмдрм┐рм░рм┐рм╢, рмжрм╢рмЯрм╛-рмдрм┐рм░рм┐рм╢рм┐
ЁЯХЪ => ЁЯХЪ, 11 рмШрмЯрм┐рмХрм╛, 11:00, рмПрмЧрм╛рм░, рмПрмЧрм╛рм░рмЯрм╛, рмШрмгрнНрмЯрм╛
ЁЯХж => ЁЯХж, 11:30, рмПрмЧрм╛рм░рмЯрм╛-рмдрм┐рм░рм┐рм╢, рмПрмЧрм╛рм░рмЯрм╛-рмдрм┐рм░рм┐рм╢рм┐, рмШрмгрнНрмЯрм╛
ЁЯМС => ЁЯМС, рмЕрморммрм╛рм╕рнНрнЯрм╛, рмЧрм╛рмв, рмЪрмирнНрмжрнНрм░, рмирнВрмЖ рмЪрмирнНрмжрнНрм░, рмирнВрмдрми
ЁЯМТ => ЁЯМТ, рмЕрмкрнВрм░рнНрмгрнНрмгрмЪрмирнНрмжрнНрм░, рмЪрмирнНрмжрнНрм░, рммрмврмирнНрмдрм╛, рммрмврмирнНрмдрм╛ рмЪрмирнНрмжрнНрм░, рн▒рнЗрмХрнНрм╕рм┐рмВ рмХрнНрм░рнЗрм╕рнЗрмгрнНрмЯ рморнБрмирнНтАМ
ЁЯМУ => ЁЯМУ, рмЕрм░рнНрмжрнНрмз рмЪрмирнНрмжрнНрм░, рмЪрмирнНрмжрнНрм░, рмкрнНрм░рмермо рмЕрм░рнНрмжрнНрмз рмЪрмирнНрмжрнНрм░, рмкрнНрм░рмермо рмЪрмдрнБрм░рнНрмерм╛рмВрм╢ рмЪрмирнНрмжрнНрм░
ЁЯМФ => ЁЯМФ, рмЕрм░рнНрмжрнНрмзрм░рнБ рмЕрмзрм┐рмХ, рмЕрм░рнНрмжрнНрмзрм░рнБ рмЕрмзрм┐рмХ рмЪрмирнНрмжрнНрм░, рмЪрмирнНрмжрнНрм░, рммрмврмирнНрмдрм╛, рн▒рнЗрмХрнНрм╕рм┐рмВ рмЧрм┐рммрм╕рнНтАМ рморнБрмирнНтАМ, рм╢рнБрмХрнНрм│рмкрмХрнНрм╖ рммрмврмирнНрмдрм╛ рмЪрмирнНрмжрнНрм░
ЁЯМХ => ЁЯМХ, рмЙрмЬрнНрм╡рм│, рмЪрмирнНрмжрнНрм░, рмкрнВрм░рнНрмгрнНрмг, рмкрнВрм░рнНрмгрнНрмг рмЪрмирнНрмжрнНрм░, рмкрнВрм░рнНрмгрнНрмгрм┐рморм╛
ЁЯМЦ => ЁЯМЦ, рмЕрм░рнНрмжрнНрмзрм░рнБ рмЕрмзрм┐рмХ, рмЕрм░рнНрмжрнНрмзрм░рнБ рмЕрмзрм┐рмХ рмЪрмирнНрмжрнНрм░, рмЪрмирнНрмжрнНрм░, рморм│рм┐рми, рморм│рм┐рми рмЪрмирнНрмжрнНрм░, рн▒рнЗрмирм┐рмВ рмЧрм┐рммрм╕рнНтАМ рморнБрмирнНтАМ
ЁЯМЧ => ЁЯМЧ, рмЕрм░рнНрмжрнНрмз рмЪрмирнНрмжрнНрм░, рмХрнГрм╖рнНрмгрмкрмХрнНрм╖ рмЪрмирнНрмжрнНрм░, рмЪрмирнНрмжрнНрм░, рм╢рнЗрм╖ рмЪрмдрнБрм░рнНрмерм╛рмВрм╢ рмЪрмирнНрмжрнНрм░
ЁЯМШ => ЁЯМШ, рмЕрмкрнВрм░рнНрмгрнНрмг, рмЕрмкрнВрм░рнНрмгрнНрмгрмЪрмирнНрмжрнНрм░, рмЪрмирнНрмжрнНрм░, рморм│рм┐рми, рморм│рм┐рми рмЪрмирнНрмжрнНрм░, рн▒рнЗрмирм┐рмВ рмХрнНрм░рнЗрм╕рнЗрмгрнНрмЯ рморнБрмирнНтАМ
ЁЯМЩ => ЁЯМЩ, рмЕрмкрнВрм░рнНрмгрнНрмг, рмЕрмкрнВрм░рнНрмгрнНрмгрмЪрмирнНрмжрнНрм░, рмХрнНрм░рм┐рм╕рнЗрмгрнНрмЯрнН рморнБрмирнН, рмЪрмирнНрмжрнНрм░
ЁЯМЪ => ЁЯМЪ, рмЕрморм╛рммрм╛рм╕рнНрнЯрм╛, рмЕрморм╛рммрм╛рм╕рнНрнЯрм╛ рморнБрмЦ, рмЪрмирнНрмжрнНрм░, рмирнВрмЖ рмЪрмирнНрмжрнНрм░ рморнБрм╣рмБ, рморнБрмЦ, рморнБрмЦ рм╕рм╣рм┐рмд рмЕрморм╛рммрм╛рм╕рнНрнЯрм╛
ЁЯМЫ => ЁЯМЫ, рмЕрм░рнНрмжрнНрмз рмЪрмирнНрмжрнНрм░, рмЕрм░рнНрмжрнНрмз рмЪрмирнНрмжрнНрм░ рморнБрмЦ, рмЪрмирнНрмжрнНрм░, рмкрнНрм░рмермо рмЕрм░рнНрмжрнНрмз рмЪрмирнНрмжрнНрм░, рмкрнНрм░рмермо рмЪрмдрнБрм░рнНрмерм╛рмВрм╢ рмЪрмирнНрмжрнНрм░ рморнБрм╣рмБ, рморнБрмЦ, рморнБрмЦ рм╕рм╣рм┐рмд рмЕрм░рнНрмжрнНрмз рмЪрмирнНрмжрнНрм░, рморнБрмЦ рм╕рм╣рм┐рмд рмЪрмирнНрмжрнНрм░
ЁЯМЬ => ЁЯМЬ, рмЕрм░рнНрмжрнНрмз рмЪрмирнНрмжрнНрм░, рмЕрм░рнНрмжрнНрмз рмЪрмирнНрмжрнНрм░ рморнБрмЦ, рмЪрмирнНрмжрнНрм░, рморнБрмЦ, рморнБрмЦ рм╕рм╣рм┐рмд рмЕрм░рнНрмжрнНрмз рмЪрмирнНрмжрнНрм░, рморнБрмЦ рм╕рм╣рм┐рмд рмЪрмирнНрмжрнНрм░, рм╢рнЗрм╖ рмЕрм░рнНрмжрнНрмз рмЪрмирнНрмжрнНрм░, рм╢рнЗрм╖ рмЪрмдрнБрм░рнНрмерм╛рмВрм╢ рмЪрмирнНрмжрнНрм░ рморнБрм╣рмБ
ЁЯМб => ЁЯМб, рмерм░рнНрморнЛрморм┐рмЯрм░
тША => тША, рмЙрмЬрнНрмЬрнНрн▒рм│, рмХрм┐рм░рмг, рмЦрм░рм╛рмЯрм┐рмЖ, рм╕рнВрм░рнНрмпрнНрнЯ
ЁЯМЭ => ЁЯМЭ, рмЪрмирнНрмжрнНрм░, рмкрнВрм░рнНрмгрнНрмг, рмкрнВрм░рнНрмгрнНрмг рмЪрмирнНрмжрнНрм░ рморнБрм╣рмБ, рмкрнВрм░рнНрмгрнНрмгрм┐рморм╛, рмкрнВрм░рнНрмгрнНрмгрм┐рморм╛ рморнБрмЦ, рморнБрмЦ, рморнБрмЦ рм╕рм╣рм┐рмд рмЪрмирнНрмжрнНрм░, рморнБрмЦ рм╕рм╣рм┐рмд рмкрнВрм░рнНрмгрнНрмгрм┐рморм╛
ЁЯМЮ => ЁЯМЮ, рморнБрмЦ, рморнБрм╣рмБ рм╕рм╣рм┐рмд рм╕рнВрм░рнНрмпрнНрнЯ, рм╕рнВрм░рнНрмпрнНрнЯ, рм╕рнВрм░рнНрмпрнНрнЯ рморнБрмЦ
тнР => тнР, рмдрм╛рм░рм╛, рмзрм│рм╛ рмормзрнНрнЯрмо рмдрм╛рм░рм╛
ЁЯМЯ => ЁЯМЯ, рмЙрмЬрнНрмЬрнНрн▒рм│ рмдрм╛рм░рм╛, рмЪрмормХ, рмЪрмормХрнБрмерм┐рммрм╛, рмЪрмормХрнБрмерм┐рммрм╛ рмдрм╛рм░рм╛, рмдрм╛рм░рм╛
ЁЯМа => ЁЯМа, рмЙрм▓рмХрм╛, рмЙрм▓рмХрм╛ рмдрм╛рм░рм╛, рмЙрм▓рмХрм╛рмдрм╛рм░рм╛, рмдрм╛рм░рм╛
тШБ => тШБ, рмкрм╛рмгрм┐рмкрм╛рмЧ, рморнЗрмШ
тЫЕ => тЫЕ, рморнЗрмШ, рморнЗрмШ рмкрмЫрм░рнЗ рм╕рнВрм░рнНрмпрнНрнЯ, рм╕рнВрм░рнНрмпрнНрнЯ, рм╕рнВрм░рнНрмпрнНрнЯ рм╕рм╣рм┐рмд рморнЗрмШ
тЫИ => тЫИ, рмШрмбрмШрмбрм┐, рммрм░рнНрм╖рм╛, рммрм┐рмЬрнБрм│рм┐ рмПрммрмВ рммрм░рнНрм╖рм╛ рм╕рм╣рм┐рмд рморнЗрмШ, рморнЗрмШ
ЁЯМд => ЁЯМд, рмЫрнЛрмЯ рморнЗрмШ рмкрмЫрм░рнЗ рм╕рнВрм░рнНрмпрнНрнЯ, рморнЗрмШ, рм╕рнВрм░рнНрмпрнНрнЯ
ЁЯМе => ЁЯМе, рммрмб рморнЗрмШ рмкрмЫрм░рнЗ рм╕рнВрм░рнНрмпрнНрнЯ, рморнЗрмШ, рм╕рнВрм░рнНрмпрнНрнЯ
ЁЯМж => ЁЯМж, рммрм░рнНрм╖рм╛, рммрм░рнНрм╖рм╛ рммрм╛рмжрм│ рмкрмЫрм░рнЗ рм╕рнВрм░рнНрмпрнНрнЯ, рморнЗрмШ, рм╕рнВрм░рнНрмпрнНрнЯ
ЁЯМз => ЁЯМз, рммрм░рнНрм╖рм╛, рммрм░рнНрм╖рм╛ рм╕рм╣рм┐рмд рморнЗрмШ, рморнЗрмШ
ЁЯМи => ЁЯМи, рмермгрнНрмбрм╛, рммрм░рмл, рммрм░рмл рм╕рм╣рм┐рмд рморнЗрмШ, рморнЗрмШ
ЁЯМй => ЁЯМй, рммрм┐рмЬрнБрм│рм┐, рммрм┐рмЬрнБрм│рм┐ рм╕рм╣рм┐рмд рморнЗрмШ, рморнЗрмШ
ЁЯМк => ЁЯМк, рмШрнВрм░рнНрмгрнНрмгрм┐рммрм╛рнЯрнБ, рмкрнНрм░рммрм│ рмдрнЛрмлрм╛рми, рморнЗрмШ
ЁЯМл => ЁЯМл, рмХрнБрм╣рнБрмбрм┐, рморнЗрмШ
ЁЯМм => ЁЯМм, рмЙрмбрм╛рмЗрммрм╛, рмкрммрми, рмкрммрми рморнБрм╣рмБ, рморнБрм╣рмБ, рморнЗрмШ
ЁЯМА => ЁЯМА, рмШрнВрм░рнНрмгрнНрмгрм┐рммрм╛рнЯрнБ, рмЯрм╛рмЗрмлрнЛрмирнН, рмдрнЛрмлрм╛рми, рммрм╛рмдрнНрнЯрм╛, рммрм╛рнЯрнБ рмШрнБрм░рнНрмгрнНрмгрми
ЁЯМИ => ЁЯМИ, рмЗрмирнНрмжрнНрм░рмзрмирнБ, рммрм░рнНрм╖рм╛
ЁЯМВ => ЁЯМВ, рмЫрмдрм╛, рммрмирнНрмж рмерм┐рммрм╛ рмЫрмдрм╛, рммрм░рнНрм╖рм╛, рммрм░рнНрм╖рм╛ рмжрм┐рмирм┐рмЖ
тШВ => тШВ, рмЫрмдрм╛, рммрм░рнНрм╖рм╛, рм▓рнБрмЧрм╛рмкрмЯрм╛
тШФ => тШФ, рмЫрмдрм╛, рммрм░рнНрм╖рм╛, рммрм░рнНрм╖рм╛ рммрм┐рмирнНрмжрнБ рм╕рм╣рм┐рмд рмЫрмдрм╛, рммрм┐рмирнНрмжрнБ, рм▓рнБрмЧрм╛рмкрмЯрм╛
тЫ▒ => тЫ▒, рмЫрмдрм╛, рммрм░рнНрм╖рм╛, рмнрнВрморм┐рм░рнЗ рмЫрмдрм╛, рм╕рнВрм░рнНрмпрнНрнЯ
тЪб => тЪб, рмЙрмЪрнНрмЪ, рмЙрмЪрнНрмЪ рмнрнЛрм▓рмЯрнЗрмЬрнН, рмЙрмЪрнНрмЪ рмнрнЛрм▓рмЯрнЗрмЬрнН рмЪрм┐рм╣рнНрми, рмЙрмЪрнНрмЪ рмнрнЛрм▓рмЯрнЗрмЬрнН рммрм┐рмкрмжрмдрм╛, рмЙрмЪрнНрмЪ рмнрнЛрм▓рнНрмЯрнЗрмЬрнНтАМ, рмЪрм┐рм╣рнНрми, рммрм┐рмкрмж, рмнрнЛрм▓рмЯрнЗрмЬрнН
тЭД => тЭД, рмдрнБрм╖рм╛рм░рмХрмгрм╛, рмермгрнНрмбрм╛, рммрм░рмл
тШГ => тШГ, рмермгрнНрмбрм╛, рммрм░рмл, рм╕рнНрмирнЛрморнНрнЯрм╛рмирнНтАМ
тЫД => тЫД, рммрм░рмл, рммрм░рмл рммрм┐рмирм╛ рм╕рнНрмирнЛрморнЗрмирнН, рм╕рнНрмирнЛрморнЗрмирнН
тШД => тШД, рмзрнВрмормХрнЗрмдрнБ, рморм╣рм╛рмХрм╛рм╢
ЁЯФе => ЁЯФе, рмЭрм╛рм╕, рмирм┐рмЖрмБ
ЁЯТз => ЁЯТз, рмХрморм┐рмХрнН, рмЫрнЛрмЯ рммрнБрмирнНрмжрм╛, рмЭрм╛рм│, рмЭрм╛рм│ рммрнЛрм╣рм┐рммрм╛, рмермгрнНрмбрм╛ рмЭрм╛рм│
ЁЯМК => ЁЯМК, рмЬрм│ рмдрм░рмЩрнНрмЧ, рмкрм╛рмгрм┐ рм▓рм╣рмбрм┐, рм▓рм╣рмбрм┐, рм╕рм╛рмЧрм░ рм▓рм╣рмбрм┐
ЁЯОГ => ЁЯОГ, рмЙрмдрнНрм╕рмм, рмХрмЦрм╛рм░рнБ, рмЬрнНрнЯрм╛рмХрнН-рмУ-рм▓рмгрнНрмарми, рм▓рмгрнНрмарми, рм╣рм╛рм▓рнНрм▓рнЛрн▒рм┐рмирнНтАМ
ЁЯОД => ЁЯОД, рмЙрмдрнНрм╕рмм, рмЦрнНрм░рнАрм╖рнНрмарморм╛рм╕ рммрнГрмХрнНрм╖, рммрнГрмХрнНрм╖
ЁЯОЖ => ЁЯОЖ, рмЖрмдрм╕рммрм╛рмЬрнА, рмЙрмдрнНрм╕рмм
ЁЯОЗ => ЁЯОЗ, рмЖрмдрм╕рммрм╛рмЬрнА, рмЖрмдрм╕рммрм╛рмЬрнА рмЪрмормХ, рмЙрмдрнНрм╕рмм, рмЭрнБрм░рнНтАМтАМрмЭрнБрм░рнА рммрм╛рмг
тЬи => тЬи, рмЪрмормХрм┐рммрм╛, рмЪрмормХрм┐рм▓рм╛ рмдрм╛рм░рм╛, рмдрм╛рм░рм╛, рм╕рнНрмкрм╛рм░рнНрмХрм▓рнЗрм╕рнН
ЁЯОИ => ЁЯОИ, рмЙрмдрнНрм╕рмм, рммрнЗрм▓рнБрмирнНтАН
ЁЯОЙ => ЁЯОЙ, рмЙрмдрнНрм╕рмм, рмкрмкрм░рнНтАМ, рмкрм╛рм░рнНрмЯрм┐, рмкрм╛рм░рнНрмЯрм┐ рмкрмкрм░рнНтАН
ЁЯОК => ЁЯОК, рмЙрмдрнНрм╕рмм, рмХрмирмлрнЗрмЯрм┐, рмХрмирмлрнЗрмЯрм┐ рммрм▓рнНтАМ, рмХрмирнЗрмлрнЗрмЯрм┐ рммрм▓рнНтАН, рммрм▓рнНтАМ
ЁЯОЛ => ЁЯОЛ, рмЙрмдрнНрм╕рмм, рмХрм╛рмЧрмЬ рмкрмЯрм┐, рмЧрмЫ, рмЧрмЫ рмПрммрмВ рмХрм╛рмЧрмЬ рмкрмЯрм┐, рмЯрм╛рмирм╛рммрм╛рмЯрм╛ рмЧрмЫ, рм╖рнНрмЯрм╛рм░рнНтАМ рмЙрмдрнНрм╕рмм
ЁЯОН => ЁЯОН, рмЙрмдрнНрм╕рмм, рмЬрм╛рмкрм╛рмирнА, рмирнВрмЖ рммрм░рнНрм╖, рмкрм╛рмЗрмирнНтАМ, рмкрм╛рмЗрмирнНтАН рм╕рм╛рмЬрм╕рмЬрнНрмЬрм╛
ЁЯОО => ЁЯОО, рмЙрмдрнНрм╕рмм, рмХрмгрнНрмврнЗрмЗ рмЙрмдрнНрм╕рмм, рмХрмгрнНрмврнЗрмЗрмЧрнБрмбрм┐рмХ, рмЬрм╛рмкрм╛рмирнА, рмЬрм╛рмкрм╛рмирнА рмХрмгрнНрмврнЗрмЗрмЧрнБрмбрм┐рмХ
ЁЯОП => ЁЯОП, рмЙрмдрнНрм╕рмм, рмХрм╛рм░рнНрмкрнНтАН рм╖рнНрмЯрнНрм░рм┐рморм░рнНтАН, рм╖рнНрмЯрнНрм░рм┐рморм░рнНтАМ
ЁЯОР => ЁЯОР, рмЭрмЩрнНрмХрм╛рм░, рмкрммрми рмШрмгрнНрмЯрм┐, рмкрммрми рмЭрмЩрнНрмХрм╛рм░
ЁЯОС => ЁЯОС, рмЙрмдрнНрм╕рмм, рмХрнБрморм╛рм░ рмкрнВрм░рнНрмгрнНрмгрм┐рморм╛, рмЪрмирнНрмжрнНрм░, рмЪрмирнНрмжрнНрм░ рмжрм░рнНрм╢рми, рмЪрм╛рмирнНрмж рмжрнЗрмЦрм┐рммрм╛ рмкрм░рнНрмм, рмжрм░рнНрм╢рми
ЁЯОА => ЁЯОА, рмЙрмдрнНрм╕рмм, рм░рм┐рммрмирнНтАН, рм░рнЗрм╢рмо рмлрм┐рмдрм╛
ЁЯОБ => ЁЯОБ, рмЙрмдрнНрм╕рмм, рмЙрмкрм╣рм╛рм░, рмЧрнБрмбрм╛ рмпрм╛рмЗрмерм┐рммрм╛ рмЙрмкрм╣рм╛рм░, рмЧрнБрмбрм╛ рм╣рнЛрмЗрмЫрм┐, рмЧрнБрмбрм╛ рм╣рнЛрмЗрмерм┐рммрм╛ рмЙрмкрм╣рм╛рм░
ЁЯОЧ => ЁЯОЧ, рмЙрмдрнНрм╕рмм ред рм╕рнНрморм╛рм░рмХ ред рм░рм┐рммрмирнНтАН, рм╕рнНрморм╛рм░рмХ рм░рм┐рммрмирнНтАН
ЁЯОЯ => ЁЯОЯ, рмЖрмбрморм┐рм╕рми ред рмЯрм┐рмХрнЗрмЯрнНтАН, рмЖрмбрморм┐рм╕рми ред рмЯрм┐рмХрнЗрмЯрнНтАНрмЧрнБрмбрм┐рмХ
ЁЯОл => ЁЯОл, рмЯрм┐рмХрнЗрмЯрнНтАН, рмормирнЛрм░рмЮрнНрмЬрми
ЁЯОЦ => ЁЯОЦ, рмЙрмдрнНрм╕рмм ред рмкрмжрмХ ред рм╕рнЗрмирм╛, рм╕рнЗрмирм╛ рмкрмжрмХ
ЁЯПЖ => ЁЯПЖ, рмЯрнНрм░рмлрм┐, рмкрнБрм░рм╕рнНрмХрм╛рм░
ЁЯПЕ => ЁЯПЕ, рмХрнНрм░рнАрмбрм╛ рмкрмжрмХ, рмкрмжрмХ
ЁЯеЗ => ЁЯеЗ, 1рмо рм╕рнНрмерм╛рми рмкрмжрмХ, рмкрнНрм░рмермо ред рм╕рнНрн▒рм░рнНрмгрнНрмг ред рмкрмжрмХ
ЁЯеИ => ЁЯеИ, 2рнЯ рм╕рнНрмерм╛рми рмкрмжрмХ, рмкрмжрмХ ред рмжрнНрн▒рм┐рмдрнАрнЯ ред рм░рнМрмкрнНрнЯ
ЁЯеЙ => ЁЯеЙ, 3рнЯ рм╕рнНрмерм╛рми рмкрмжрмХ, рммрнНрм░рнЛрмЮрнНрмЬ ред рмкрмжрмХ ред рмдрнГрмдрнАрнЯ
тЪ╜ => тЪ╜, рммрм▓рнН, рм╕рмХрм░рнНтАН рммрм▓рнНтАН, рм╕рнЛрмХрм░рнН, рм╕рнЛрмХрм░рнН рммрм▓рнН
тЪ╛ => тЪ╛, рммрнЗрм╕рммрм▓рнНтАН, рммрнЗрм╕рнНтАМрммрм▓рнН
ЁЯПА => ЁЯПА, рмХрнНрм░рнАрмбрм╛, рмЧрнЛрм▓рм╛рмХрм╛рм░ рмкрмЯрм┐, рммрм▓рнНтАМ, рммрм╛рм╕рнНрмХрнЗрмЯрммрм▓, рммрм╛рм╕рнНрмХрнЗрмЯрммрм▓ рмЦрнЗрм│рм░ рмЧрнЛрм▓рм╛рмХрм╛рм░ рмкрмЯрм┐, рммрм╛рм╕рнНрмХрнЗрмЯрммрм▓рнНтАН
ЁЯПР => ЁЯПР, рммрм▓рнНтАН ред рмЦрнЗрм│, рмнрм▓рм┐рммрм▓рнНтАН
ЁЯПИ => ЁЯПИ, рмЖрморнЗрм░рм┐рмХрнАрнЯ, рмЖрморнЗрм░рм┐рмХрнАрнЯ рмлрнБрмЯрммрм▓рнНтАН, рмХрнНрм░рнАрмбрм╛, рммрм▓рнНтАМ
ЁЯПЙ => ЁЯПЙ, рмХрнНрм░рнАрмбрм╛, рмлрнБрмЯрммрм▓, рммрм▓рнНтАМ, рм░рмЧрммрм┐ рмлрнБрмЯрммрм▓рнНтАН, рм╕рмХрм░рнНтАМ рммрм▓рнНтАМ
ЁЯО╛ => ЁЯО╛, рмХрнНрм░рнАрмбрм╛, рмЯрнЗрмирм┐рм╕рнНтАН, рмЯрнЗрмирм┐рм╕рнНтАМ рммрм▓рнНтАМ, рмЯрнЗрмирм┐рм╕рнНтАМ рм░рнЗрмХрнЗрмЯрнНтАМ рмПрммрмВ рммрм▓рнНтАМ
ЁЯО▒ => ЁЯО▒, рмЖрмарнЛрмЯрм┐ рммрм▓рнНтАМ, рмЦрнЗрм│, рмлрнБрм▓рнНтАН 8 рммрм▓рнНтАН, рммрм┐рм▓рм┐рнЯрм╛рм░рнНрмб
ЁЯО│ => ЁЯО│, рмЦрнЗрм│, рмлрм┐рмЩрнНрмЧрм╛ рммрм▓рнНтАМ, рмлрм┐рмЩрнНрмЧрм┐рммрм╛, рммрм▓рнНтАМ, рммрнЛрм▓рм┐рмВ
ЁЯПП => ЁЯПП, рмХрнНрм░рм┐рмХрнЗрмЯрнНтАН рмЦрнЗрм│, рммрм▓рнНтАН ред рммрнНрнЯрм╛рмЯрнНтАН ред рмЦрнЗрм│
ЁЯПС => ЁЯПС, рмлрм┐рм▓рнНрмб рм╣рмХрм┐, рммрм▓рнНтАН ред рмкрмбрм┐рмЖ ред рмЦрнЗрм│ ред рм╣рмХрм┐ ред рммрм╛рмбрм┐
ЁЯПТ => ЁЯПТ, рмЖрмЗрм╕рнНтАН рм╣рмХрм┐, рмЦрнЗрм│ ред рм╣рмХрм┐ ред рммрм░рмл ред рмкрнБрмХрнНтАН ред рммрм╛рмбрм┐
ЁЯПУ => ЁЯПУ, рмЦрнЗрм│, рмЯрнЗрммрнБрм▓рнНтАН рмЯрнЗрмирм┐рм╕рнНтАН, рмкрм┐рмЩрнНрмЧ рмкрмЩрнНрмЧ, рмкрнНрнЯрм╛рмбрм▓рнНтАН, рммрм▓рнНтАН, рммрнНрнЯрм╛рмЯрнНтАН
ЁЯП╕ => ЁЯП╕, рммрм╛рм░рнНрмбрм┐ ред рмЦрнЗрм│ ред рм░рм╛рмХрнНрн▒рнЗрмЯрнНтАН ред рм╕рмЯрм▓рнНтАНрмХрмХрнНтАН, рммрнНрнЯрм╛рмбрморм┐рмгрнНрмЯрми
ЁЯеК => ЁЯеК, рммрмХрнНрм╕рм┐рмВ ред рмЧрнНрм▓рнЛрмнрнНтАН, рммрмХрнНрм╕рм┐рмВ рмЧрнНрм▓рнЛрмнрнНтАН
ЁЯеЛ => ЁЯеЛ, рмЬрнБрмбрнЛ ред рмХрм░рм╛рмЯрнЗ ред рмЯрм╛рмЗрмХрнЛрмгрнНрмбрнЛ ред рморм╛рм░рнНрм╕рм╛рм▓рнНтАН рмЖрм░рнНрмЯрнНрм╕ ред рнЯрнБрмирм┐рмлрм░рнНрмо, рморм╛рм░рнНрм╢рм╛рм▓рнНтАН рмЖрм░рнНрмЯрнНрм╕ рнЯрнБрмирм┐рмлрм░рнНрмо
ЁЯеЕ => ЁЯеЕ, рмЧрнЛрм▓рнНтАН ред рмирнЗрмЯрнНтАН, рмЧрнЛрм▓рнНтАН рмирнЗрмЯрнНтАН
ЁЯОп => ЁЯОп, рмЦрнЗрм│, рмарм┐рмХрнНтАМ рм▓рмХрнНрм╖рнНрнЯрм╕рнНрмерм│рм░рнЗ, рмбрм╛рмЗрм░рнЗрмХрнНрмЯ рм╣рм┐рмЯрнНтАН, рммрм╛рмЬрм┐рммрм╛, рм▓рмХрнНрм╖рнНрнЯрм╕рнНрмерм│, рм▓рмХрнНрм╖рнНрнЯрм╕рнНрмерм│рм░ рмХрнЗрмирнНрмжрнНрм░, рм╕рм┐рмзрм╛рм╕рм│рмЦ рммрм╛рмЬрм┐рммрм╛
тЫ│ => тЫ│, рмЧрм▓рнНрмл, рмЧрм▓рнНрмл рмкрмдрм╛рмХрм╛, рмЧрм╛рмд, рмЧрм╛рмдрм░рнЗ рмкрмдрм╛рмХрм╛
тЫ╕ => тЫ╕, рмЖрмЗрм╕рнНтАН рм╕рнНрмХрнЗрмЯрнНтАН, рммрм░рмл ред рм╕рнНрмХрнЗрмЯрнНтАН
ЁЯОг => ЁЯОг, рмЦрморнНрмм, рмЪрм┐рмдрнНрмдрммрм┐рмирнЛрмжрми, рмормирнЛрм░рмЮрнНрмЬрми, рморм╛рмЫ, рморм╛рмЫ рмзрм░рм┐рммрм╛, рморм╛рмЫ рмзрм░рм┐рммрм╛ рмкрм╛рмЗрмБ рмЦрморнНрмм, рморм╛рмЫрморм░рм╛ рмЦрморнНрмм
ЁЯО╜ => ЁЯО╜, рмХрнНрм░рнАрмбрм╛, рмЪрм│рморм╛рми, рмжрнМрмб рм╕рм╛рм░рнНрмЯрнНтАН, рм░рмирм┐рмВ рм╕рм╛рм░рнНрмЯтАМ, рм╕рм╛рм░рнНрмЯ, рм╕рнНрнЯрм╛рм╢рнНтАМ, рм╕рнНрнЯрм╛рм╢рнНтАМ рм╕рм╣рм┐рмд рм░рмирм┐рмВ рм╕рм╛рм░рнНрмЯ
ЁЯО┐ => ЁЯО┐, рмХрнНрм░рнАрмбрм╛, рммрнБрмЯрнН, рм╕рнНрмХрм╛рмЗ, рм╕рнНрмХрм╛рмЗ рмПрммрмВ рммрнБрмЯрнНтАМ, рм╕рнНрмХрм┐
ЁЯЫ╖ => ЁЯЫ╖, рм╕рнНрм▓рнЗрмЬрнНтАН ред рм╕рнНрм▓рнЗрмЬрнНтАН, рм╕рнНрм▓рнЗрмбрнНтАН
ЁЯеМ => ЁЯеМ, рммрмЩрнНрмХрм╛ рмкрмерм░, рммрмб рмкрмерм░ ред рмЦрнЗрм│
ЁЯОо => ЁЯОо, рмЦрнЗрм│, рмЦрнЗрм│ рмирм┐рнЯрмирнНрмдрнНрм░рмХ, рмирм┐рнЯрмирнНрмдрнНрм░рмХ, рмнрм┐рмбрм┐рмУ рмЧрнЗрморнНтАН
ЁЯХ╣ => ЁЯХ╣, рмЦрнЗрм│ ред рмнрм┐рмбрм┐рмУ рмЧрнЗрморнНтАН, рмЬрнЯрм╖рнНрмЯрм┐рмХрнНтАН
ЁЯО▓ => ЁЯО▓, рмЦрнЗрм│, рмЧрнЗрморнНтАН рмбрм╛рмЗ, рмкрм╢рм╛рмХрм╛рмарм┐, рморм░рм┐рммрм╛, рм▓рнБрмбрнБ
тЩа => тЩа, рмХрм╛рм░рнНрмб ред рмЦрнЗрм│, рм╕рнНрмкрнЗрмбрнНтАН рм╕рнБрмЯрнНтАН
тЩе => тЩе, рмХрм╛рм░рнНрмб ред рмЦрнЗрм│, рм╣рм╛рм░рнНрмЯрнНтАН рм╕рнБрмЯрнНтАН
тЩж => тЩж, рмХрм╛рм░рнНрмб ред рмЦрнЗрм│, рмбрм╛рмПрмормгрнНрмб рм╕рнБрмЯрнНтАН
тЩг => тЩг, рмХрм╛рм░рнНрмб ред рмЦрнЗрм│, рмХрнНрм▓рммрнНтАН рм╕рнБрмЯрнНтАН
ЁЯГП => ЁЯГП, рмХрм╛рм░рнНрмбрнН, рмЬрнЛрмХрм░рнНтАН, рмЬрнЛрмХрм░рнН рмХрм╛рм░рнНрмбрнН, рмкрнНрм▓рнЗрнЯрм┐рмВ рмХрм╛рм░рнНрмбрнН
ЁЯАД => ЁЯАД, рмЯрм╛рмЗрм▓рнН, рмбрнНрм░рм╛рмЧрмирнН, рморм╣рмЬрнЛрмЩрнНрмЧ, рморм╣рмЬрнЛрмЩрнНрмЧ рмЯрм╛рмЗрм▓рнН, рморм╣рмЬрнЛрмЩрнНрмЧ рм▓рм╛рм▓ рмбрнНрм░рм╛рмЧрмирнНтАН, рм▓рм╛рм▓рнН рмбрнНрм░рм╛рмЧрмирнН
ЁЯО┤ => ЁЯО┤, рмХрм╛рм░рнНрмб, рмХрм╛рм░рнНрмб рмЦрнЗрм│, рмЦрнЗрм│, рмдрм╛рм╕, рмлрнБрм▓, рмлрнБрм▓ рмдрм╛рм╕, рмлрнНрм▓рм╛рн▒рм╛рм░рнНтАМ рмХрм╛рм░рнНрмб, рм╣рм╛рмирм╛рмлрнБрмбрм╛
ЁЯФЗ => ЁЯФЗ, рмХрмерм╛ рмирмХрм╣рм┐рммрм╛, рмжрнЯрм╛рмХрм░рм┐ рм╢рм╛рмирнНрмд рм░рнБрм╣рмирнНрмдрнБ, рммрм╛рмдрм┐рм▓рнН рмЪрм┐рм╣рнНрми рм╕рм╣рм┐рмд рм╕рнНрмкрм┐рмХрм░рнН, рморнНрнЯрнБрмЯрнНтАМ рм╣рнЛрмЗрмерм┐рммрм╛ рм╕рнНрмкрм┐рмХрм░рнНтАМ, рм╢рм╛рмирнНрмд
ЁЯФИ => ЁЯФИ, рмХрморнНтАМ рмзрнНрн▒рмирм┐ рммрм┐рм╢рм┐рм╖рнНрмЯ рм╕рнНрмкрм┐рмХрм░рнНтАМ, рм▓рм╛рмЙрмбрнНтАМрм╕рнНрмкрм┐рмХрм░рнН, рм╕рнНрмкрм┐рмХрм░рнН
ЁЯФЙ => ЁЯФЙ, рмХрморнН, рмХрморнН рмнрм▓рнНрнЯрнБрморнН, рмХрморнН рмнрм▓рнНрнЯрнБрморнН рм╕рм╣рм┐рмд рм╕рнНрмкрм┐рмХрм░рнН, рмормзрнНрнЯрмо рмзрм░рмгрм░ рмзрнНрн▒рмирм┐ рм╕рнНрмкрм┐рмХрм░рнНтАМ, рм╕рнНрмкрм┐рмХрм░рнН
ЁЯФК => ЁЯФК, рмЙрмЪрнНрмЪ, рмЙрмЪрнНрмЪ рмзрнНрн▒рмирм┐ рммрм┐рм╢рм┐рм╖рнНрмЯ рм╕рнНрмкрм┐рмХрм░рнНтАМ, рмЙрмЪрнНрмЪ рмнрм▓рнНрнЯрнБрморнН, рм▓рм╛рмЙрмбрнН рмнрм▓рнНрнЯрнБрморнН рм╕рм╣рм┐рмд рм╕рнНрмкрм┐рмХрм░рнН, рм╕рнНрмкрм┐рмХрм░рнН
ЁЯУв => ЁЯУв, рмпрнЛрмЧрм╛рмпрнЛрмЧ, рм▓рм╛рмЙрмбрм╕рнНрмкрм┐рмХрм░рнН, рм▓рм╛рмЙрмбрнНтАМрм╕рнНрмкрм┐рмХрм░рнН, рм╕рм░рнНрммрм╕рм╛рмзрм╛рм░рмг рмарм┐рмХрмгрм╛, рм╣рнНрнЯрм╛рмгрнНрмбрнН рм╕рнНрмкрм┐рмХрм░рнН
ЁЯУг => ЁЯУг, рмЪрм┐рнЯрм░рм┐рмВ, рморнЗрмЧрм╛рмлрнЛрмирнНтАМ, рмпрнЛрмЧрм╛рмпрнЛрмЧ
ЁЯУп => ЁЯУп, рмкрнЛрм╖рнНрмЯрм╛рм▓рнН, рмкрнЛрм╖рнНрмЯрм╛рм▓рнН рм╣рм░рнНрмгрнНрмг, рмкрнЛрм╖рнНрмЯрм╛рм▓рнНтАМ рм╣рм░рнНрмирнНтАМ, рм╣рм░рнНрмгрнНрмг
ЁЯФФ => ЁЯФФ, рмШрмгрнНрмЯрм┐
ЁЯФХ => ЁЯФХ, рмХрнМрмгрм╕рм┐ рммрнЗрм▓рнН рмирм╛рм╣рм┐рмБ, рмХрнМрмгрм╕рм┐ рм╕рм╛рмЙрмгрнНрмбрнН рмирм╛рм╣рм┐рмБ, рммрм╛рмдрм┐рм▓рнНтАМрмХрм░рмг рмЪрм┐рм╣рнНрми рм╕рм╣рм┐рмд рммрнЗрм▓рнН, рммрнЗрм▓рнН, рм╕рнНрм▓рм╛рм╢рнНтАМ рм╕рм╣рм┐рмд рмШрмгрнНрмЯрм┐
ЁЯО╝ => ЁЯО╝, рм╕рмЩрнНрмЧрнАрмд, рм╕рмЩрнНрмЧрнАрмд рм╕рморнНрммрмирнНрмзрнАрнЯ рм╕рнНрмХрнЛрм░рнНтАМ, рм╕рмЩрнНрмЧрнАрмд рм╕рнНрмХрнЛрм░рнНтАМ, рм╕рнНрмХрнЛрм░рнНтАМ
ЁЯО╡ => ЁЯО╡, рм╕рмЩрнНрмЧрнАрмд, рм╕рмЩрнНрмЧрнАрмд рм╕рморнНрммрмирнНрмзрнАрнЯ рмирнЛрмЯрнН, рм╕рмЩрнНрмЧрнАрмд рм╕рморнНрммрмирнНрмзрнАрнЯ рм╕рнНрн▒рм░, рм╕рнНрн▒рм░
ЁЯО╢ => ЁЯО╢, рм╕рмЩрнНрмЧрнАрмд, рм╕рмЩрнНрмЧрнАрмд рм╕рморнНрммрмирнНрмзрнАрнЯ рмирнЛрмЯрнНрм╕, рм╕рмЩрнНрмЧрнАрмд рм╕рморнНрммрмирнНрмзрнАрнЯ рм╕рнНрн▒рм░рмЧрнБрмбрм┐рмХ, рм╕рнНрн▒рм░, рм╕рнНрн▒рм░рмЧрнБрмбрм┐рмХ
ЁЯОЩ => ЁЯОЩ, рморм╛рмЗрмХрнНтАМ, рморм╛рмЗрмХрнНрм░рнЛрмлрнЛрмирнНтАМ, рм╖рнНрмЯрнБрмбрм┐рмУ, рм╖рнНрмЯрнБрмбрм┐рмУ рморм╛рмЗрмХрнНрм░рнЛрмлрнЛрмирнНтАМ, рм╕рмЩрнНрмЧрнАрмд
ЁЯОЪ => ЁЯОЪ, рм╕рмЩрнНрмЧрнАрмд рм╕рнНрм▓рм╛рмЗрмбрм░рнНтАМ, рм╕рнНрмдрм░, рм╕рнНрмдрм░ рм╕рнНрм▓рм╛рмЗрмбрм░рнНтАМ
ЁЯОЫ => ЁЯОЫ, рмирммрнНтАМтАМтАМтАМрмЧрнБрмбрм┐рмХ, рмирм┐рнЯрмирнНрмдрнНрм░рмг, рмирм┐рнЯрмирнНрмдрнНрм░рмг рмирммрнН, рм╕рмЩрнНрмЧрнАрмд
ЁЯОд => ЁЯОд, рмХрм╛рм░рм╛рмУрмХрнНтАМ, рмормирнЛрм░рмЮрнНрмЬрми, рморм╛рмЗрмХрнНтАМ, рморм╛рмЗрмХрнНрм░рнЛрмлрнЛрмирнН
ЁЯОз => ЁЯОз, рмормирнЛрм░рмЮрнНрмЬрми, рм╣рнЗрмбрмлрнЛрмирнНтАМ
ЁЯУ╗ => ЁЯУ╗, рм░рнЗрмбрм┐рмУ
ЁЯО╖ => ЁЯО╖, рмЙрмкрмХрм░рмг, рм╕рмЩрнНрмЧрнАрмд, рм╕рмЩрнНрмЧрнАрмд рмнрм┐рмдрнНрмдрм┐рмХ рмЙрмкрмХрм░рмг, рм╕рм╛рмХрнНрм╕рнЛрмлрнЛрмирнНтАМ, рм╕рнНрнЯрм╛рмХрнНрм╕
ЁЯО╕ => ЁЯО╕, рмЙрмкрмХрм░рмг, рмЧрм┐рмдрм╛рм░, рм╕рмЩрнНрмЧрнАрмд рмнрм┐рмдрнНрмдрм┐рмХ рмЙрмкрмХрм░рмг
ЁЯО╣ => ЁЯО╣, рмЙрмкрмХрм░рмг, рмХрнАрммрнЛрм░рнНрмб, рмкрм┐рмЖрмирнЛ, рм╕рмЩрнНрмЧрнАрмд, рм╕рмЩрнНрмЧрнАрмд рмнрм┐рмдрнНрмдрм┐рмХ рмЙрмкрмХрм░рмг, рм╕рмЩрнНрмЧрнАрмд рмнрм┐рмдрнНрмдрм┐рмХ рмХрнАрммрнЛрм░рнНрмб, рм╕рмЩрнНрмЧрнАрмд рм╕рморнНрммрмирнНрмзрнАрнЯ рмХрнАрммрнЛрм░рнНрмбрнНтАМ
ЁЯО║ => ЁЯО║, рмЙрмкрмХрм░рмг, рмдрнБрм░рнА, рм╕рмЩрнНрмЧрнАрмд, рм╕рмЩрнНрмЧрнАрмд рмнрм┐рмдрнНрмдрм┐рмХ рмЙрмкрмХрм░рмг
ЁЯО╗ => ЁЯО╗, рмЙрмкрмХрм░рмг, рммрнЗрм╣рнЗрм▓рм╛, рмнрм╛рмУрм▓рм┐рмирнН, рм╕рмЩрнНрмЧрнАрмд, рм╕рмЩрнНрмЧрнАрмд рмнрм┐рмдрнНрмдрм┐рмХ рмЙрмкрмХрм░рмг
ЁЯеБ => ЁЯеБ, рмбрнНрм░рморнНтАМ, рмбрнНрм░рморнНтАМ рммрмЬрм╛рмЗрммрм╛ рмХрм╛рмарм┐, рм╕рмЩрнНрмЧрнАрмд
ЁЯУ▒ => ЁЯУ▒, рмлрнЛрмирнН, рморнЛрммрм╛рмЗрм▓рнНтАМ рмлрнЛрмирнНтАМ, рм╕рнЗрм▓рнН рмлрнЛрмирнН
ЁЯУ▓ => ЁЯУ▓, рмПрмХ рмХрм▓рнН рмХрм░рм┐рммрм╛, рмдрнАрм░ рм╕рм╣рм┐рмд рморнЛрммрм╛рмЗрм▓рнНтАМ рмлрнЛрмирнНтАМ, рмдрнАрм░ рм╕рм╣рм┐рмд рм╕рнЗрм▓рнН рмлрнЛрмирнН, рмлрнЛрмирнН, рморнЛрммрм╛рмЗрм▓рнН рмлрнЛрмирнН
тШО => тШО, рмЯрнЗрм▓рм┐рмлрнЛрмирнНтАМ, рмлрнЛрмирнНтАМ
ЁЯУЮ => ЁЯУЮ, рмЯрнЗрм▓рм┐рмлрнЛрмирнН, рмЯрнЗрм▓рм┐рмлрнЛрмирнНтАМ рм░рм┐рм╕рм┐рмнрм░рнНтАМ, рмлрнЛрмирнН, рмлрнЛрмирнН рм░рм┐рм╕рм┐рмнрм░рнН, рмпрнЛрмЧрм╛рмпрнЛрмЧ
ЁЯУЯ => ЁЯУЯ, рмкрнЗрмЬрм░рнНтАМ, рмпрнЛрмЧрм╛рмпрнЛрмЧ
ЁЯУа => ЁЯУа, рмлрнНрнЯрм╛рмХрнНрм╕, рмлрнНрнЯрм╛рмХрнНрм╕ рморнЗрм╕рм┐рмирнНтАМ, рмпрнЛрмЧрм╛рмпрнЛрмЧ
ЁЯФЛ => ЁЯФЛ, рммрнНрнЯрм╛рмЯрнЗрм░рнА
ЁЯФМ => ЁЯФМ, рмЗрм▓рнЗрмХрнНрмЯрнНрм░рм┐рмХрнН, рмЗрм▓рнЗрмХрнНрмЯрнНрм░рм┐рмХрнН рмкрнНрм▓рмЧрнН, рммрнИрмжрнНрнЯрнБрмдрм┐рмХрнНтАМ рмкрнНрм▓рмЧрнНтАМ
ЁЯТ╗ => ЁЯТ╗, рмХрморнНрмкрнНрнЯрнБрмЯрм░рнН, рмкрм░рнНрм╕рмирм╛рм▓рнН, рмкрм░рнНрм╕рмирм╛рм▓рнН рмХрморнНрмкрнНрнЯрнБрмЯрм░рнН, рмкрм┐рм╕рм┐, рм▓рм╛рмкрмЯрмкрнНтАМ рмХрморнНрмкрнНрнЯрнБрмЯрм░рнНтАМ
ЁЯЦе => ЁЯЦе, рмХрморнНрмкрнНрнЯрнБрмЯрм░рнНтАМ ред рмбрнЗрм╕рнНрмХрмЯрмкрнНтАМ, рмбрнЗрм╕рнНрмХрмЯрмкрнНтАМ рмХрморнНрмкрнНрнЯрнБрмЯрм░рнНтАМ
ЁЯЦи => ЁЯЦи, рмХрморнНрмкрнНрнЯрнБрмЯрм░рнНтАМ, рмкрнНрм░рм┐рмгрнНрмЯрм░рнНтАМ
тМи => тМи, рмХрморнНрмкрнНрнЯрнБрмЯрм░рнНтАМ, рмХрнАрммрнЛрм░рнНрмбрнНтАМ
ЁЯЦ▒ => ЁЯЦ▒, рмХрморнНрмкрнНрнЯрнБрмЯрм░рнНтАМ, рмХрморнНрмкрнНрнЯрнБрмЯрм░рнНтАМ рморм╛рмЙрм╕рнНтАМ
ЁЯЦ▓ => ЁЯЦ▓, рмХрморнНрмкрнНрнЯрнБрмЯрм░рнНтАМ, рмЯрнНрм░рм╛рмХрнНтАМрммрм▓рнНтАМ
ЁЯТ╜ => ЁЯТ╜, рмПрмормбрм┐, рмХрморнНрмкрнНрнЯрнБрмЯрм░рнНтАМ рмбрм┐рм╕рнНрмХ, рмбрм┐рм╕рнНрмХрнН, рморм┐рмирм┐ рмбрм┐рм╕рнНрмХрнН
ЁЯТ╛ => ЁЯТ╛, рмбрм┐рм╕рнНрмХрнН, рмлрнНрм▓рмкрм┐, рмлрнНрм▓рмкрм┐ рмбрм┐рм╕рнНрмХ, рмлрнНрм▓рмкрм┐ рмбрм┐рм╕рнНрмХрнН
ЁЯТ┐ => ЁЯТ┐, рмЕрмкрнНрмЯрм┐рмХрм╛рм▓рнНтАМ рмбрм┐рм╕рнНрмХ, рмЕрмкрнНрмЯрм┐рмХрм╛рм▓рнН рмбрм┐рм╕рнНрмХрнН, рмбрм┐рмнрм┐рмбрм┐, рмбрм┐рм╕рнНрмХрнН, рммрнНрм▓рнБ-рм░рнЗ, рм╕рм┐рмбрм┐
ЁЯУА => ЁЯУА, рмбрм┐рмнрм┐рмбрм┐, рмбрм┐рмнрм┐рмбрм┐ рмбрм┐рм╕рнНрмХрнН, рмбрм┐рм╕рнНрмХрнН
ЁЯОе => ЁЯОе, рмЪрм│рмЪрнНрмЪрм┐рмдрнНрм░, рмЪрм│рмЪрнНрмЪрм┐рмдрнНрм░ рмХрнНрнЯрм╛рморнЗрм░рм╛, рмормирнЛрм░рмЮрнНрмЬрми, рморнБрмнрм┐ рмХрнНрнЯрм╛рморнЗрм░рм╛, рм╕рм┐рмирнЗрморм╛
ЁЯОЮ => ЁЯОЮ, рмлрм┐рм▓рнНрмо рмлрнНрм░рнЗрморнНтАМрмЧрнБрмбрм┐рмХ, рм╕рм┐рмирнЗрморм╛ ред рмлрм┐рм▓рнНрмо ред рмлрнНрм░рнЗрморнНтАМрмЧрнБрмбрм┐рмХ ред рморнБрмнрм┐
ЁЯУ╜ => ЁЯУ╜, рмлрм┐рм▓рнНрмо рмкрнНрм░рнЛрмЬрнЗрмХрнНрмЯрм░рнНтАМ, рм╕рм┐рмирнЗрморм╛ ред рмлрм┐рм▓рнНрмо ред рморнБрмнрм┐ ред рмкрнНрм░рнЛрмЬрнЗрмХрнНрмЯрм░рнНтАМ ред рмнрм┐рмбрм┐рмУ
ЁЯОм => ЁЯОм, рмХрнНрм▓рм╛рмкрм░рнНтАМ рммрнЛрм░рнНрмб, рмХрнНрм▓рм╛рмкрм░рнНтАМрммрнЛрм░рнНрмб, рмЪрм│рмЪрнНрмЪрм┐рмдрнНрм░, рмдрм╛рм│рм┐ рморм░рм╛рмпрм┐рммрм╛ рмлрм│рмХ, рмдрм╛рм│рм┐ рморм╛рм░рм┐рммрм╛ рммрнНрнЯрмХрнНрмдрм┐, рмормирнЛрм░рмЮрнНрмЬрми
ЁЯУ║ => ЁЯУ║, рмЯрм┐рмнрм┐, рмЯрнЗрм▓рм┐рмнрм┐рмЬрмирнН, рмжрнВрм░рмжрм░рнНрм╢рми
ЁЯУ╖ => ЁЯУ╖, рмХрнНрнЯрм╛рморнЗрм░рм╛
ЁЯУ╕ => ЁЯУ╕, рмХрнНрнЯрм╛рморнЗрм░рм╛ ред рмлрнНрм▓рм╛рм╢рнНтАМ ред рмнрм┐рмбрм┐рмУ, рмлрнНрм▓рм╛рм╢рнНтАМ рм╕рм╣рм┐рмд рмХрнНрнЯрм╛рморнЗрм░рм╛
ЁЯУ╣ => ЁЯУ╣, рмХрнНрнЯрм╛рморнЗрм░рм╛, рмнрм┐рмбрм┐рмУ, рмнрм┐рмбрм┐рмУ рмХрнНрнЯрм╛рморнЗрм░рм╛, рмнрм┐рмбрм┐рмУ рмХрнНрнЯрм╛рморнН
ЁЯУ╝ => ЁЯУ╝, рмЯрнНрнЯрм╛рмкрнН, рмнрм┐рмбрм┐рмУ, рмнрм┐рмбрм┐рмУ рмХрнНрнЯрм╛рм╕рнЗрмЯрнНтАМ, рмнрм┐рмбрм┐рмУ рмЯрнНрнЯрм╛рмкрнН
ЁЯФН => ЁЯФН, рмХрм╛рмЪ, рмЬрммрмХрм╛рмЪ, рммрм╛рмормХрнБ рмврм│рм┐рмерм┐рммрм╛ рмпрммрмХрм╛рмЪ, рммрм╛рмормХрнБ рмжрнГрм╖рнНрмЯрм┐ рмирм┐рмХрнНрм╖рнЗрмк рмХрм░рнБрмерм┐рммрм╛, рммрм╛рмормХрнБ рмжрнГрм╖рнНрмЯрм┐ рмирм┐рмХрнНрм╖рнЗрмк рмХрм░рнБрмерм┐рммрм╛ рмЬрммрмХрм╛рмЪ, рм╕рмирнНрмзрм╛рми
ЁЯФО => ЁЯФО, рмХрм╛рмЪ, рмЬрммрмХрм╛рмЪ, рмбрм╛рм╣рм╛рмгрмХрнБ рмврм│рм┐рмерм┐рммрм╛ рмпрммрмХрм╛рмЪ, рмбрм╛рм╣рм╛рмгрмХрнБ рмжрнГрм╖рнНрмЯрм┐ рмирм┐рмХрнНрм╖рнЗрмк рмХрм░рнБрмерм┐рммрм╛, рмбрм╛рм╣рм╛рмгрмХрнБ рмжрнГрм╖рнНрмЯрм┐ рмирм┐рмХрнНрм╖рнЗрмк рмХрм░рнБрмерм┐рммрм╛ рмЬрммрмХрм╛рмЪ, рм╕рмирнНрмзрм╛рми
ЁЯФм => ЁЯФм, рморм╛рмЗрмХрнНрм░рнЛрм╕рнНрмХрнЛрмкрнНтАМ
ЁЯФн => ЁЯФн, рмЯрнЗрм▓рм┐рм╕рнНрмХрнЛрмкрнНтАМ
ЁЯУб => ЁЯУб, рмЖрмгрнНрмЯрм┐рмирм╛, рмбрм┐рм╕рнН, рмпрнЛрмЧрм╛рмпрнЛрмЧ, рм╕рм╛рмЯрнЗрм▓рм╛рмЗрмЯрнН, рм╕рм╛рмЯрнЗрм▓рм╛рмЗрмЯрнН рмЖрмгрнНрмЯрм┐рмирм╛, рм╕рм╛рмЯрнЗрм▓рм╛рмЗрмЯрнН рмбрм┐рм╕рнН, рм╕рнНрнЯрм╛рмЯрнЗрм▓рм╛рмЗрмЯрнНтАМ рмЖрмгрнНрмЯрм┐рмирм╛
ЁЯХп => ЁЯХп, рмЖрм▓рнЛрмХ, рморм╣рмо
ЁЯТб => ЁЯТб, рмЖрм▓рнЛрмХ, рмЖрм▓рнЛрмХ рммрм▓рммрнНтАМ, рмПрмХ рмзрм╛рм░рмгрм╛ рмкрм╛рмЗрммрм╛, рммрм▓рмХрнНтАМ, рммрнИрмжрнНрнЯрнБрмдрм┐рмХ, рм▓рм╛рмЗрмЯрнНтАМ рммрм▓рнНрмм, рм╣рм╛рм╕рнНрнЯрнЛрмжрнНрмжрнАрмкрмХ
ЁЯФж => ЁЯФж, рмЖрм▓рнЛрмХ, рмЗрм▓рнЗрмХрнНрмЯрнНрм░рм┐рмХрнН, рмЯрм░рнНрмЪрнНрмЪ, рмлрнНрм▓рм╛рм╢рнНтАМрм▓рм╛рмЗрмЯрнНтАМ, рмлрнНрм▓рм╛рм╕рнНтАМрм▓рм╛рмЗрмЯрнН
ЁЯПо => ЁЯПо, рмЗрмЬрм╛рмХрм╛рнЯрм╛, рммрм╛рм░рнНтАМ, рм░рнЗрм╖рнНрмЯрнБрм░рм╛рмгрнНрмЯ, рм▓рмгрнНрмарми, рм▓рм╛рм▓рнНтАМ, рм▓рм╛рм▓рнНтАМ рмХрм╛рмЧрмЬ рм▓рмгрнНрмарми, рм▓рм╛рм▓рнНтАМ рм▓рмгрнНрмарми
ЁЯУФ => ЁЯУФ, рмХрмнрм░рнН, рмЪрм┐рмдрнНрм░рммрм┐рмЪрм┐рмдрнНрм░ рмирнЛрмЯрнНтАМрммрнБрмХрнН, рмЪрм┐рмдрнНрм░рммрм┐рмЪрм┐рмдрнНрм░ рммрм┐рм╢рм┐рм╖рнНрмЯ рмирнЛрмЯрнНтАМрммрнБрмХрнН, рмирнЛрмЯрнНтАМрммрнБрмХрнН, рм╢рнЛрмнрм╛рммрм░рнНрмжрнНрмзрмХ рморм▓рм╛рмЯ рмерм┐рммрм╛ рмирнЛрмЯрнНтАМрммрнБрмХрнНтАМ
ЁЯУХ => ЁЯУХ, рмкрнБрм╕рнНрмдрмХ, рммрмирнНрмж рмерм┐рммрм╛ рммрм╣рм┐, рммрмирнНрмж рмкрнБрм╕рнНрмдрмХ
ЁЯУЦ => ЁЯУЦ, рмЦрнЛрм▓рм╛ рмкрнБрм╕рнНрмдрмХ, рмЦрнЛрм▓рм╛ рммрм╣рм┐, рмкрнБрм╕рнНрмдрмХ
ЁЯУЧ => ЁЯУЧ, рмкрнБрм╕рнНрмдрмХ, рм╕рммрнБрмЬ рмкрнБрм╕рнНрмдрмХ, рм╕рммрнБрмЬ рммрм╣рм┐
ЁЯУШ => ЁЯУШ, рмирнАрм│ рмкрнБрм╕рнНрмдрмХ, рмирнАрм│ рммрм╣рм┐, рмкрнБрм╕рнНрмдрмХ
ЁЯУЩ => ЁЯУЩ, рмХрморм│рм╛ рмкрнБрм╕рнНрмдрмХ, рмХрморм│рм╛ рммрм╣рм┐, рмкрнБрм╕рнНрмдрмХ
ЁЯУЪ => ЁЯУЪ, рмкрнБрм╕рнНрмдрмХ, рммрм╣рм┐рмЧрнБрмбрм┐рмХ
ЁЯУУ => ЁЯУУ, рмирнЛрмЯрнНтАМрммрнБрмХрнНтАМ
ЁЯУТ => ЁЯУТ, рмирнЛрмЯрнНтАМрммрнБрмХрнН, рм▓рнЗрмЬрм░рнН
ЁЯУГ => ЁЯУГ, рмХрнБрмЮрнНрмЪрм┐рмд рмкрнГрм╖рнНрмарм╛, рмбрмХрнНрнЯрнБрморнЗрмгрнНрмЯрнН, рмкрнГрм╖рнНрмарм╛, рморнЛрмбрм┐ рм╣рнЛрмЗрмерм┐рммрм╛ рмкрнГрм╖рнНрмарм╛
ЁЯУЬ => ЁЯУЬ, рмХрм╛рмЧрмЬ рм╕рнНрмХрнНрм░рнЛрм▓рнН, рм╕рнНрмХрнНрм░рнЛрм▓рнН
ЁЯУД => ЁЯУД, рмЙрмкрм░рмХрнБ рморнБрм╣рмБ рмХрм░рм┐рмерм┐рммрм╛ рмкрнГрм╖рнНрмарм╛, рмЙрмкрм░рнБ рморнЛрмбрм┐ рм╣рнЛрмЗрмерм┐рммрм╛, рмЙрмкрм░рнБ рморнЛрмбрм┐ рм╣рнЛрмЗрмерм┐рммрм╛ рмкрнГрм╖рнНрмарм╛, рмбрмХрнНрнЯрнБрморнЗрмгрнНрмЯрнН, рмкрнГрм╖рнНрмарм╛
ЁЯУ░ => ЁЯУ░, рмирнНрнЯрнБрмЬрнН, рмирнНрнЯрнБрмЬрнНтАМрмкрнЗрмкрм░рнН, рмкрнЗрмкрм░рнН, рм╕рморнНрммрм╛рмжрмкрмдрнНрм░
ЁЯЧЮ => ЁЯЧЮ, рмХрм╛рмЧрмЬ, рмЧрнБрмбрм╛ рм╣рнЛрмЗрмерм┐рммрм╛, рмЧрнБрмбрм╛ рм╣рнЛрмЗрмерм┐рммрм╛ рм╕рморнНрммрм╛рмжрмкрмдрнНрм░, рм╕рморнНрммрм╛рмж, рм╕рморнНрммрм╛рмжрмкрмдрнНрм░
ЁЯУС => ЁЯУС, рмЯрнНрнЯрм╛рммрнН, рмкрнБрм╕рнНрмдрмХрмЪрм┐рм╣рнНрми, рмкрнБрм╕рнНрмдрмХрмЪрм┐рм╣рнНрми рмЯрнНрнЯрм╛рммрнН, рммрнБрмХрнНтАМрморм╛рм░рнНрмХрнНтАМ рмЯрнНрнЯрм╛рммрнНтАМрмЧрнБрмбрм┐рмХ, рморм╛рм░рнНрмХрм░рнН
ЁЯФЦ => ЁЯФЦ, рмкрнБрм╕рнНрмдрмХрмЪрм┐рм╣рнНрми, рммрнБрмХрнНтАМрморм╛рм░рнНрмХрнНтАМ
ЁЯП╖ => ЁЯП╖, рм▓рнЗрммрнБрм▓рнНтАМ
ЁЯТ░ => ЁЯТ░, рмЯрмЩрнНрмХрм╛, рмЯрмЩрнНрмХрм╛ рмерм│рм┐, рмЯрмЩрнНрмХрм╛ рммрнНрнЯрм╛рмЧрнН, рмбрм▓рм╛рм░рнН рммрнНрнЯрм╛рмЧрнН, рммрнНрнЯрм╛рмЧрнН
ЁЯТ┤ => ЁЯТ┤, рмЯрмЩрнНрмХрм╛, рмирнЛрмЯрнН, рммрм┐рм▓рнН, рммрнНрнЯрм╛рмЩрнНрмХрмирнЛрмЯрнН, рнЯрнЗрмирнН, рнЯрнЗрмирнН рмирнЛрмЯрнН, рнЯрнЗрмирнНтАМ рммрнНрнЯрм╛рмЩрнНрмХрмирнЛрмЯрнНтАМ
ЁЯТ╡ => ЁЯТ╡, рмЯрмЩрнНрмХрм╛, рмбрм▓рм╛рм░рнН, рмбрм▓рм╛рм░рнН рмирнЛрмЯрнН, рмбрм▓рм╛рм░рнНтАМ рммрнНрнЯрм╛рмЩрнНрмХрмирнЛрмЯрнНтАМ, рмирнЛрмЯрнН, рммрм┐рм▓рнН, рммрнНрнЯрм╛рмЩрнНрмХрнН рмирнЛрмЯрнН
ЁЯТ╢ => ЁЯТ╢, рмЯрмЩрнНрмХрм╛, рмирнЛрмЯрнН, рммрм┐рм▓рнН, рммрнНрнЯрм╛рмЩрнНрмХрмирнЛрмЯрнН, рнЯрнБрм░рнЛ, рнЯрнБрм░рнЛ рмирнЛрмЯрнН, рнЯрнБрм░рнЛ рммрнНрнЯрм╛рмЩрнНрмХрмирнЛрмЯрнНтАМ
ЁЯТ╖ => ЁЯТ╖, рмЯрмЩрнНрмХрм╛, рмкрм╛рмЙрмгрнНрмб рммрнНрнЯрм╛рмЩрнНрмХрмирнЛрмЯрнНтАМ, рмкрм╛рмЙрмгрнНрмбрнН, рмкрм╛рмЙрмгрнНрмбрнН рмирнЛрмЯрнН, рммрнНрнЯрм╛рмЩрнНрмХрмирнЛрмЯрнН
ЁЯТ╕ => ЁЯТ╕, рмЙрмбрмирнНрмдрм╛ рмЯрмЩрнНрмХрм╛, рмЙрмбрмирнНрмдрм╛ рммрнНрнЯрм╛рмЩрнНрмХрмирнЛрмЯрнН, рмЯрмЩрнНрмХрм╛, рмЯрмЩрнНрмХрм╛рм░рнЗ рмкрм░ рм▓рм╛рмЧрм┐рммрм╛, рмбрнЗрмгрм╛ рмерм┐рммрм╛ рмЯрмЩрнНрмХрм╛, рмирнЛрмЯрнН, рммрнНрнЯрм╛рмЩрнНрмХрнН
ЁЯТ│ => ЁЯТ│, рмХрм╛рм░рнНрмбрнН, рмХрнНрм░рнЗрмбрм┐рмЯрнН, рмХрнНрм░рнЗрмбрм┐рмЯрнНтАМ рмХрм╛рм░рнНрмб, рмХрнНрм░рнЗрмбрм┐рмЯрнН рмХрм╛рм░рнНрмбрнН
ЁЯТ╣ => ЁЯТ╣, рмЙрмкрм░, рмЪрм╛рм░рнНрмЯрнН, рмЪрм╛рм░рнНрмЯрнН рмЙрмкрм░рморм╛рм░рнНрмЧ, рммрмЬрм╛рм░, рммрмврмирнНрмдрм╛ рммрмЬрм╛рм░, рнЯрнЗрмирнНтАМ рм╕рм╣рм┐рмд рммрнГрмжрнНрмзрм┐ рмкрм╛рмЙрмерм┐рммрм╛ рмЪрм╛рм░рнНрмЯрнНтАМ
ЁЯТ▒ => ЁЯТ▒, рмЯрмЩрнНрмХрм╛, рммрм┐рмирм┐рморнЯ, рморнБрмжрнНрм░рм╛, рморнБрмжрнНрм░рм╛ рммрм┐рмирм┐рморнЯ
ЁЯТ▓ => ЁЯТ▓, рмЯрмЩрнНрмХрм╛, рмбрм▓рм╛рм░рнН, рмбрм▓рм╛рм░рнН рмЪрм┐рм╣рнНрми, рммрнЛрм▓рнНрмбрнН рмбрм▓рм╛рм░рнН рмЪрм┐рм╣рнНрми, рмнрм╛рм░рнА рмбрм▓рм╛рм░рнНтАМ рмЪрм┐рм╣рнНрми
тЬЙ => тЬЙ, рмЪрм┐рмарм┐ ред рмЗрморнЗрм▓рнНтАМ, рм▓рмлрм╛рмлрм╛
ЁЯУз => ЁЯУз, рмЗрморнЗрм▓рнНтАМ, рмЪрм┐рмарм╛, рморнЗрм▓рнН, рмпрнЛрмЧрм╛рмпрнЛрмЧ
ЁЯУи => ЁЯУи, рмЖрмЧрмирнНрмдрнБрмХ, рмЖрмЧрмирнНрмдрнБрмХ рморнЗрм▓рнН, рмЖрмЧрморми рм▓рмлрм╛рмлрм╛, рмЗрморнЗрм▓рнН, рмПрмирнНтАМрмнрм▓рмкрнН, рмЪрм┐рмарм╛, рмкрнНрм░рм╛рмкрнНрмд рм╣рнЛрмЗрмерм┐рммрм╛ рморнЗрм▓рнН, рморнЗрм▓рнН, рмпрнЛрмЧрм╛рмпрнЛрмЧ
ЁЯУй => ЁЯУй, рмЗрморнЗрм▓рнН, рмПрмирнНтАМрмнрм▓рмкрнН, рмЪрм┐рмарм╛, рмдрнАрм░ рм╕рм╣рм┐рмд рм▓рмлрм╛рмлрм╛, рмкрнНрм░рнЗрм░рм┐рмд рморнЗрм▓рнН, рммрм╣рм┐рм░рнНрмЧрморми, рммрм╣рм┐рм░рнНрмЧрморми рморнЗрм▓рнН, рморнЗрм▓рнН, рмпрнЛрмЧрм╛рмпрнЛрмЧ
ЁЯУд => ЁЯУд, рмЖрмЙрмЯрммрмХрнНрм╕ рмЯрнНрм░рнЗ, рмЯрнНрм░рнЗ, рмкрнНрм░рнЗрм░рмг, рмкрнНрм░рнЗрм░рмг рммрм╛рмХрнНрм╕, рммрм╛рмХрнНрм╕, рммрм╛рм╣рнНрнЯрммрм╛рмХрнНрм╕, рморнЗрм▓рнН, рморнЗрм▓рнН рмкрмарм╛рмЗрммрм╛, рмпрнЛрмЧрм╛рмпрнЛрмЧ
ЁЯУе => ЁЯУе, рмЗрмирммрмХрнНрм╕ рмЯрнНрм░рнЗ, рмЗрмирнНтАМрммрм╛рмХрнНрм╕, рмЯрнНрм░рнЗ, рмкрнНрм░рм╛рмкрнНрмд рм╣рнЛрмЗрмерм┐рммрм╛, рмкрнНрм░рм╛рмкрнНрмд рм╣рнЛрмЗрмерм┐рммрм╛ рморнЗрм▓рнН, рммрм╛рмХрнНрм╕, рморнЗрм▓рнН, рмпрнЛрмЧрм╛рмпрнЛрмЧ
ЁЯУж => ЁЯУж, рмкрм╛рм░рнНрм╕рм▓рнН, рмкрнНрнЯрм╛рмХрнЗрмЬрнНтАМ, рммрм╛рмХрнНрм╕
ЁЯУл => ЁЯУл, рмЙрмарм┐рмерм┐рммрм╛ рмкрмдрм╛рмХрм╛ рм╕рм╣рм┐рмд рммрмирнНрмж рмерм┐рммрм╛ рморнЗрм▓рнНтАМрммрм╛рмХрнНрм╕, рмПрмХ рмЙрмжрнНрмзрмЧрм╛рморнА рмкрмдрм╛рмХрм╛ рм╕рм╣рм┐рмд рморнЗрм▓рнНтАМрммрм╛рмХрнНрм╕, рмкрмдрм╛рмХрм╛, рммрмирнНрмж рм╣рнЛрмЗрмЫрм┐, рморнЗрм▓рнН, рморнЗрм▓рнНтАМрммрм╛рмХрнНрм╕
ЁЯУк => ЁЯУк, рмПрмХ рмирм┐рморнНрмирмЧрм╛рморнА рмкрмдрм╛рмХрм╛ рм╕рм╣рм┐рмд рморнЗрм▓рнНтАМрммрм╛рмХрнНрм╕, рмдрм│рнБрмЖ рмерм┐рммрм╛ рмкрмдрм╛рмХрм╛ рм╕рм╣рм┐рмд рммрмирнНрмж рмерм┐рммрм╛ рморнЗрм▓рнНтАМрммрм╛рмХрнНрм╕, рмкрмдрм╛рмХрм╛, рммрмирнНрмж рм╣рнЛрмЗрмЫрм┐, рморнЗрм▓рнН, рморнЗрм▓рнНтАМрммрм╛рмХрнНрм╕
ЁЯУм => ЁЯУм, рмПрмХ рмЙрмжрнНрмзрмЧрм╛рморнА рмкрмдрм╛рмХрм╛ рм╕рм╣рм┐рмд рморнЗрм▓рнНтАМрммрм╛рмХрнНрм╕, рмЦрнЛрм▓рм╛, рмдрм│рнБрмЖ рмерм┐рммрм╛ рмкрмдрм╛рмХрм╛ рм╕рм╣рм┐рмд рмЦрнЛрм▓рм╛ рморнЗрм▓рнНтАМрммрм╛рмХрнНрм╕, рмкрмдрм╛рмХрм╛, рморнЗрм▓рнН, рморнЗрм▓рнНтАМрммрм╛рмХрнНрм╕
ЁЯУн => ЁЯУн, рмЙрмарм┐рмерм┐рммрм╛ рмкрмдрм╛рмХрм╛ рм╕рм╣рм┐рмд рмЦрнЛрм▓рм╛ рморнЗрм▓рнНтАМрммрм╛рмХрнНрм╕, рмПрмХ рмирм┐рморнНрмирмЧрм╛рморнА рмкрмдрм╛рмХрм╛ рм╕рм╣рм┐рмд рморнЗрм▓рнНтАМрммрм╛рмХрнНрм╕, рмЦрнЛрм▓рм╛, рмкрмдрм╛рмХрм╛, рморнЗрм▓рнН, рморнЗрм▓рнНтАМрммрм╛рмХрнНрм╕
ЁЯУо => ЁЯУо, рмкрнЛрм╖рнНрмЯрммрм╛рмХрнНрм╕
ЁЯЧ│ => ЁЯЧ│, рммрм╛рмХрнНрм╕, рммрм╛рм▓рм╛рмЯрнНтАМ, рммрм╛рм▓рм╛рмЯрнНтАМ рмерм┐рммрм╛ рммрм╛рм▓рм╛рмЯрнНтАМ рммрм╛рмХрнНрм╕
тЬП => тЬП, рмкрнЗрмирм╕рм┐рм▓рнНтАМ
тЬТ => тЬТ, рмХрм▓рмо, рмХрм▓рморморнБрми, рмХрм│рм╛ рмХрм▓рморморнБрми
ЁЯЦЛ => ЁЯЦЛ, рмЭрм░рмгрм╛ ред рмХрм▓рмо, рмЭрм░рмгрм╛ рмкрнЗрмирнНтАМ
ЁЯЦК => ЁЯЦК, рмХрм▓рмо, рммрм▓рнНтАМрмкрмПрмгрнНрмЯ
ЁЯЦМ => ЁЯЦМ, рмЪрм┐рмдрнНрм░рм╛рмЩрнНрмХрми, рмЪрм┐рмдрнНрм░рм╛рмЩрнНрмХрми рммрнНрм░рм╢рнНтАМ
ЁЯЦН => ЁЯЦН, рмХрнНрм░рнЗрнЯрмирнНтАМ
ЁЯУЭ => ЁЯУЭ, рморнЗрморнЛ, рморнЗрморнЛ рмкрнБрм╕рнНрмдрмХ, рмпрнЛрмЧрм╛рмпрнЛрмЧ
ЁЯТ╝ => ЁЯТ╝, рммрнНрм░рм┐рмлрмХрнЗрм╕рнН, рммрнНрм░рм┐рмлрнНтАМрмХрнЗрм╕рнН
ЁЯУБ => ЁЯУБ, рмлрм╛рмЗрм▓рнН, рмлрм╛рмЗрм▓рнНтАМ рмлрнЛрм▓рнНрмбрмЛ, рмлрм╛рмЗрм▓рнН рмлрнЛрм▓рнНрмбрм░рнН, рмлрнЛрм▓рнНрмбрм░рнН
ЁЯУВ => ЁЯУВ, рмЦрнЛрм▓рм╛, рмЦрнЛрм▓рм╛ рмлрм╛рмЗрм▓рнНтАМ рмлрнЛрм▓рнНрмбрм░, рмЦрнЛрм▓рм╛ рмлрм╛рмЗрм▓рнН рмлрнЛрм▓рнНрмбрм░рнН, рмЦрнЛрм▓рм╛ рмлрнЛрм▓рнНрмбрм░рнН, рмлрм╛рмЗрм▓рнН, рмлрнЛрм▓рнНрмбрм░рнН
ЁЯЧВ => ЁЯЧВ, рмЕрмирнБрмХрнНрм░рмормгрм┐рмХрм╛, рмХрм╛рм░рнНрмб, рмХрм╛рм░рнНрмб рмЕрмирнБрмХрнНрм░рмормгрм┐рмХрм╛ рммрм┐рмнрм╛рмЬрмХрмЧрнБрмбрм┐рмХ, рммрм┐рмнрм╛рмЬрмХрмЧрнБрмбрм┐рмХ
ЁЯУЕ => ЁЯУЕ, рмХрнНрнЯрм╛рм▓рнЗрмгрнНрмбрм░рнНтАМ
ЁЯУЖ => ЁЯУЖ, рмХрнНрнЯрм╛рм▓рнЗрмгрнНрмбрм░рнН, рмЪрм┐рм░рм╛ рмпрм╛рмЗрмерм┐рммрм╛ рмХрнНрнЯрм╛рм▓рнЗрмгрнНрмбрм░рнНтАМ, рмЪрм┐рм░рм┐рммрм╛рмпрнЛрмЧрнНрнЯ рмХрнНрнЯрм╛рм▓рнЗрмгрнНрмбрм░рнН
ЁЯЧТ => ЁЯЧТ, рмирнЛрмЯрнНтАМ, рмкрнНрнЯрм╛рмбрнНтАМ, рм╕рнНрмкрм╛рмЗрм░рм╛рм▓рнНтАМ, рм╕рнНрмкрм╛рмЗрм░рм╛рм▓рнНтАМ рмирнЛрмЯрнНтАМрммрнНрнЯрм╛рмбрнНтАМ
ЁЯЧУ => ЁЯЧУ, рмХрнНрнЯрм╛рм▓рнЗрмгрнНрмбрм░рнНтАМ, рмкрнНрнЯрм╛рмбрнНтАМ, рм╕рнНрмкрм╛рмЗрм░рм╛рм▓рнНтАМ, рм╕рнНрмкрм╛рмЗрм░рм╛рм▓рнНтАМ рмХрнНрнЯрм╛рм▓рнЗрмгрнНрмбрм░рнНтАМ
ЁЯУЗ => ЁЯУЗ, рмЗрмгрнНрмбрнЗрмХрнНрм╕, рмХрм╛рм░рнНрмб рмЕрмирнБрмХрнНрм░рмормгрм┐рмХрм╛, рмХрм╛рм░рнНрмбрнН рмЗрмгрнНрмбрнЗрмХрнНрм╕, рм░рнЛрм▓рнЛрмбрнЗрмХрнНрм╕
ЁЯУИ => ЁЯУИ, рмЙрмкрм░рмХрнБ, рмЙрмкрм░рмХрнБ рммрмврмирнНрмдрм╛ рмкрнНрм░рммрнГрмдрнНрмдрм┐ рмЪрм╛рм░рнНрмЯрнН, рмЧрнНрм░рм╛рмлрнН, рмЪрм╛рм░рнНрмЯрнН, рмЪрм╛рм░рнНрмЯрнНтАМ рммрнГрмжрнНрмзрм┐ рм╣рнЗрмЙрмЫрм┐, рммрмврмирнНрмдрм╛ рмкрнНрм░рммрнГрмдрнНрмдрм┐
ЁЯУЙ => ЁЯУЙ, рмЧрнНрм░рм╛рмлрнН, рмЪрм╛рм░рнНрмЯрнН, рмЪрм╛рм░рнНрмЯрнНтАМ рм╣рнНрм░рм╛рм╕ рм╣рнЗрмЙрмЫрм┐, рмдрм│рмХрнБ рмпрм╛рмЙрмерм┐рммрм╛, рмдрм│рмХрнБ рмпрм╛рмЙрмерм┐рммрм╛ рмкрнНрм░рммрнГрмдрнНрмдрм┐, рмдрм│рмХрнБ рмпрм╛рмЙрмерм┐рммрм╛ рмкрнНрм░рммрнГрмдрнНрмдрм┐ рмЪрм╛рм░рнНрмЯрнН
ЁЯУК => ЁЯУК, рмЪрм╛рм░рнНрмЯрнН, рммрм╛рм░рнН рмЧрнНрм░рм╛рмлрнН, рммрм╛рм░рнН рмЪрм╛рм░рнНрмЯрнН
ЁЯУЛ => ЁЯУЛ, рмХрнНрм▓рм┐рмкрнНтАМрммрнЛрм░рнНрмб, рмХрнНрм▓рм┐рмкрнНтАМрммрнЛрм░рнНрмбрнН
ЁЯУМ => ЁЯУМ, рмкрм┐рмирнН, рмкрнБрм╕рмкрм┐рмирнН, рмкрнБрм╕рнНтАМрмкрм┐рмирнН
ЁЯУН => ЁЯУН, рмЧрнЛрм▓ рмкрнБрм╕рнНтАМрмкрм┐рмирнН, рмЧрнЛрм▓рм╛рмХрм╛рм░ рмкрнБрм╕рнНтАМтАМрмкрм┐рмирнНтАМ, рмкрм┐рмирнН, рмкрнБрм╕рнНтАМрмкрм┐рмирнН
ЁЯУО => ЁЯУО, рмХрнНрм▓рм┐рмкрнН, рмкрнЗрмкрм░ рмХрнНрм▓рм┐рмкрнН, рмкрнЗрмкрм░рнН рмХрнНрм▓рм┐рмкрнН
ЁЯЦЗ => ЁЯЦЗ, рмкрнЗрмкрм░ рмХрнНрм▓рм┐рмкрнН, рмкрнЗрмкрм░ рмХрнНрм▓рм┐рмкрнНтАМрмЧрнБрмбрм┐рмХ, рм▓рм┐рмЩрнНрмХрнНтАМ, рм▓рм┐рмЩрнНрмХрнНтАМрмпрнБрмХрнНрмд
ЁЯУП => ЁЯУП, рм░рнБрм▓рм░рнН, рм╕рм┐рмзрм╛ рм░рнБрм▓рм░рнНтАМ, рм╕рнНрмХрнЗрм▓рнН
ЁЯУР => ЁЯУР, рмдрнНрм░рм┐рмХрнЛрмгрнАрнЯ, рмдрнНрм░рм┐рмХрнЛрмгрнАрнЯ рм╕рнНрмХрнЗрм▓рнН, рмдрнНрм░рм┐рмнрнБрмЬрм╛рмХрм╛рм░ рм░рнБрм▓рм░рнНтАМ, рм░рнБрм▓рм░рнН, рм╕рнЗрмЯрнН рм╕рнНрмХрнЛрнЯрм╛рм░рнН
тЬВ => тЬВ, рмХрмдрнБрм░рнА, рмХрм╛рмЯрм┐рммрм╛, рмпрмирнНрмдрнНрм░рмкрм╛рмдрм┐
ЁЯЧГ => ЁЯЧГ, рмХрм╛рм░рнНрмб, рмХрм╛рм░рнНрмб рмлрм╛рмЗрм▓рнНтАМ рммрм╛рмХрнНрм╕, рмлрм╛рмЗрм▓рнНтАМ, рммрм╛рмХрнНрм╕
ЁЯЧД => ЁЯЧД, рмХрнНрнЯрм╛рммрм┐рмирнЗрмЯрнНтАМ, рмлрм╛рмЗрм▓рм┐рмВ, рмлрм╛рмЗрм▓рнНтАМ, рмлрм╛рмЗрм▓рнНтАМ рмХрнНрнЯрм╛рммрм┐рмирнЗрмЯрнНтАМ
ЁЯЧС => ЁЯЧС, рмЖрммрм░рнНрмЬрмирм╛ рммрнЛрмЭ
ЁЯФТ => ЁЯФТ, рммрмирнНрмж рм╣рнЛрмЗрмерм┐рммрм╛ рм▓рмХрнН, рм▓рмХрнН, рм▓рмХрнНтАМрмпрнБрмХрнНрмд
ЁЯФУ => ЁЯФУ, рмдрм╛рм▓рм╛ рмкрмбрм┐рмирм╛рм╣рм┐рмБ, рм▓рмХрнН, рм▓рмХрнН рмЦрнЛрм▓рм┐рммрм╛
ЁЯФП => ЁЯФП, рмПрмХ рм╕рнНрнЯрм╛рм╣рм┐ рмкрнЗрмирнНтАМрм░рнЗ рм▓рмХрнН рмХрм░рм┐рммрм╛, рмЧрнЛрмкрмирнАрнЯрмдрм╛, рмкрнЗрмирнНтАМ рм╕рм╣рм┐рмд рмдрм╛рм▓рм╛ рмкрмбрм┐рмЫрм┐, рм▓рмХрнН, рм╕рнНрнЯрм╛рм╣рм┐ рмкрнЗрмирнН
ЁЯФР => ЁЯФР, рмПрмХ рмХрнА рм╕рм╣рм┐рмд рм▓рмХрнН, рмЪрм╛рммрм┐ рм╕рм╣рм┐рмд рмдрм╛рм▓рм╛ рмкрмбрм┐рмЫрм┐, рммрмирнНрмж рм╣рнЛрмЗрмерм┐рммрм╛ рм▓рмХрнН, рм╕рнБрм░рмХрнНрм╖рм┐рмд
ЁЯФС => ЁЯФС, рмХрнА, рмЪрм╛рммрм┐, рмкрм╛рм╕рнНтАМрн▒рм╛рм░рнНрмбрнН
ЁЯЧЭ => ЁЯЧЭ, рмЪрм╛рммрм┐, рмдрм╛рм▓рм╛, рмкрнБрм░рнБрмгрм╛, рмкрнБрм░рнБрмгрм╛ рмЪрм╛рммрм┐, рм░рм╣рм╕рнНрнЯ рмЙрмжрнНтАМрмШрм╛рмЯрмирм░ рм╕рнВрмдрнНрм░
ЁЯФи => ЁЯФи, рмЙрмкрмХрм░рмг, рм╣рм╛рмдрнБрмбрм╝рм┐, рм╣рм╛рморм╛рм░рнН
тЫП => тЫП, рмЦрмгрмдрм┐, рмЦрмгрм┐ рмХрм╛рмо, рмпрмирнНрмдрнНрм░рмкрм╛рмдрм┐
тЪТ => тЪТ, рмЦрмгрмдрм┐, рмпрмирнНрмдрнНрм░рмкрм╛рмдрм┐, рм╣рм╛рмдрнБрмбрм┐, рм╣рм╛рмдрнБрмбрм┐ рмПрммрмВ рмЦрмгрмдрм┐
ЁЯЫа => ЁЯЫа, рмпрмирнНрмдрнНрм░рмкрм╛рмдрм┐, рм░рнЗрмЮрнНрмЪрм┐, рм╕рнНрмкрм╛рмирм░рнНтАМ, рм╣рм╛рмдрнБрмбрм┐, рм╣рм╛рмдрнБрмбрм┐ рмПрммрмВ рм░рнЗрмЮрнНрмЪрм┐
ЁЯЧб => ЁЯЧб, рмЫрнБрм░рм╛, рмЫрнБрм░рнА ред рмЕрм╕рнНрмдрнНрм░рм╢рм╕рнНрмдрнНрм░
тЪФ => тЪФ, рмЕрм╕рнНрмдрнНрм░рм╢рм╕рнНрмдрнНрм░, рмЦрмгрнНрмбрм╛рмЧрнБрмбрм┐рмХ, рмЫрмХрм┐рмпрнБрмХрнНрмд, рмЫрмХрм┐рмпрнБрмХрнНрмд рмЦрмгрнНрмбрм╛рмЧрнБрмбрм┐рмХ
ЁЯФл => ЁЯФл, рмЧрмирнН, рмкрм┐рм╕рнНрмдрм▓, рмкрм┐рм╕рнНрмдрм▓рнН, рм░рм┐рмнрнЛрм▓рнНтАМрмнрм░рнН
ЁЯП╣ => ЁЯП╣, рмдрнАрм░, рмзрмирнБ, рмзрмирнБ рмПрммрмВ рмдрнАрм░, рмзрмирнБ рм░рм╛рм╢рм┐, рмзрмирнБрм░рнНрмжрнНрмзрм░, рмзрмирнБрм░рнНрммрм┐рмжрнНрнЯрм╛, рмпрмирнНрмдрнНрм░рмкрм╛рмдрм┐, рм░рм╛рм╢рм┐ рмЪрмХрнНрм░, рм╣рмдрм┐рмЖрм░
ЁЯЫб => ЁЯЫб, рмЕрм╕рнНрмдрнНрм░рм╢рм╕рнНрмдрнНрм░, рмврм╛рм▓
ЁЯФз => ЁЯФз, рмЙрмкрмХрм░рмг, рм░рнЗрмЮрнНрмЪрм┐
ЁЯФй => ЁЯФй, рмЙрмкрмХрм░рмг, рмирмЯрнН, рмирмЯрнНтАМ рмПрммрмВ рммрнЛрм▓рнНрмЯ, рмирмЯрнН рмПрммрмВ рммрнЛрм▓рнНрмЯрнН, рммрнЛрм▓рнНрмЯрнН
тЪЩ => тЪЩ, рмЧрм┐рнЯрм░рнНтАМ, рмпрмирнНрмдрнНрм░рмкрм╛рмдрм┐
ЁЯЧЬ => ЁЯЧЬ, рмХрморнНрмкрнНрм░рнЗрм╕рнНтАМ, рмХрнНрм▓рм╛рморнНрмк, рмнрм╛рмЗрм╕рнНтАМ, рмпрмирнНрмдрнНрм░рмкрм╛рмдрм┐
тЪЧ => тЪЧ, рмПрм▓рнЗрморнНрммрм┐рмХрнНтАМ, рмХрнЗрморм┐рм╖рнНрмЯрнНрм░рм┐, рмпрмирнНрмдрнНрм░рмкрм╛рмдрм┐
тЪЦ => тЪЦ, рмУрмЬрми, рмдрнБрм│рм╛ рм░рм╛рм╢рм┐, рмирнНрнЯрм╛рнЯ, рмнрм╛рм░рм╕рм╛рморнНрнЯ, рмнрм╛рм░рм╕рм╛рморнНрнЯ рм╕рнНрмХрнЗрм▓рнНтАМ, рмпрмирнНрмдрнНрм░рмкрм╛рмдрм┐, рм░рм╛рм╢рм┐ рмЪрмХрнНрм░, рм╕рнНрмХрнЗрм▓рнНтАМрмЧрнБрмбрм┐рмХ
ЁЯФЧ => ЁЯФЧ, рмжрнБрмЗрмЯрм┐ рм░рм┐рмВ, рм▓рм┐рмЩрнНрмХрнНтАМ, рм▓рм┐рмЩрнНрмХрнН рмЪрм┐рм╣рнНрми
тЫУ => тЫУ, рмЪрнЗрмирнНтАМ, рмЪрнЗрмирнНтАМрмЧрнБрмбрм┐рмХ
ЁЯТЙ => ЁЯТЙ, рмФрм╖рмз, рмЫрнБрмЮрнНрмЪрм┐, рмбрм╛рмХрнНрмдрм░, рм╢рмЯрнНтАМ, рм╕рм┐рм░рм┐рмЮрнНрмЬ
ЁЯТК => ЁЯТК, рмФрм╖рмз, рмбрм╛рмХрнНрмдрм░, рммрмЯрм┐рмХрм╛
ЁЯЪм => ЁЯЪм, рмЪрм┐рм╣рнНрми, рмзрнВрмормкрм╛рми, рмзрнВрмормкрм╛рми рмЕрмирнБрморнЛрмжрм┐рмд, рмзрнВрмормкрм╛рми рмЪрм┐рм╣рнНрми, рм╕рм┐рмЧрм╛рм░рнЗрмЯрнНтАМ
тЪ░ => тЪ░, рмХрмлрм┐рмирнНтАМ, рморнГрмдрнНрнЯрнБ
тЪ▒ => тЪ▒, рмЕрм░рнНрмирнНтАМ, рмкрм╛рмЙрмБрм╢, рморнГрмдрнНрнЯрнБ, рм╢рмм рм╕рмдрнНрмХрм╛рм░, рм╢рмм рм╕рмдрнНрмХрм╛рм░ рмЕрм░рнНрмирнНтАМ
ЁЯЧ┐ => ЁЯЧ┐, рморнЛрмЖрмЗ, рморнЛрнЯрм╛рмЗ, рморнЛрнЯрм╛рмЗ рм╖рнНрмЯрнЗрмЪрнНрнЯрнБ, рм╖рнНрмЯрнЗрмЪрнНрнЯрнБ
ЁЯЫв => ЁЯЫв, рмбрнНрм░рморнНтАМ ред рмдрнЗрм▓, рмдрнЗрм▓ рмбрнНрм░рморнНтАМ
ЁЯФо => ЁЯФо, рмХрнНрм░рм┐рм╖рнНрмЯрм╛рм▓рнН, рмХрнНрм░рм┐рм╖рнНрмЯрм╛рм▓рнН рммрм▓рнН, рмлрм░рнНрмЪрнНрнЯрнБрмирнН, рмлрм░рнНрмЪрнНрнЯрнБрмирнН рмЯрнЗрм▓рм┐рмВ, рммрм▓рнН, рм╕рнНрмкрмЯрм┐рмХ рмкрнЗрмгрнНрмбрнБ
ЁЯЫТ => ЁЯЫТ, рм╢рмкрм┐рмВ ред рмХрм╛рм░рнНрмЯрнНтАМ ред рмЯрнНрм░рм▓рм┐, рм╢рмкрм┐рмВ рмХрм╛рм░рнНрмЯрнНтАМ
ЁЯПз => ЁЯПз, atm, ATM рмЪрм┐рм╣рнНрми, рммрнНрнЯрм╛рмЩрнНрмХ ред рмЯрнЗрм▓рм░рнНтАМ, рм╕рнНрн▒рмЪрм╛рм│рм┐рмд
ЁЯЪо => ЁЯЪо, рмЕрммрм░рнНрмЬрмирм╛, рмЕрммрм░рнНрмЬрмирм╛ рммрм╛рмХрнНрм╕, рмЕрм│рм┐рмЖ рмбрммрм╛рм░рнЗ рмлрм┐рмЩрнНрмЧрм┐рммрм╛ рмЪрм┐рм╣рнНрми
ЁЯЪ░ => ЁЯЪ░, рмкрм╛рмдрнНрм░рм░рнЗ рмнрм░рм┐рммрм╛ рмпрнЛрмЧрнНрнЯ рмЬрм│, рмкрм╛рмирнАрнЯ ред рмкрм╛рмдрнНрм░рм░рнЗ рмнрм░рм┐рммрм╛рмпрнЛрмЧрнНрнЯ ред рмЬрм│
тЩ┐ => тЩ┐, рмкрнНрм░рммрнЗрм╢, рм╣рнБрмЗрм▓рмЪрнЗрнЯрм╛рм░рнНтАМ рм╕рмЩрнНрмХрнЗрмд
ЁЯЪ╣ => ЁЯЪ╣, wc, рмЖрм░рм╛рмормХрмХрнНрм╖, рмкрм╛рмЗрмЦрм╛рмирм╛, рмкрнБрм░рнБрм╖, рмкрнБрм░рнБрм╖рмЩрнНрмХ рмХрмХрнНрм╖
ЁЯЪ║ => ЁЯЪ║, wc, рмЖрм░рм╛рмормХрмХрмХрнНрм╖, рмкрм╛рмЗрмЦрм╛рмирм╛, рморм╣рм┐рм│рм╛, рморм╣рм┐рм│рм╛рмЩрнНрмХ рмХрмХрнНрм╖
ЁЯЪ╗ => ЁЯЪ╗, WC, рмЖрм░рм╛рмо рмХрмХрнНрм╖, рмЖрм░рм╛рмормХрмХрнНрм╖, рмкрм╛рмЗрмЦрм╛рмирм╛
ЁЯЪ╝ => ЁЯЪ╝, рмЫрнЛрмЯ рмкрм┐рм▓рм╛ рм╕рмЩрнНрмХрнЗрмд, рммрмжрм│рм╛рмЗрммрм╛, рм╢рм┐рм╢рнБ
ЁЯЪ╛ => ЁЯЪ╛, wc, рмЖрм░рм╛рмормХрмХрнНрм╖, рмЬрм│, рмкрм╛рмЗрмЦрм╛рмирм╛, рм╢рнМрмЪрм╛рм│рнЯ
ЁЯЫВ => ЁЯЫВ, рмирм┐рнЯрмирнНрмдрнНрм░рмг, рмкрм╛рм╕рнНтАМрмкрнЛрм░рнНрмЯ, рмкрм╛рм╕рнНтАМрмкрнЛрм░рнНрмЯ рмирм┐рнЯрмирнНрмдрнНрм░рмг
ЁЯЫГ => ЁЯЫГ, рмХрм╖рнНрмЯрморм╕рнНтАМ
ЁЯЫД => ЁЯЫД, рмЬрм┐рмирм┐рм╖рмкрмдрнНрм░, рмЬрм┐рмирм┐рм╖рмкрмдрнНрм░ рмжрм╛рммрм┐, рмжрм╛рммрм┐
ЁЯЫЕ => ЁЯЫЕ, рмЫрм╛рмбрм┐рмерм┐рммрм╛ рмЬрм┐рмирм┐рм╖рмкрмдрнНрм░, рмЬрм┐рмирм┐рм╖рмкрмдрнНрм░, рморм╛рм▓рмкрмдрнНрм░, рм▓рмХрм░рнНтАМ
тЪа => тЪа, рмЪрнЗрмдрм╛рммрмирнА
ЁЯЪ╕ => ЁЯЪ╕, рмЯрнНрм░рм╛рмлрм┐рмХрнНтАМ, рмкрмермЪрм╛рм░рнА, рмкрм┐рм▓рм╛, рмкрм┐рм▓рм╛рморм╛рмирнЗ рм░рм╛рм╕рнНрмдрм╛ рмкрм╛рм░рнНтАМ рм╣рнЗрммрм╛, рм░рм╛рм╕рнНрмдрм╛ рмкрм╛рм░рнНтАМ рм╣рнЗрммрм╛
тЫФ => тЫФ, рмЯрнНрм░рм╛рмлрм┐рмХрнНтАМ, рмирм╛, рмирм╛рм╣рм┐рмБ, рмирм┐рм╖рм┐рмжрнНрмз, рмирм┐рм╖рнЗрмзрм┐рмд, рмкрнНрм░рммрнЗрм╢, рмкрнНрм░рммрнЗрм╢ рмирм┐рм╖рнЗрмз
ЁЯЪл => ЁЯЪл, рмирм╛, рмирм╛рм╣рм┐рмБ, рмирм┐рм╖рм┐рмжрнНрмз, рмирм┐рм╖рнЗрмзрм┐рмд, рмкрнНрм░рммрнЗрм╢
ЁЯЪ│ => ЁЯЪ│, рмирм╛, рмирм╛рм╣рм┐рмБ, рмирм┐рм╖рм┐рмжрнНрмз, рмирм┐рм╖рнЗрмзрм┐рмд, рммрм╛рмЗрмХрнНтАМ, рммрм╛рмЗрм╕рм╛рмЗрмХрнЗрм▓рнНтАМ, рммрм╛рмЗрм╕рнЗрмЗрмХрнЗрм▓рнНтАМ рмирм┐рм╖рнЗрмз
ЁЯЪн => ЁЯЪн, рмзрнВрмормкрм╛рми, рмзрнВрмормкрм╛рми рмирм┐рм╖рнЗрмз, рмирм╛, рмирм╛рм╣рм┐рмБ, рмирм┐рм╖рм┐рмжрнНрмз, рмирм┐рм╖рнЗрмзрм┐рмд
ЁЯЪп => ЁЯЪп, рмЖрммрм░рнНрмЬрмирм╛ рмлрм┐рмЩрнНрмЧрм┐рммрм╛, рмЖрммрм░рнНрмЬрмирм╛ рмлрм┐рмЩрнНрмЧрм┐рммрм╛ рмирм┐рм╖рнЗрмз, рмирм╛, рмирм╛рм╣рм┐рмБ, рмирм┐рм╖рм┐рмжрнНрмз, рмирм┐рм╖рнЗрмзрм┐рмд
ЁЯЪ▒ => ЁЯЪ▒, рмЕрмг-рмкрм╛рмирнАрнЯ, рмЬрм│, рмкрм╛рмдрнНрм░рм░рнЗ рмнрм░рм┐рммрм╛ рмЕрмпрнЛрмЧрнНрнЯ, рмкрм╛рмдрнНрм░рм░рнЗ рмнрм░рм┐рммрм╛ рмЕрмпрнЛрмЧрнНрнЯ рмЬрм│
ЁЯЪ╖ => ЁЯЪ╖, рмирм┐рм╖рнЗрмзрм┐рмд ред рмирм╛ ред рмирм╛рм╣рм┐рмБ ред рмкрмермЪрм╛рм░рнА ред рмирм┐рм╖рм┐рмжрнНрмз, рмкрмермЪрм╛рм░рнА рмирм┐рм╖рм┐рмжрнНрмз
ЁЯУ╡ => ЁЯУ╡, рмЯрнЗрм▓рм┐рмлрнЛрмирнНтАМ, рмирм╛, рмирм╛рм╣рм┐рмБ, рмирм┐рм╖рм┐рмжрнНрмз, рмирм┐рм╖рнЗрмзрм┐рмд, рмлрнЛрмирнНтАМ, рморнЛрммрм╛рмЗрм▓рнНтАМ, рморнЛрммрм╛рмЗрм▓рнНтАМ рмлрнЛрмирнНтАМ рмирм┐рм╖рм┐рмжрнНрмз, рм╕рнЗрм▓рнНтАМ
ЁЯФЮ => ЁЯФЮ, 18, рмЕрмарм░, рмЕрмарм░ рммрм░рнНрм╖рм░рнБ рмХрморнНтАМ рмХрнЗрм╣рм┐ рмирм╛рм╣рм╛рмБрмирнНрмдрм┐, рмХрморнНтАМ рммрнЯрм╕рнНрмХ, рмирм╛, рмирм╛рм╣рм┐рмБ, рмирм┐рм╖рм┐рмжрнНрмз, рмирм┐рм╖рнЗрмзрм┐рмд, рммрнЯрм╕ рмкрнНрм░рмдрм┐рммрмирнНрмзрмХ
тШв => тШв, рмЪрм┐рм╣рнНрми, рм░рнЗрмбрм┐рмУрмЖрмХрнНрмЯрм┐рмнрнНтАМ
тШг => тШг, рмЪрм┐рм╣рнНрми, рмЬрнИрмм рммрм┐рмкрмж
тмЖ => тмЖ, рмЙрмкрм░ рмдрнАрм░, рмдрнАрм░, рмжрм┐рмЧ, рмкрнВрм░рнНрмм, рмкрнНрм░рмзрм╛рми
тЖЧ => тЖЧ, рмЕрмирнНрмдрмГрмкрнНрм░рмзрм╛рми, рмЙрмдрнНрмдрм░рмкрнВрм░рнНрмм, рмЙрмкрм░-рмбрм╛рм╣рм╛рмг рмдрнАрм░, рмдрнАрм░, рмжрм┐рмЧ
тЮб => тЮб, рмбрм╛рм╣рм╛рмг рмдрнАрм░, рмдрнАрм░, рмжрм┐рмЧ, рмкрнВрм░рнНрмм, рмкрнНрм░рмзрм╛рми
тЖШ => тЖШ, рмЕрмирнНрмдрмГрмкрнНрм░рмзрм╛рми, рмдрм│-рмбрм╛рм╣рм╛рмг рмдрнАрм░, рмдрнАрм░, рмжрмХрнНрм╖рм┐рмгрмкрнВрм░рнНрмм, рмжрм┐рмЧ
тмЗ => тмЗ, рмдрм│, рмдрм│ рмдрнАрм░, рмдрнАрм░, рмжрмХрнНрм╖рм┐рмг, рмжрм┐рмЧ, рмкрнНрм░рмзрм╛рми
тЖЩ => тЖЩ, рмЕрмирнНрмдрмГрмкрнНрм░рмзрм╛рми, рмдрм│-рммрм╛рмо рмдрнАрм░, рмдрнАрм░, рмжрмХрнНрм╖рм┐рмгрмкрм╢рнНрмЪрм┐рмо, рмжрм┐рмЧ
тмЕ => тмЕ, рмдрнАрм░, рмжрм┐рмЧ, рмкрм╢рнНрмЪрм┐рмо, рмкрнНрм░рмзрм╛рми, рммрм╛рмо рмдрнАрм░
тЖЦ => тЖЦ, рмЕрмирнНрмдрмГрмкрнНрм░рмзрм╛рми, рмЙрмдрнНрмдрм░рмкрм╢рнНрмЪрм┐рмо, рмЙрмкрм░-рммрм╛рмо рмдрнАрм░, рмдрнАрм░, рмжрм┐рмЧ
тЖХ => тЖХ, рмЙрмкрм░-рмдрм│ рмдрнАрм░, рмдрнАрм░
тЖФ => тЖФ, рмдрнАрм░, рммрм╛рмо-рмбрм╛рм╣рм╛рмг рмдрнАрм░
тЖй => тЖй, рмбрм╛рм╣рм╛рмг рмдрнАрм░ рммрм╛рмормХрнБ рморнЛрмбрм┐ рм╣рнЗрмЙрмЫрм┐, рмдрнАрм░
тЖк => тЖк, рмдрнАрм░, рммрм╛рмо рмдрнАрм░ рмбрм╛рм╣рм╛рмгрмХрнБ рморнЛрмбрм┐ рм╣рнЗрмЙрмЫрм┐
тд┤ => тд┤, рмбрм╛рм╣рм╛рмг рмдрнАрм░ рмЙрмкрм░рмХрнБ рморнЛрмбрм┐ рм╣рнЗрмЙрмЫрм┐, рмдрнАрм░
тд╡ => тд╡, рмбрм╛рм╣рм╛рмг рмдрнАрм░ рмдрм│рмХрнБ рморнЛрмбрм┐ рм╣рнЗрмЙрмЫрм┐, рмдрм│, рмдрнАрм░
ЁЯФГ => ЁЯФГ, рмШрмгрнНрмЯрм╛рмХрмгрнНрмЯрм╛ рмШрнВрм░рм┐рммрм╛ рмжрм┐рмЧрм░рнЗ, рмШрмгрнНрмЯрм╛рмХрмгрнНрмЯрм╛ рмШрнВрм░рм┐рммрм╛ рмжрм┐рмЧрм░рнЗ рмнрнВрм▓рморнНрмм рмдрнАрм░рмЧрнБрмбрм┐рмХ, рмдрнАрм░, рмкрнБрмирмГрм▓рнЛрмбрнН
ЁЯФД => ЁЯФД, рмШрмгрнНрмЯрм╛рмХрмгрнНрмЯрм╛ рмШрнВрм░рм┐рммрм╛рм░ рммрм┐рмкрм░рнАрмд рмжрм┐рмЧрм░рнЗ, рмШрмгрнНрмЯрм╛рмХрмгрнНрмЯрм╛рм░ рмШрнВрм░рм┐рммрм╛рм░ рммрм┐рмкрм░рнАрмд рмжрм┐рмЧрм░рнЗ рмдрнАрм░ рммрмЯрмирнНтАМ, рмШрмгрнНрмЯрм╛рмХрмгрнНрмЯрм╛рм░ рммрм┐рмкрм░рнАрмд рмжрм┐рмЧрм░рнЗ, рмдрнАрм░, рн▒рм┐рмжрм░рм╢рм┐рмирнНрм╕
ЁЯФЩ => ЁЯФЩ, рмдрнАрм░, рмкрмЫ, рмкрмЫ рмдрнАрм░
ЁЯФЪ => ЁЯФЪ, рмдрнАрм░, рм╢рнЗрм╖, рм╢рнЗрм╖ рмдрнАрм░
ЁЯФЫ => ЁЯФЫ, рмЕрмирнНтАМ, рмЕрмирнНтАМ! рмдрнАрм░, рмЪрм┐рм╣рнНрми, рмдрнАрм░
ЁЯФЬ => ЁЯФЬ, рмдрнАрм░, рм╢рнАрмШрнНрм░, рм╢рнАрмШрнНрм░ рмдрнАрм░
ЁЯФЭ => ЁЯФЭ, рмЙрмкрм░, рмдрнАрм░, рм╢рнАрм░рнНрм╖, рм╢рнАрм░рнНрм╖ рмдрнАрм░
ЁЯЫР => ЁЯЫР, рмзрм░рнНрмо, рмкрнВрмЬрм╛ рмХрм░рм┐рммрм╛, рмкрнВрмЬрм╛ рм╕рнНрмерм╛рми
тЪЫ => тЪЫ, рмирм╛рм╕рнНрмдрм┐рмХ, рмкрм░рморм╛рмгрнБ, рмкрм░рморм╛рмгрнБ рм╕рмЩрнНрмХрнЗрмд
ЁЯХЙ => ЁЯХЙ, рмУрморнНтАМ, рмзрм░рнНрмо, рм╣рм┐рмирнНрмжрнБ
тЬб => тЬб, рмЗрм╣рнБрмжрнА рмзрм░рнНрмо рм╕рморнНрммрмирнНрмзрнАрнЯ, рмЬрнНрнЯрнБ, рмбрнЗрмнрм┐рмбрнНтАМ, рмбрнЗрмнрм┐рмбрнН рмдрм╛рм░рм╛, рмдрм╛рм░рм╛, рмзрм░рнНрмо
тШ╕ => тШ╕, рмЪрмХрнНрм░, рмзрм░рнНрмо, рмзрм░рнНрморм░ рмЪрмХрнНрм░, рммрнМрмжрнНрмзрмзрм░рнНрморнА
тШп => тШп, рмдрм╛рмУ, рмдрм╛рмУрмзрм░рнНрморнА, рмзрм░рнНрмо, рнЯрм╛рмЩрнНрмЧ, рнЯрм┐рмирнНтАМ, рнЯрм┐рмирнНтАМ рнЯрм╛рмЩрнНрмЧ
тЬЭ => тЬЭ, рмХрнНрм░рнБрм╢, рмЦрнНрм░рнАрм╖рнНрмЯрм┐рмЖрмирнНтАМ, рмзрм░рнНрмо, рм▓рм╛рмЯрм┐рмирнНтАМ рмХрнНрм░рм╕рнНтАМ
тШж => тШж, рмЕрм░рнНрмернЛрмбрмХрнНрм╕ рмХрнНрм░рм╕рнНтАМ, рмХрнНрм░рнБрм╢, рмЦрнНрм░рнАрм╖рнНрмЯрм┐рмЖрмирнНтАМ, рмзрм░рнНрмо
тШк => тШк, рмЗрм╕рм▓рм╛рмо, рмдрм╛рм░рм╛ рмПрммрмВ рмЕрмкрнВрм░рнНрмгрнНрмг рмЪрмирнНрмжрнНрм░, рмзрм░рнНрмо, рморнБрм╕рм▓рморм╛рми
тШо => тШо, рм╢рм╛рмирнНрмдрм┐, рм╢рм╛рмирнНрмдрм┐ рм╕рмЩрнНрмХрнЗрмд
ЁЯХО => ЁЯХО, рмХрм╛рмгрнНрмбрнЗрм▓рммрнНрм░рморнНтАМ, рмзрм░рнНрмо, рморм╣рморммрмдрм┐, рморнЗрмирнЛрм░рм╛рм╣
ЁЯФп => ЁЯФп, рмдрм╛рм░рм╛, рмлрм░рнНрмЪрнНрнЯрнВрмирнНтАМ, рммрм┐рмирнНрмжрнБрмпрнБрмХрнНрмд рмЫрмЕ-рмкрмПрмгрнНрмЯ рммрм┐рм╢рм┐рм╖рнНрмЯ рмдрм╛рм░рм╛
тЩИ => тЩИ, рморнЗрмгрнНрмврм╛ ред рм░рм╛рм╢рм┐рмЪрмХрнНрм░, рморнЗрм╖
тЩЙ => тЩЙ, рммрм│рмж, рммрнГрм╖, рм░рм╛рм╢рм┐рмЪрмХрнНрм░, рм╖рмгрнНрмв
тЩК => тЩК, рмЬрм╛рмЖрмБрм│рм╛ ред рм░рм╛рм╢рм┐рмЪрмХрнНрм░, рморм┐рмернБрми
тЩЛ => тЩЛ, рмХрмЩрнНрмХрмбрм╛ ред рм░рм╛рм╢рм┐рмЪрмХрнНрм░, рмХрм░рнНрмХрмЯ
тЩМ => тЩМ, рм╕рм┐рмВрм╣, рм╕рм┐рмВрм╣ ред рм░рм╛рм╢рм┐рмЪрмХрнНрм░
тЩН => тЩН, рмХрмирнНрнЯрм╛, рм░рм╛рм╢рм┐рмЪрмХрнНрм░
тЩО => тЩО, рмдрнБрм│рм╛, рмирнНрнЯрм╛рнЯ, рмнрм╛рм░рм╕рм╛рморнНрнЯ, рм░рм╛рм╢рм┐ рмЪрмХрнНрм░, рм╕рнНрмХрнЗрм▓рнНтАМ
тЩП => тЩП, рммрм┐рмЫрм╛, рммрнГрм╢рнНрмЪрм┐рмХ рм░рм╛рм╢рм┐, рм░рм╛рм╢рм┐рмЪрмХрнНрм░
тЩР => тЩР, рмзрмирнБ, рмзрмирнБрм░рнНрмжрнНрмзрм░, рм░рм╛рм╢рм┐рмЪрмХрнНрм░
тЩС => тЩС, рмЫрнЗрм│рм┐, рмормХрм░, рм░рм╛рм╢рм┐рмЪрмХрнНрм░
тЩТ => тЩТ, рмХрнБрморнНрмн, рмЬрм│, рммрм╛рм╣рмХ, рм░рм╛рм╢рм┐рмЪрмХрнНрм░
тЩУ => тЩУ, рморм╛рмЫ, рморнАрми, рм░рм╛рм╢рм┐рмЪрмХрнНрм░
тЫО => тЫО, рмУрмлрм┐рмЙрмЪрнБрм╕рнНтАМ, рммрмб рм╕рм╛рмк, рммрм╛рм╣рмХ, рм░рм╛рм╢рм┐рмЪрмХрнНрм░, рм╕рм╛рмк
ЁЯФА => ЁЯФА, рмЫрмХрм┐ рмкрмбрм┐рмерм┐рммрм╛, рмдрнАрм░, рм╕рмлрм▓рнНтАМ рмЯрнНрм░рм╛рмХрнНтАМ рммрмЯрмирнНтАМ
ЁЯФБ => ЁЯФБ, рмШрмгрнНрмЯрм╛рмХрмгрнНрмЯрм╛ рмШрнВрм░рм┐рммрм╛ рмжрм┐рмЧрм░рнЗ, рмдрнАрм░, рмжрнЛрм╣рм░рм╛рмЗрммрм╛, рмжрнЛрм╣рм░рм╛рмЗрммрм╛ рммрмЯрмирнНтАМ
ЁЯФВ => ЁЯФВ, рмШрмгрнНрмЯрм╛рмХрмгрнНрмЯрм╛ рмШрнВрм░рм┐рммрм╛ рмжрм┐рмЧрм░рнЗ, рмдрнАрм░, рмерм░рнЗ, рмжрнЛрм╣рм░рм╛рмЗрммрм╛ рмПрмХрмХ рммрмЯрмирнНтАМ
тЦ╢ => тЦ╢, рмЪрм╛рм│рми, рмЪрм╛рм│рми рммрмЯрмирнНтАМ, рмбрм╛рм╣рм╛рмг, рмдрнАрм░, рмдрнНрм░рм┐рмнрнБрмЬ
тПй => тПй, рмЕрмЧрнНрм░рмЧрм╛рморнА, рмдрнАрм░, рмжрнБрмЗрмерм░, рмжрнНрм░рнБрмд, рмжрнНрм░рнБрмд-рмЕрмЧрнНрм░рмЧрм╛рморнА рммрмЯрмирнНтАМ
тПн => тПн, рмдрнАрм░, рмдрнНрм░рм┐рмнрнБрмЬ, рмкрм░рммрм░рнНрмдрнНрмдрнА рмЯрнНрм░рм╛рмХрнНтАМ, рмкрм░рммрм░рнНрмдрнНрмдрнА рмЯрнНрм░рм╛рмХрнНтАМ рммрмЯрмирнНтАМ, рмкрм░рммрм░рнНрмдрнНрмдрнА рм╕рм┐рмирнНтАМ
тПп => тПп, рмЪрм╛рм│рми, рмЪрм╛рм│рми рмХрм┐рморнНрммрм╛ рммрм┐рм░рм╛рмо рммрмЯрмирнНтАМ, рмбрм╛рм╣рм╛рмг, рмдрнАрм░, рмдрнНрм░рм┐рмнрнБрмЬ, рммрм┐рм░рм╛рмо
тЧА => тЧА, рмдрнАрм░, рмдрнНрм░рм┐рмнрнБрмЬ, рммрм╛рмо, рммрм┐рмкрм░рнАрмд, рммрм┐рмкрм░рнАрмд рммрмЯрмирнНтАМ
тПк => тПк, рмдрнАрм░, рмжрнБрмЗрмерм░, рмжрнНрм░рнБрмд рммрм┐рмкрм░рнАрмд рммрмЯрмирнНтАМ, рм░рм┐рн▒рм╛рмЗрмгрнНрмб
тПо => тПо, рмдрнАрм░, рмдрнНрм░рм┐рмнрнБрмЬ, рмкрнВрм░рнНрммрммрм░рнНрмдрнНрмдрнА рмЯрнНрм░рм╛рмХрнНтАМ, рмкрнВрм░рнНрммрммрм░рнНрмдрнНрмдрнА рмжрнГрм╢рнНрнЯ, рм╢рнЗрм╖ рмЯрнНрм░рм╛рмХрнНтАМ рммрмЯрмирнНтАМ
ЁЯФ╝ => ЁЯФ╝, рмЙрмкрм░ рммрмЯрмирнНтАМ, рмдрнАрм░, рммрмЯрмирнНтАМ, рм▓рм╛рм▓рнНтАМ
тПл => тПл, рмдрнАрм░, рмжрнБрмЗ рмерм░, рмжрнНрм░рнБрмд рмЙрмкрм░ рммрмЯрмирнНтАМ
ЁЯФ╜ => ЁЯФ╜, рмдрм│, рмдрм│ рммрмЯрмирнНтАМ, рмдрнАрм░, рммрмЯрмирнНтАМ, рм▓рм╛рм▓рнНтАМ
тПм => тПм, рмдрм│, рмдрнАрм░, рмжрнБрмЗрмерм░, рмжрнНрм░рнБрмд рмдрм│ рммрмЯрмирнНтАМ
тП╕ => тП╕, рмжрмгрнНрмбрм┐рмХрм╛, рмжрнБрмЗрмерм░, рммрм┐рм░рм╛рмо, рммрм┐рм░рм╛рмо рммрмЯрмирнНтАМ, рмнрнВрм▓рморнНрмм
тП╣ => тП╣, рммрм░рнНрмЧрмХрнНрм╖рнЗрмдрнНрм░, рм╕рнНрмермЧрм┐рмд, рм╕рнНрмермЧрм┐рмд рммрмЯрмирнНтАМ
тП║ => тП║, рммрнГрмдрнНрмд, рм░рнЗрмХрм░рнНрмб, рм░рнЗрмХрм░рнНрмб рммрмЯрмирнНтАМ
тПП => тПП, рмЗрмЬрнЗрмХрнНрмЯ, рмЗрмЬрнЗрмХрнНрмЯ рммрмЯрмирнНтАМ
ЁЯОж => ЁЯОж, рмХрнНрнЯрм╛рморнЗрм░рм╛, рмлрм┐рм▓рнНрмо, рморнБрмнрм┐, рм╕рм┐рмирнЗрморм╛
ЁЯФЕ => ЁЯФЕ, рмЙрмЬрнНрмЬрнНрн▒рм│рмдрм╛, рмХрморнНтАМ, рмХрнНрм╖рнАрмг, рмХрнНрм╖рнАрмг рммрмЯрмирнНтАМ
ЁЯФЖ => ЁЯФЖ, рмЙрмЬрнНрмЬрнНрн▒рм│, рмЙрмЬрнНрмЬрнНрн▒рм│ рммрмЯрмирнНтАМ, рмЙрмЬрнНрмЬрнНрн▒рм│рмдрм╛
ЁЯУ╢ => ЁЯУ╢, рмЖрмгрнНрмЯрм┐рмирм╛, рмЖрмгрнНрмЯрм┐рмирм╛ рмжрмгрнНрмбрм┐рмХрм╛рмЧрнБрмбрм┐рмХ, рмЯрнЗрм▓рм┐рмлрнЛрмирнНтАМ, рмжрмгрнНрмбрм┐рмХрм╛, рмлрнЛрмирнН, рморнЛрммрм╛рмЗрм▓рнНтАМ, рм╕рмЩрнНрмХрнЗрмд, рм╕рнЗрм▓рнНтАМ
ЁЯУ│ => ЁЯУ│, рмХрморнНрмкрми, рмХрморнНрмкрми рморнЛрмбрнНтАМ, рмЯрнЗрм▓рм┐рмлрнЛрмирнНтАМ, рмлрнЛрмирнНтАМ, рморнЛрмбрнНтАМ, рморнЛрммрм╛рмЗрм▓рнНтАМ, рм╕рнЗрм▓рнНтАМ
ЁЯУ┤ => ЁЯУ┤, рмЕрмлрнНтАМ, рмЯрнЗрм▓рм┐рмлрнЛрмирнНтАМ, рмлрнЛрмирнНтАМ, рморнЛрммрм╛рмЗрм▓рнНтАМ, рморнЛрммрм╛рмЗрм▓рнНтАМ рмлрнЛрмирнНтАМ рмЕрмлрнНтАМ, рм╕рнЗрм▓рнНтАМ
тЩА => тЩА, рморм╣рм┐рм│рм╛, рм╕рнНрмдрнНрм░рнА рмЬрм╛рмдрнАрнЯ рмЪрм┐рм╣рнНрми
тЩВ => тЩВ, рмкрнБрм░рнБрм╖, рмкрнБрм░рнБрм╖ рмЪрм┐рм╣рнНрми
тЪХ => тЪХ, рмПрм╕рнБрм▓рм╛рмкрм┐рнЯрм╕, рмФрм╖рмз, рмХрм░рнНрмормЪрм╛рм░рнА, рмбрм╛рмХрнНрмдрм░рнА рм╕рмЩрнНрмХрнЗрмд
тЩ╗ => тЩ╗, рмирммрнАрмХрм░рмг рмХрм░рм┐рммрм╛ рм╕рмЩрнНрмХрнЗрмд, рм░рм┐рм╕рм╛рмЗрмХрнЗрм▓рнН
тЪЬ => тЪЬ, рмлрнНрм▓рм┐рмЙрм░рнНтАМ-рмбрм┐-рм▓рм┐рм╕рнНтАМ
ЁЯФ▒ => ЁЯФ▒, рмЖрмЩрнНрмХрм░рнНтАМ, рмЬрм╛рм╣рм╛рмЬ, рмдрнНрм░рм┐рм╢рнВрм│, рмдрнНрм░рм┐рм╢рнВрм│ рмкрнНрм░рмдрнАрмХ, рмкрнНрм░рмдрнАрмХ, рмпрмирнНрмдрнНрм░рмкрм╛рмдрм┐
ЁЯУЫ => ЁЯУЫ, рмирм╛рмо, рмирм╛рмо рммрнНрнЯрм╛рмЬрнНтАМ, рммрнНрнЯрм╛рмЬрнН
ЁЯФ░ => ЁЯФ░, рмЪрнЗрмнрнНрм░рмирнНтАМ, рмЬрм╛рмкрм╛рмирнАрнЯ, рмирнВрмЖ рм╢рм┐рмЦрм╛рм│рм┐рмЩрнНрмХ рмкрм╛рмЗрмБ рмЬрм╛рмкрм╛рмирнАрнЯ рм╕рмЩрнНрмХрнЗрмд, рмкрмдрнНрм░, рмпрмирнНрмдрнНрм░рмкрм╛рмдрм┐, рм╢рм┐рмХрнНрм╖рм╛рм░рнНрмернА, рм╕рммрнБрмЬ, рм╣рм│рмжрм┐рмЖ
тнХ => тнХ, o, рмЧрм╛рмв рммрмб рммрнГрмдрнНрмд, рммрнГрмдрнНрмд
тЬЕ => тЬЕ, рмЪрм┐рм╣рнНрми, рмзрм│рм╛ рмЧрм╛рмв рмпрм╛рмЮрнНрмЪ рмЪрм┐рм╣рнНрми, рмпрм╛рмЮрнНрмЪ
тШС => тШС, рммрм╛рмХрнНрм╕, рммрм╛рм▓рм╛рмЯрнНтАМ, рмпрм╛рмЮрнНрмЪ, рмпрм╛рмЮрнНрмЪ рмЪрм┐рм╣рнНрми рм╕рм╣рм┐рмд рммрм╛рм▓рм╛рмЯрнНтАМ рммрм╛рмХрнНрм╕
тЬФ => тЬФ, рмЧрм╛рмв рмпрм╛рмЮрнНрмЪ рмЪрм┐рм╣рнНрми, рмпрм╛рмЮрнНрмЪ ред рмЪрм┐рм╣рнНрми
тЬЦ => тЬЦ, x, рмЧрм╛рмв рмЧрнБрмгрми x, рмЧрнБрмгрми, рмЧрнБрмгрми рмХрм░рм┐рммрм╛, рммрм╛рмдрм┐рм▓рнНтАМ
тЭМ => тЭМ, x, рмЧрнБрмгрми, рмЧрнБрмгрми рмХрм░рм┐рммрм╛, рмЪрм┐рм╣рнНрми, рмЫрмХрм┐ рмЪрм┐рм╣рнНрми, рммрм╛рмдрм┐рм▓рнНтАМ
тЭО => тЭО, рмЪрм┐рм╣рнНрми ред рммрм░рнНрмЧ, рмЫрмХрм┐ рмЪрм┐рм╣рнНрми рммрмЯрмирнНтАМ
тЮХ => тЮХ, рмЧрмгрм┐рмд, рмЧрм╛рмв рмпрнБрмХрнНрмд рмЪрм┐рм╣рнНрми, рмпрнБрмХрнНрмд
тЮЦ => тЮЦ, рмЧрмгрм┐рмд, рмЧрм╛рмв рмлрнЗрмбрм╛рмг рмЪрм┐рм╣рнНрми, рммрм┐рмпрнБрмХрнНрмд
тЮЧ => тЮЧ, рмЧрмгрм┐рмд, рмЧрм╛рмв рм╣рм░рмг рмЪрм┐рм╣рнНрми, рммрм┐рмнрмХрнНрмд
тЮ░ => тЮ░, рмХрм░рнНрм▓рнНтАМ, рмХрнБрмЯрнАрм│ рммрмирнНрмзрмирнА, рм▓рнБрмкрнНтАМ
тЮ┐ => тЮ┐, рмХрм░рнНрм▓рнНтАМ, рмжрнБрмЗрмЯрм┐, рмжрнБрмЗрмЯрм┐ рмХрнБрмЯрнАрм│ рммрмирнНрмзрмирнА, рм▓рнБрмкрнНтАМ
уА╜ => уА╜, рмЕрмВрм╢, рмЕрмВрм╢ рммрм┐рмХрм│рнНрмк рмЪрм┐рм╣рнНрми, рмЪрм┐рм╣рнНрми
тЬ│ => тЬ│, рмЖрма-рмЦрм╛рмбрм┐ рмпрнБрмХрнНрмд рмдрм╛рм░рм╛рмХрнГрмдрм┐ рмЪрм┐рм╣рнНрми, рмдрм╛рм░рм╛рмХрнГрмдрм┐ рмЪрм┐рм╣рнНрми
тЬ┤ => тЬ┤, рмЖрма-рмкрмПрмгрнНрмЯрмпрнБрмХрнНрмд рмдрм╛рм░рм╛, рмдрм╛рм░рм╛
тЭЗ => тЭЗ, рмЭрм▓рм╕рм┐рммрм╛
тА╝ => тА╝, рмЪрм┐рм╣рнНрми, рмжрнБрмЗрмЯрм┐ рммрм┐рм╕рнНрморнЯрм╕рнВрмЪрмХ рмЪрм┐рм╣рнНрми, рммрм┐рм░рм╛рмо рмЪрм┐рм╣рнНрми, рммрм┐рм╕рнНрморнЯрм╕рнВрмЪрмХ, рммрнНрнЯрм╛рмЩрнНрмЧрммрнНрнЯрм╛рмЩрнНрмЧ
тБЙ => тБЙ, рмЗрмгрнНрмЯрнЗрм░рнЛрммрнНрнЯрм╛рмЩрнНрмЧ, рмЪрм┐рм╣рнНрми, рмкрнНрм░рм╢рнНрми, рммрм┐рм░рм╛рмо рмЪрм┐рм╣рнНрми, рммрм┐рм╕рнНрморнЯрм╕рнВрмЪрмХ, рммрм┐рм╕рнНрморнЯрм╕рнВрмЪрмХ рмкрнНрм░рм╢рнНрмирммрм╛рмЪрмХ рмЪрм┐рм╣рнНрми
тЭУ => тЭУ, рмЪрм┐рм╣рнНрми, рмкрнНрм░рм╢рнНрми, рмкрнНрм░рм╢рнНрмирммрм╛рмЪрмХ рмЪрм┐рм╣рнНрми, рммрм┐рм░рм╛рмо рмЪрм┐рм╣рнНрми
тЭФ => тЭФ, рмЪрм┐рм╣рнНрми ред рммрм╛рм╣рнНрнЯрм░рнЗрмЦрм╛рмХрнГрмд ред рммрм┐рм░рм╛рмо рмЪрм┐рм╣рнНрми ред рмкрнНрм░рм╢рнНрми, рмзрм│рм╛ рмкрнНрм░рм╢рнНрмирммрм╛рмЪрмХ рмЪрм┐рм╣рнНрми
тЭХ => тЭХ, рмЪрм┐рм╣рнНрми, рмзрм│рм╛ рммрм┐рм╕рнНрморнЯрм╕рнВрмЪрмХ рмЪрм┐рм╣рнНрми, рммрм╛рм╣рнНрнЯрм░рнЗрмЦрм╛рмХрнГрмд, рммрм┐рм░рм╛рмо рмЪрм┐рм╣рнНрми, рммрм┐рм╕рнНрморнЯрм╕рнВрмЪрмХ
тЭЧ => тЭЧ, рмЪрм┐рм╣рнНрми, рммрм╛рм╣рнНрнЯрм░рнЗрмЦрм╛рмпрнБрмХрнНрмд, рммрм┐рм░рм╛рмо рмЪрм┐рм╣рнНрми, рммрм┐рм╕рнНрморнЯрм╕рнВрмЪрмХ, рммрм┐рм╕рнНрморнЯрм╕рнВрмЪрмХ рмЪрм┐рм╣рнНрми
уА░ => уА░, рмХрнБрмгрнНрмбрм│рм╛рмХрм╛рм░ рмбрнНрнЯрм╛рм╢рнНтАМ, рмбрнНрнЯрм╛рм╢рнНтАМ ред рммрм┐рм░рм╛рмо рмЪрм┐рм╣рнНрми ред рмХрнБрмгрнНрмбрм│рм╛рмХрм╛рм░
┬й => ┬й, рмХрмкрм┐рм░рм╛рмЗрмЯрнНтАМ
┬о => ┬о, рмкрмЮрнНрмЬрм┐рмХрнГрмд
тДв => тДв, рмЪрм┐рм╣рнНрми, рмЯрм┐рмПрморнНтАМ, рмЯрнНрм░рнЗрмбрморм╛рм░рнНрмХрнНтАМ, рмЯрнНрм░рнЗрмбрнНтАМ рмЪрм┐рм╣рнНрми
ЁЯТп => ЁЯТп, 100, рмкрнВрм░рнНрмгрнНрмг, рм╢рм╣рнЗ, рм╢рм╣рнЗ рмкрмПрмгрнНрмЯ, рм╕рнНрмХрнЛрм░рнНтАМ
ЁЯФа => ЁЯФа, ABCD, рмЕрмХрнНрм╖рм░рмЧрнБрмбрм┐рмХ, рмЗрмирмкрнБрмЯрнНтАМ, рмЗрмирмкрнБрмЯрнНтАМ рм▓рм╛рмЯрм┐рмирнНтАМ рммрмб рмЕрмХрнНрм╖рм░, рммрмб рмЕрмХрнНрм╖рм░, рм▓рм╛рмЯрм┐рмирнНтАМ
ЁЯФб => ЁЯФб, abcd, рмЕрмХрнНрм╖рм░рмЧрнБрмбрм┐рмХ, рмЗрмирмкрнБрмЯрнНтАМ, рмЗрмирмкрнБрмЯрнНтАМ рм▓рм╛рмЯрм┐рмирнНтАМ рм╕рм╛рми рмЕрмХрнНрм╖рм░, рмЫрнЛрмЯ рмЕрмХрнНрм╖рм░, рм▓рм╛рмЯрм┐рмирнНтАМ
ЁЯФв => ЁЯФв, 1234, рмЗрмирмкрнБрмЯрнНтАМ, рмЗрмирмкрнБрмЯрнНтАМ рм╕рмВрмЦрнНрнЯрм╛рмЧрнБрмбрм┐рмХ, рм╕рмВрмЦрнНрнЯрм╛рмЧрнБрмбрм┐рмХ
ЁЯФг => ЁЯФг, уАТтЩк&%, рмЗрмирмкрнБрмЯрнНтАМ, рмЗрмирмкрнБрмЯрнНтАМ рм╕рмЩрнНрмХрнЗрмдрмЧрнБрмбрм┐рмХ
ЁЯФд => ЁЯФд, abc, рмЕрмХрнНрм╖рм░рмЧрнБрмбрм┐рмХ, рмЗрмирмкрнБрмЯрнНтАМ, рмЗрмирмкрнБрмЯрнНтАМ рм▓рм╛рмЯрм┐рмирнНтАМ рмЕрмХрнНрм╖рм░рмЧрнБрмбрм┐рмХ, рммрм░рнНрмгрнНрмгрморм╛рм│рм╛, рм▓рм╛рмЯрм┐рмирнНтАМ
ЁЯЕ░ => ЁЯЕ░, a, A рммрмЯрмирнНтАМ (рм░рмХрнНрмд рмкрнНрм░рмХрм╛рм░), рм░рмХрнНрмд рмкрнНрм░рмХрм╛рм░
ЁЯЖО => ЁЯЖО, ab, AB рммрмЯрмирнНтАМ (рм░рмХрнНрмд рмкрнНрм░рмХрм╛рм░), рм░рмХрнНрмд рмкрнНрм░рмХрм╛рм░
ЁЯЕ▒ => ЁЯЕ▒, b, B рммрмЯрмирнНтАМ (рм░рмХрнНрмд рмкрнНрм░рмХрм╛рм░), рм░рмХрнНрмд рмкрнНрм░рмХрм╛рм░
ЁЯЖС => ЁЯЖС, cl, CL рммрмЯрмирнНтАМ
ЁЯЖТ => ЁЯЖТ, рмЕрмдрм┐ рмЙрмдрнНрмХрнГрм╖рнНрмЯ, рмЕрмдрм┐ рмЙрмдрнНрмХрнГрм╖рнНрмЯ рммрмЯрмирнНтАМ
ЁЯЖУ => ЁЯЖУ, рморм╛рмЧрмгрм╛, рморм╛рмЧрмгрм╛ рммрмЯрмирнН
тД╣ => тД╣, i, рм╕рнВрмЪрмирм╛
ЁЯЖФ => ЁЯЖФ, id, ID рммрмЯрмирнНтАМ, рмкрм░рм┐рмЪрнЯ
тУВ => тУВ, m, рммрнГрмдрнНрмд, рммрнГрмдрнНрмд рмормзрнНрнЯрм░рнЗ M
ЁЯЖХ => ЁЯЖХ, рмирнВрмдрми, рмирнВрмдрми рммрмЯрмирнНтАМ
ЁЯЖЦ => ЁЯЖЦ, ng, NG рммрмЯрмирнНтАМ
ЁЯЕ╛ => ЁЯЕ╛, o, O рммрмЯрмирнНтАМ (рм░рмХрнНрмд рмкрнНрм░рмХрм╛рм░), рм░рмХрнНрмд рмкрнНрм░рмХрм╛рм░
ЁЯЖЧ => ЁЯЖЧ, OK рммрмЯрмирнНтАМ, рмУрмХрнЗ
ЁЯЕ┐ => ЁЯЕ┐, P рммрмЯрмирнН, рмкрм╛рм░рнНрмХрм┐рмВ
ЁЯЖШ => ЁЯЖШ, SOS рммрмЯрмирнН, рмЪрм┐рм╣рнНрми, рм╕рм╣рм╛рнЯрмдрм╛
ЁЯЖЩ => ЁЯЖЩ, UP! рммрмЯрмирнНтАМ, рмЪрм┐рм╣рнНрми ред рмЙрмкрм░
ЁЯЖЪ => ЁЯЖЪ, vs, VS рммрмЯрмирнНтАМ, рммрмирм╛рмо
ЁЯИБ => ЁЯИБ, тАЬрмПрмарм╛рм░рнЗтАЭ, рмХрмЯрмХрмгрм╛, рмЬрм╛рмкрм╛рмирнА, рмЬрм╛рмкрм╛рмирнА тАЬрмПрмарм╛рм░рнЗтАЭ рммрмЯрмирнНтАМ, уВ│уВ│
ЁЯИВ => ЁЯИВ, тАЬрм╕рнЗрммрм╛ рмжрнЗрнЯтАЭ, рмХрмЯрмХрмгрм╛, рмЬрм╛рмкрм╛рмирнА, рмЬрм╛рмкрм╛рмирнА тАЬрм╕рнЗрммрм╛ рмжрнЗрнЯтАЭ рммрмЯрмирнНтАМ, уВ╡
ЁЯИ╖ => ЁЯИ╖, тАЬрморм╛рм╕рм┐рмХ рм░рм╛рм╢рм┐тАЭ, рмЬрм╛рмкрм╛рмирнА, рмЬрм╛рмкрм╛рмирнА тАЬрморм╛рм╕рм┐рмХ рм░рм╛рм╢рм┐тАЭ рммрмЯрмирнНтАМ, рм╕рмЩрнНрмХрнЗрмд, цЬИ
ЁЯИ╢ => ЁЯИ╢, тАЬрмжрнЗрнЯ рморнБрмХрнНрмд рмирнБрм╣рнЗрмБтАЭ, рмЬрм╛рмкрм╛рмирнА, рмЬрм╛рмкрм╛рмирнА тАЬрмжрнЗрнЯ рморнБрмХрнНрмд рмирнБрм╣рнЗрмБтАЭ рммрмЯрмирнНтАМ, рм╕рмЩрнНрмХрнЗрмд, цЬЙ
ЁЯИп => ЁЯИп, тАЬрм╕рмВрм░рмХрнНрм╖рм┐рмдтАЭ, рмЬрм╛рмкрм╛рмирнА, рмЬрм╛рмкрм╛рмирнАрнЯ "рм╕рмВрм░рмХрнНрм╖рм┐рмдтАЭ рммрмЯрмирнНтАМ, рм╕рмЩрнНрмХрнЗрмд, цМЗ
ЁЯЙР => ЁЯЙР, тАЬрммрнБрмЭрм╛рмормгрм╛ рмХрм░рм┐рммрм╛тАЭ, рмЬрм╛рмкрм╛рмирнА, рмЬрм╛рмкрм╛рмирнА тАЬрммрнБрмЭрм╛рмормгрм╛ рмХрм░рм┐рммрм╛тАЭ рммрмЯрмирнНтАМ, рм╕рмЩрнНрмХрнЗрмд, х╛Ч
ЁЯИ╣ => ЁЯИ╣, тАЬрм░рм┐рм╣рм╛рмдрм┐тАЭ, рмЬрм╛рмкрм╛рмирнА, рмЬрм╛рмкрм╛рмирнА тАЬрм░рм┐рм╣рм╛рмдрм┐тАЭ рммрмЯрмирнНтАМ, рм░рм┐рм╣рм╛рмдрм┐, хЙ▓
ЁЯИЪ => ЁЯИЪ, тАЬрмжрнЗрнЯ рморнБрмХрнНрмдтАЭ, рмЬрм╛рмкрм╛рмирнА, рмЬрм╛рмкрм╛рмирнА тАЬрмжрнЗрнЯ рморнБрмХрнНрмдтАЭ рммрмЯрмирнНтАМ, рм╕рмЩрнНрмХрнЗрмд, чДб
ЁЯИ▓ => ЁЯИ▓, тАЬрмирм┐рм╖рм┐рмжрнНрмзтАЭ, рмЬрм╛рмкрм╛рмирнА, рмЬрм╛рмкрм╛рмирнА тАЬрмирм┐рм╖рм┐рмжрнНрмзтАЭ рммрмЯрмирнНтАМ, рм╕рмЩрнНрмХрнЗрмд, чжБ
ЁЯЙС => ЁЯЙС, тАЬрмЧрнНрм░рм╣рмгрнАрнЯтАЭ, рмЬрм╛рмкрм╛рмирнА, рмЬрм╛рмкрм╛рмирнА тАЬрмЧрнНрм░рм╣рмгрнАрнЯтАЭ рммрмЯрмирнНтАМ, рм╕рмЩрнНрмХрнЗрмд, хПп
ЁЯИ╕ => ЁЯИ╕, тАЬрмЖрмкрнНрм▓рм┐рмХрнЗрм╕рмирнНтАМтАЭ, рмЬрм╛рмкрм╛рмирнА, рмЬрм╛рмкрм╛рмирнА тАЬрмЖрмкрнНрм▓рм┐рмХрнЗрм╕рмирнНтАМтАЭ рммрмЯрмирнНтАМ, рм╕рмЩрнНрмХрнЗрмд, чФ│
ЁЯИ┤ => ЁЯИ┤, тАЬрмкрм╛рм╕рм┐рмВ рмЧрнНрм░рнЗрмбрнНтАМтАЭ, рмЬрм╛рмкрм╛рмирнА, рмЬрм╛рмкрм╛рмирнА тАЬрмкрм╛рм╕рм┐рмВ рмЧрнНрм░рнЗрмбрнНтАМтАЭ рммрмЯрмирнНтАМ, рм╕рмЩрнНрмХрнЗрмд, хРИ
ЁЯИ│ => ЁЯИ│, рмЬрм╛рмкрм╛рмирнА тАЬрмЦрм╛рм▓рм┐рмерм┐рммрм╛ рм╕рнНрмерм╛рмитАЭ рммрмЯрмирнНтАМ, рмЬрм╛рмкрм╛рмирнА тАЬрмкрм╛рм╕рм┐рмВ рмЧрнНрм░рнЗрмбрнНтАМтАЭ рммрмЯрмирнНтАМ
уКЧ => уКЧ, тАЬрмЕрмнрм┐рмирмирнНрмжрмитАЭ, рмЬрм╛рмкрм╛рмирнА, рмЬрм╛рмкрм╛рмирнА тАЬрмЕрмнрм┐рмирмирнНрмжрмитАЭ рммрмЯрмирнНтАМ, рм╕рмЩрнНрмХрнЗрмд, чеЭ
уКЩ => уКЩ, тАЬрмЧрнЛрмкрмирнАрнЯтАЭ, рмЬрм╛рмкрм╛рмирнА, рмЬрм╛рмкрм╛рмирнА тАЬрмЧрнЛрмкрмирнАрнЯтАЭ рммрмЯрмирнНтАМ, рм╕рмЩрнНрмХрнЗрмд, чзШ
ЁЯИ║ => ЁЯИ║, тАЬрммрнНрнЯрммрм╕рм╛рнЯ рмкрм╛рмЗрмБ рмЦрнЛрм▓рм╛тАЭ, рмЬрм╛рмкрм╛рмирнА, рмЬрм╛рмкрм╛рмирнА тАЬрммрнНрнЯрммрм╕рм╛рнЯ рмкрм╛рмЗрмБ рмЦрнЛрм▓рм╛тАЭ рммрмЯрмирнНтАМ, рм╕рмЩрнНрмХрнЗрмд, хЦ╢
ЁЯИ╡ => ЁЯИ╡, тАЬрмЦрм╛рм▓рм┐рмерм┐рммрм╛ рм╕рнНрмерм╛рми рмирм╛рм╣рм┐рмБтАЭ, рмЬрм╛рмкрм╛рмирнА, рмЬрм╛рмкрм╛рмирнА тАЬрмЦрм╛рм▓рм┐рмерм┐рммрм╛ рм╕рнНрмерм╛рми рмирм╛рм╣рм┐рмБтАЭ рммрмЯрмирнНтАМ, рм╕рмЩрнНрмХрнЗрмд, ц║А
тЦк => тЦк, рмХрм│рм╛ рмЫрнЛрмЯ рммрм░рнНрмЧрм╛рмХрм╛рм░ рмХрнНрм╖рнЗрмдрнНрм░, рмЬрнНрнЯрм╛рморм┐рмдрм┐рмХ, рммрм░рнНрмЧрмХрнНрм╖рнЗрмдрнНрм░
тЦл => тЦл, рмЬрнНрнЯрм╛рморм┐рмдрм┐рмХ, рмзрм│рм╛ рмЫрнЛрмЯ рммрм░рнНрмЧрмХрнНрм╖рнЗрмдрнНрм░, рммрм░рнНрмЧрмХрнНрм╖рнЗрмдрнНрм░
тЧ╗ => тЧ╗, рмЬрнНрнЯрм╛рморм┐рмдрм┐рмХ, рмзрм│рм╛ рмормзрнНрнЯрмо рммрм░рнНрмЧрмХрнНрм╖рнЗрмдрнНрм░, рммрм░рнНрмЧрмХрнНрм╖рнЗрмдрнНрм░
тЧ╝ => тЧ╝, рмХрм│рм╛ рмормзрнНрнЯрмо рммрм░рнНрмЧрмХрнНрм╖рнЗрмдрнНрм░, рмЬрнНрнЯрм╛рморм┐рмдрм┐рмХ, рммрм░рнНрмЧрмХрнНрм╖рнЗрмдрнНрм░
тЧ╜ => тЧ╜, рмЬрнНрнЯрм╛рморм┐рмдрм┐рмХ, рмзрм│рм╛ рмормзрнНрнЯрмо-рмЫрнЛрмЯ рммрм░рнНрмЧрмХрнНрм╖рнЗрмдрнНрм░, рммрм░рнНрмЧрмХрнНрм╖рнЗрмдрнНрм░
тЧ╛ => тЧ╛, рмХрм│рм╛ рмормзрнНрнЯрмо-рмЫрнЛрмЯ рммрм░рнНрмЧрмХрнНрм╖рнЗрмдрнНрм░, рмЬрнНрнЯрм╛рморм┐рмдрм┐рмХ, рммрм░рнНрмЧрмХрнНрм╖рнЗрмдрнНрм░
тмЫ => тмЫ, рмХрм│рм╛ рммрнГрм╣рмдрнНтАМ рммрм░рнНрмЧрмХрнНрм╖рнЗрмдрнНрм░, рмЬрнНрнЯрм╛рморм┐рмдрм┐рмХ, рммрм░рнНрмЧрмХрнНрм╖рнЗрмдрнНрм░
тмЬ => тмЬ, рмЬрнНрнЯрм╛рморм┐рмдрм┐рмХ, рмзрм│рм╛ рммрнГрм╣рмдрнНтАМ рммрм░рнНрмЧрмХрнНрм╖рнЗрмдрнНрм░, рммрм░рнНрмЧрмХрнНрм╖рнЗрмдрнНрм░
ЁЯФ╢ => ЁЯФ╢, рмХрморм│рм╛, рмЬрнНрнЯрм╛рморм┐рмдрм┐рмХ, рммрнГрм╣рмдрнНтАМ рмХрморм│рм╛ рм░рмЩрнНрмЧрм░ рм╣рнАрм░рм╛, рм╣рнАрм░рм╛
ЁЯФ╖ => ЁЯФ╖, рмЬрнНрнЯрм╛рморм┐рмдрм┐рмХ, рмирнАрм│, рммрнГрм╣рмдрнН рмирнАрм│ рм╣рнАрм░рм╛, рм╣рнАрм░рм╛
ЁЯФ╕ => ЁЯФ╕, рмХрморм│рм╛, рмЫрнЛрмЯ рмХрморм│рм╛ рм░рмЩрнНрмЧрм░ рм╣рнАрм░рм╛, рмЬрнНрнЯрм╛рморм┐рмдрм┐рмХ, рм╣рнАрм░рм╛
ЁЯФ╣ => ЁЯФ╣, рмЫрнЛрмЯ рмирнАрм│ рм╣рнАрм░рм╛, рмЬрнНрнЯрм╛рморм┐рмдрм┐рмХ, рмирнАрм│, рм╣рнАрм░рм╛
ЁЯФ║ => ЁЯФ║, рмЙрмкрм░ рморнБрм╣рм╛рмБ рм▓рм╛рм▓ рмдрнНрм░рм┐рмнрнБрмЬ, рмЬрнНрнЯрм╛рмормдрм┐рмХ, рм▓рм╛рм▓рнНтАМ
ЁЯФ╗ => ЁЯФ╗, рмЬрнНрнЯрм╛рморм┐рмдрм┐рмХ, рмдрм│, рмдрм│ рморнБрм╣рм╛рмБ рм▓рм╛рм▓ рмдрнНрм░рм┐рмнрнБрмЬ, рм▓рм╛рм▓рнНтАМ
ЁЯТа => ЁЯТа, рмПрмХ рммрм┐рмирнНрмжрнБ рм╕рм╣рм┐рмд рм╣рнАрм░рм╛, рмХрморм┐рмХрнНтАМ, рмЬрнНрнЯрм╛рморм┐рмдрм┐рмХ, рмнрм┐рмдрм░ рмкрм╛рм░рнНрм╢рнНрм╡, рм╣рнАрм░рм╛
ЁЯФШ => ЁЯФШ, рмЬрнНрнЯрм╛рморм┐рмдрм┐рмХ, рммрмЯрмирнНтАМ, рм░рнЗрмбрм┐рмУ, рм░рнЗрмбрм┐рмУ рммрмЯрмирнНтАМ
ЁЯФ▓ => ЁЯФ▓, рмХрм│рм╛ рммрм░рнНрмЧрм╛рмХрм╛рм░ рммрмЯрмирнНтАМ, рмЬрнНрнЯрм╛рморм┐рмдрм┐рмХ, рммрмЯрмирнНтАМ, рммрм░рнНрмЧрмХрнНрм╖рнЗрмдрнНрм░
ЁЯФ│ => ЁЯФ│, рмЬрнНрнЯрм╛рморм┐рмдрм┐рмХ, рмзрм│рм╛ рммрм░рнНрмЧрм╛рмХрм╛рм░ рммрмЯрмирнНтАМ, рммрмЯрмирнНтАМ, рммрм░рнНрмЧрмХрнНрм╖рнЗрмдрнНрм░, рммрм╛рм╣рнНрнЯрм░рнЗрмЦрм╛рмХрнГрмд
тЪк => тЪк, рмЬрнНрнЯрм╛рморм┐рмдрм┐рмХ, рмзрм│рм╛ рммрнГрмдрнНрмд, рммрнГрмдрнНрмд
тЪл => тЪл, рмХрм│рм╛ рммрнГрмдрнНрмд, рмЬрнНрнЯрм╛рморм┐рмдрм┐рмХ, рммрнГрмдрнНрмд
ЁЯФ┤ => ЁЯФ┤, рмЬрнНрнЯрм╛рморм┐рмдрм┐рмХ, рммрнГрмдрнНрмд, рм▓рм╛рм▓ рммрнГрмдрнНрмд, рм▓рм╛рм▓рнН
ЁЯФ╡ => ЁЯФ╡, рмЬрнНрнЯрм╛рморм┐рмдрм┐рмХ, рмирнАрм│, рмирнАрм│ рммрнГрмдрнНрмд, рммрнГрмдрнНрмд
ЁЯПБ => ЁЯПБ, рмЪрнЗрмХрм░рнНтАМрмпрнБрмХрнНрмд, рмЫрмХрм┐рмХрмЯрм╛ рмврм╛рмЮрнНрмЪрм╛рм░рнЗ рмЕрмЩрнНрмХрм┐рмд, рмЫрмХрм┐рмХрмЯрм╛ рмврм╛рмЮрнНрмЪрм╛рм░рнЗ рмЕрмЩрнНрмХрм┐рмд рмкрмдрм╛рмХрм╛, рм░рнЗрм╕рм┐рмВ
ЁЯЪй => ЁЯЪй, рмдрнНрм░рм┐рмнрнБрмЬрм╛рмХрм╛рм░ рмкрмдрм╛рмХрм╛, рмкрнЛрм╖рнНрмЯрнНтАМ
ЁЯОМ => ЁЯОМ, рмЙрмдрнНрм╕рмм рмкрм╛рм│рми, рмЫрмХрм┐ рмЪрм┐рм╣рнНрми, рмЫрмХрм┐рмпрнБрмХрнНрмд, рмЫрмХрм┐рмпрнБрмХрнНрмд рмкрмдрм╛рмХрм╛рмЧрнБрмбрм┐рмХ, рмЬрм╛рмкрм╛рмирнАрнЯ
ЁЯП┤ => ЁЯП┤, рмХрм│рм╛ рмкрмдрм╛рмХрм╛, рмжрнЛрм│рм╛рнЯрморм╛рми
ЁЯП│ => ЁЯП│, рмжрнЛрм│рм╛рнЯрморм╛рми, рмзрм│рм╛ рмкрмдрм╛рмХрм╛
ЁЯП│тАНЁЯМИ => ЁЯП│тАНЁЯМИ, рмЗрмирнНрмжрнНрм░рмзрмирнБ, рмЗрмирнНрмжрнНрм░рмзрмирнБ рмкрмдрм╛рмХрм╛
ЁЯЗжЁЯЗи => ЁЯЗжЁЯЗи, рмЖрм╕рнЗрмирм╕рм┐рмЕрмирнНтАМ рмжрнНрн▒рнАрмк
ЁЯЗжЁЯЗй => ЁЯЗжЁЯЗй, рмЖрмгрнНрмбрнЛрм░рм╛
ЁЯЗжЁЯЗк => ЁЯЗжЁЯЗк, рм╕рмВрмпрнБрмХрнНрмд рмЖрм░рмм рмПрморм┐рм░рнЗрмЯрм╕рнН
ЁЯЗжЁЯЗл => ЁЯЗжЁЯЗл, рмЖрмлрмЧрм╛рмирм┐рм╕рнНрмдрм╛рмирнН
ЁЯЗжЁЯЗм => ЁЯЗжЁЯЗм, рмЖрмгрнНрмЯрм┐рмЧрнБрмЖ рмПрммрмВ рммрм╛рм░рммрнБрмжрм╛
ЁЯЗжЁЯЗо => ЁЯЗжЁЯЗо, рмЖрмЩрнНрмЧрнБрмЗрм▓рнНрм▓рм╛
ЁЯЗжЁЯЗ▒ => ЁЯЗжЁЯЗ▒, рмЖрм▓рммрм╛рмирм┐рмЖ
ЁЯЗжЁЯЗ▓ => ЁЯЗжЁЯЗ▓, рмЖрм░рнНрморнЗрмирм┐рмЖ
ЁЯЗжЁЯЗ┤ => ЁЯЗжЁЯЗ┤, рмЖрмЩрнНрмЧрнЛрм▓рм╛
ЁЯЗжЁЯЗ╢ => ЁЯЗжЁЯЗ╢, рмЖрмгрнНрмЯрм╛рм░рнНрмХрм╛рмЯрм┐рмХрм╛
ЁЯЗжЁЯЗ╖ => ЁЯЗжЁЯЗ╖, рмЖрм░рнНрмЬрнЗрмгрнНрмЯрм┐рмирм╛
ЁЯЗжЁЯЗ╕ => ЁЯЗжЁЯЗ╕, рмЖрморнЗрм░рм┐рмХрм╛рмирнН рм╕рм╛рморнЛрмЖ
ЁЯЗжЁЯЗ╣ => ЁЯЗжЁЯЗ╣, рмЕрм╖рнНрмЯрнНрм░рм┐рмЖ
ЁЯЗжЁЯЗ║ => ЁЯЗжЁЯЗ║, рмЕрм╖рнНрмЯрнНрм░рнЗрм▓рм┐рмЖ
ЁЯЗжЁЯЗ╝ => ЁЯЗжЁЯЗ╝, рмЖрм░рнБрммрм╛
ЁЯЗжЁЯЗ╜ => ЁЯЗжЁЯЗ╜, рмЕрм▓рм╛рмгрнНрмб рмжрнНрм╡рнАрмкрмкрнБрмЮрнНрмЬ
ЁЯЗжЁЯЗ┐ => ЁЯЗжЁЯЗ┐, рмЖрмЬрнЗрм░рммрм╛рмЗрмЬрм╛рмирнН
ЁЯЗзЁЯЗж => ЁЯЗзЁЯЗж, рммрнЛрм╕рмирм┐рмЖ рмПрммрмВ рм╣рм░рнНрмЬрмЧрнЛрмнрм┐рмирм╛
ЁЯЗзЁЯЗз => ЁЯЗзЁЯЗз, рммрм╛рм░рммрм╛рмбрнЛрм╕рнН
ЁЯЗзЁЯЗй => ЁЯЗзЁЯЗй, рммрм╛рмВрм▓рм╛рмжрнЗрм╢
ЁЯЗзЁЯЗк => ЁЯЗзЁЯЗк, рммрнЗрм▓рмЬрм┐рнЯрморнН
ЁЯЗзЁЯЗл => ЁЯЗзЁЯЗл, рммрнБрм░рнНрмХрм┐рмирм╛ рмлрм╛рм╕рнЛ
ЁЯЗзЁЯЗм => ЁЯЗзЁЯЗм, рммрнБрм▓рмЧрнЗрм░рм┐рмЖ
ЁЯЗзЁЯЗн => ЁЯЗзЁЯЗн, рммрм╛рм╣рм╛рм░рм┐рмирнН
ЁЯЗзЁЯЗо => ЁЯЗзЁЯЗо, рммрнБрм░рнБрмгрнНрмбрм┐
ЁЯЗзЁЯЗп => ЁЯЗзЁЯЗп, рммрнЗрмирм┐рмирнН
ЁЯЗзЁЯЗ▒ => ЁЯЗзЁЯЗ▒, рм╕рнЗрмгрнНрмЯ рммрм╛рм░рнНрмернЗрм▓рнЗрморм┐
ЁЯЗзЁЯЗ▓ => ЁЯЗзЁЯЗ▓, рммрм░рнНрморнБрмбрм╛
ЁЯЗзЁЯЗ│ => ЁЯЗзЁЯЗ│, рммрнНрм░рнБрмирнЗрмЗ
ЁЯЗзЁЯЗ┤ => ЁЯЗзЁЯЗ┤, рммрнЛрм▓рмнрм┐рмЖ
ЁЯЗзЁЯЗ╢ => ЁЯЗзЁЯЗ╢, рмХрм╛рм░рммрм┐рнЯрмирнНтАМ рмирнЗрмжрм░рм▓рнНрнЯрм╛рмгрнНрмб
ЁЯЗзЁЯЗ╖ => ЁЯЗзЁЯЗ╖, рммрнНрм░рм╛рмЬрм┐рм▓рнН
ЁЯЗзЁЯЗ╕ => ЁЯЗзЁЯЗ╕, рммрм╛рм╣рм╛рморм╛рм╕рнН
ЁЯЗзЁЯЗ╣ => ЁЯЗзЁЯЗ╣, рмнрнБрмЯрм╛рми
ЁЯЗзЁЯЗ╗ => ЁЯЗзЁЯЗ╗, рммрнМрмнрнЗрмЯрнНтАМ рмжрнНрн▒рнАрмк
ЁЯЗзЁЯЗ╝ => ЁЯЗзЁЯЗ╝, рммрнЛрмЯрм╕рнНрн▒рм╛рмирм╛
ЁЯЗзЁЯЗ╛ => ЁЯЗзЁЯЗ╛, рммрнЗрм▓рм╛рм░рнБрм╖рнН
ЁЯЗзЁЯЗ┐ => ЁЯЗзЁЯЗ┐, рммрнЗрм▓рм┐рмЬрнН
ЁЯЗиЁЯЗж => ЁЯЗиЁЯЗж, рмХрм╛рмирм╛рмбрм╛
ЁЯЗиЁЯЗи => ЁЯЗиЁЯЗи, рмХрнЛрмХрнЛрм╕рнН (рмХрнАрм▓рм┐рмВ) рмжрнНрм╡рнАрмкрмкрнБрмЮрнНрмЬ
ЁЯЗиЁЯЗй => ЁЯЗиЁЯЗй, рмХрмЩрнНрмЧрнЛ-рмХрм┐рмирм╕рм╛рм╕рм╛
ЁЯЗиЁЯЗл => ЁЯЗиЁЯЗл, рмормзрнНрнЯ рмЖрмлрнНрм░рм┐рмХрнАрнЯ рм╕рм╛рмзрм╛рм░рмгрмдрмирнНрмдрнНрм░
ЁЯЗиЁЯЗм => ЁЯЗиЁЯЗм, рмХрмЩрнНрмЧрнЛ-рммрнНрм░рм╛рмЬрм┐рмнрм┐рм▓рнНрм▓рнЗ
ЁЯЗиЁЯЗн => ЁЯЗиЁЯЗн, рм╕рнНрн▒рм┐рмЬрм░рм▓рнНрнЯрм╛рмгрнНрмб
ЁЯЗиЁЯЗо => ЁЯЗиЁЯЗо, рмХрнЛрмЯрнЗ рмбрм┐ рмЖрмЗрмнрнЛрм░рм┐
ЁЯЗиЁЯЗ░ => ЁЯЗиЁЯЗ░, рмХрнБрмХрнНтАМ рмжрнНрн▒рнАрмкрмкрнБрмЮрнНрмЬ
ЁЯЗиЁЯЗ▒ => ЁЯЗиЁЯЗ▒, рмЪрм┐рм▓рнНрм▓рнА
ЁЯЗиЁЯЗ▓ => ЁЯЗиЁЯЗ▓, рмХрм╛рморнЗрм░рнБрмирнН
ЁЯЗиЁЯЗ│ => ЁЯЗиЁЯЗ│, рмЪрм┐рмирнН
ЁЯЗиЁЯЗ┤ => ЁЯЗиЁЯЗ┤, рмХрнЛрм▓рморнНрммрм┐рмЖ
ЁЯЗиЁЯЗ╡ => ЁЯЗиЁЯЗ╡, рмХрнНрм▓рм┐рмкрм░рмЯрмирнНтАМ рмжрнНрн▒рнАрмк
ЁЯЗиЁЯЗ╖ => ЁЯЗиЁЯЗ╖, рмХрнЛрм╖рнНрмЯрм╛ рм░рм┐рмХрм╛
ЁЯЗиЁЯЗ║ => ЁЯЗиЁЯЗ║, рмХрнНрн▒рм┐рммрм╛
ЁЯЗиЁЯЗ╗ => ЁЯЗиЁЯЗ╗, рмХрнЗрмкрнН рмнрм░рнНрмжрнЗ
ЁЯЗиЁЯЗ╝ => ЁЯЗиЁЯЗ╝, рмХрнБрм░рм╛рмХрм╛рмУ
ЁЯЗиЁЯЗ╜ => ЁЯЗиЁЯЗ╜, рмЦрнНрм░рнАрм╖рнНрмЯрморм╛рм╕ рмжрнНрн▒рнАрмк
ЁЯЗиЁЯЗ╛ => ЁЯЗиЁЯЗ╛, рм╕рм╛рмЗрмкрнНрм░рм╕рнН
ЁЯЗиЁЯЗ┐ => ЁЯЗиЁЯЗ┐, рмЪрнЗрмЪрм┐рмЖ
ЁЯЗйЁЯЗк => ЁЯЗйЁЯЗк, рмЬрм░рнНрморм╛рмирнА
ЁЯЗйЁЯЗм => ЁЯЗйЁЯЗм, рмбрм┐рмПрмЧрнЛ рмЧрм╛рм░рнНрм╕рм┐рмЖ
ЁЯЗйЁЯЗп => ЁЯЗйЁЯЗп, рмЬрм┐рммрнЛрмЯрм┐
ЁЯЗйЁЯЗ░ => ЁЯЗйЁЯЗ░, рмбрнЗрмирморм╛рм░рнНрмХ
ЁЯЗйЁЯЗ▓ => ЁЯЗйЁЯЗ▓, рмбрнЛрморм┐рмирм┐рмХрм╛
ЁЯЗйЁЯЗ┤ => ЁЯЗйЁЯЗ┤, рмбрнЛрморм┐рмирм┐рмХрм╛рмирнНтАМ рм╕рм╛рмзрм╛рм░рмгрмдрмирнНрмдрнНрм░
ЁЯЗйЁЯЗ┐ => ЁЯЗйЁЯЗ┐, рмЖрм▓рмЬрнЗрм░рм┐рмЖ
ЁЯЗкЁЯЗж => ЁЯЗкЁЯЗж, рм╕рм┐рмЙрмЯрм╛ рмПрммрмВ рморнЗрм▓рм┐рм▓рм╛
ЁЯЗкЁЯЗи => ЁЯЗкЁЯЗи, рмЗрмХрнНрн▒рм╛рмбрнЛрм░рнН
ЁЯЗкЁЯЗк => ЁЯЗкЁЯЗк, рмПрм╕рнНрмдрнЛрмирм┐рмЖ
ЁЯЗкЁЯЗм => ЁЯЗкЁЯЗм, рмЗрмЬрм┐рмкрнНрмЯ
ЁЯЗкЁЯЗн => ЁЯЗкЁЯЗн, рмкрм╢рнНрмЪрм┐рмо рм╕рм╛рм╣рм╛рм░рм╛
ЁЯЗкЁЯЗ╖ => ЁЯЗкЁЯЗ╖, рмЗрм░рм┐рмЯрнНрм░рм┐рнЯрм╛
ЁЯЗкЁЯЗ╕ => ЁЯЗкЁЯЗ╕, рм╕рнНрмкрнЗрмирнН
ЁЯЗкЁЯЗ╣ => ЁЯЗкЁЯЗ╣, рмЗрмерм┐рмУрмкрм┐рмЖ
ЁЯЗкЁЯЗ║ => ЁЯЗкЁЯЗ║, рнЯрнБрм░рнЛрмкрнАрнЯ рм╕рмВрмШ
ЁЯЗкЁЯЗ┐ => ЁЯЗкЁЯЗ┐, рнЯрнБрм░рнЛрмХрнНрм╖рнЗрмдрнНрм░
ЁЯЗлЁЯЗо => ЁЯЗлЁЯЗо, рмлрм┐рмирм▓рнНрнЯрм╛рмгрнНрмб
ЁЯЗлЁЯЗп => ЁЯЗлЁЯЗп, рмлрм┐рмЬрм┐
ЁЯЗлЁЯЗ░ => ЁЯЗлЁЯЗ░, рмлрмХрнНтАМрм▓рнНрнЯрм╛рмгрнНрмб рмжрнНрм╡рнАрмкрмкрнБрмЮрнНрмЬ
ЁЯЗлЁЯЗ▓ => ЁЯЗлЁЯЗ▓, рморм╛рмЗрмХрнНрм░рнЛрмирнЗрм╕рм┐рмЖ
ЁЯЗлЁЯЗ┤ => ЁЯЗлЁЯЗ┤, рмлрм╛рм░рнЛрмЗ рмжрнНрн▒рнАрмкрмкрнБрмЮрнНрмЬ
ЁЯЗлЁЯЗ╖ => ЁЯЗлЁЯЗ╖, рмлрнНрм░рм╛рмирнНрм╕
ЁЯЗмЁЯЗж => ЁЯЗмЁЯЗж, рмЧрм╛рммрнЛрмирнН
ЁЯЗмЁЯЗз => ЁЯЗмЁЯЗз, рмпрнБрмХрнНрмдрм░рм╛рмЬрнНрнЯ
ЁЯЗмЁЯЗй => ЁЯЗмЁЯЗй, рмЧрнНрм░рнЗрмирм╛рмбрм╛
ЁЯЗмЁЯЗк => ЁЯЗмЁЯЗк, рмЬрм░рнНрмЬрм┐рмЖ
ЁЯЗмЁЯЗл => ЁЯЗмЁЯЗл, рмлрнНрм░рнЗрмЮрнНрмЪ рмЧрнБрмЗрмирм╛
ЁЯЗмЁЯЗм => ЁЯЗмЁЯЗм, рмЧрнБрмПрм░рмирнЗрм╕рм┐
ЁЯЗмЁЯЗн => ЁЯЗмЁЯЗн, рмШрм╛рмирм╛
ЁЯЗмЁЯЗо => ЁЯЗмЁЯЗо, рмЬрм┐рммрнНрм░рм╛рм▓рнНрмЯрм░рнН
ЁЯЗмЁЯЗ▒ => ЁЯЗмЁЯЗ▒, рмЧрнНрм░рнАрмирм▓рнНрнЯрм╛рмгрнНрмб
ЁЯЗмЁЯЗ▓ => ЁЯЗмЁЯЗ▓, рмЧрм╛рморнНрммрм┐рмЖ
ЁЯЗмЁЯЗ│ => ЁЯЗмЁЯЗ│, рмЧрнБрмЗрмирм┐рмЖ
ЁЯЗмЁЯЗ╡ => ЁЯЗмЁЯЗ╡, рмЧрнБрмЖрмбрнЗрм▓рнЛрмкрнНтАМ
ЁЯЗмЁЯЗ╢ => ЁЯЗмЁЯЗ╢, рмЗрмХрнНрммрм╛рмЯрнЗрм░рм┐рмЖрм▓рнН рмЧрнБрмЗрмирм┐рмЖ
ЁЯЗмЁЯЗ╖ => ЁЯЗмЁЯЗ╖, рмЧрнНрм░рнАрм╕рнН
ЁЯЗмЁЯЗ╕ => ЁЯЗмЁЯЗ╕, рмжрмХрнНрм╖рм┐рмг рмЬрм░рнНрмЬрм┐рмЖ рмПрммрмВ рмжрмХрнНрм╖рм┐рмг рм╕рм╛рмгрнНрмбрн▒рм┐рмЪрнН рмжрнНрн▒рнАрмкрмкрнБрмЮрнНрмЬ
ЁЯЗмЁЯЗ╣ => ЁЯЗмЁЯЗ╣, рмЧрнБрмПрмдрморм╛рм▓рм╛
ЁЯЗмЁЯЗ║ => ЁЯЗмЁЯЗ║, рмЧрнБрмЖрморнН
ЁЯЗмЁЯЗ╝ => ЁЯЗмЁЯЗ╝, рмЧрнБрмЗрмирм┐рмЖ-рммрм┐рм╕рм╛рмЙ
ЁЯЗмЁЯЗ╛ => ЁЯЗмЁЯЗ╛, рмЧрнБрмЗрмирм╛
ЁЯЗнЁЯЗ░ => ЁЯЗнЁЯЗ░, рм╣рмВ рмХрмВ рмПрм╕рмПрмЖрм░рнНтАМ рмЪрм╛рмЗрмирм╛
ЁЯЗнЁЯЗ▓ => ЁЯЗнЁЯЗ▓, рм╣рм╛рм░рнНрмбрнНтАМ рмПрммрмВ рморнНрнЯрм╛рмХрмбрнЛрмирм╛рм▓рнНрмб рмжрнНрн▒рнАрмкрмкрнБрмЮрнНрмЬ
ЁЯЗнЁЯЗ│ => ЁЯЗнЁЯЗ│, рм╣рнЛрмгрнНрмбрнБрм░рм╛рм╕рнНтАМ
ЁЯЗнЁЯЗ╖ => ЁЯЗнЁЯЗ╖, рмХрнНрм░рнЛрмПрм╕рм┐рмЖ
ЁЯЗнЁЯЗ╣ => ЁЯЗнЁЯЗ╣, рм╣рм╛рмЗрмдрм┐
ЁЯЗнЁЯЗ║ => ЁЯЗнЁЯЗ║, рм╣рмЩрнНрмЧрнЗрм░рнА
ЁЯЗоЁЯЗи => ЁЯЗоЁЯЗи, рмХрнЗрмирнЗрм░рнА рмжрнНрн▒рнАрмкрмкрнБрмЮрнНрмЬ
ЁЯЗоЁЯЗй => ЁЯЗоЁЯЗй, рмЗрмгрнНрмбрнЛрмирнЗрм╕рм┐рмЖ
ЁЯЗоЁЯЗк => ЁЯЗоЁЯЗк, рмЖрнЯрм░рм▓рнНрнЯрм╛рмгрнНрмб
ЁЯЗоЁЯЗ▒ => ЁЯЗоЁЯЗ▒, рмЗрм╕рнНрм░рм╛рмПрм▓рнН
ЁЯЗоЁЯЗ▓ => ЁЯЗоЁЯЗ▓, рмЖрмЗрм▓рнНтАМ рмЕрмлрнНтАМ рморнНрнЯрм╛рмирнНтАМ
ЁЯЗоЁЯЗ│ => ЁЯЗоЁЯЗ│, рмнрм╛рм░рмд
ЁЯЗоЁЯЗ┤ => ЁЯЗоЁЯЗ┤, рммрнНрм░рм┐рмЯрм┐рм╢рнНтАМ рмнрм╛рм░рмд рморм╛рм╣рм╛рм╕рм╛рмЧрм░ рмХрнНрм╖рнЗрмдрнНрм░
ЁЯЗоЁЯЗ╢ => ЁЯЗоЁЯЗ╢, рмЗрм░рм╛рмХрнН
ЁЯЗоЁЯЗ╖ => ЁЯЗоЁЯЗ╖, рмЗрм░рм╛рми
ЁЯЗоЁЯЗ╕ => ЁЯЗоЁЯЗ╕, рмЖрмЗрм╕рм▓рнНрнЯрм╛рмгрнНрмб
ЁЯЗоЁЯЗ╣ => ЁЯЗоЁЯЗ╣, рмЗрмЯрм╛рм▓рнА
ЁЯЗпЁЯЗк => ЁЯЗпЁЯЗк, рмЬрм░рнНрм╕рм┐
ЁЯЗпЁЯЗ▓ => ЁЯЗпЁЯЗ▓, рмЬрм╛рморм╛рмЗрмХрм╛
ЁЯЗпЁЯЗ┤ => ЁЯЗпЁЯЗ┤, рмЬрнЛрм░рнНрмбрм╛рмирнН
ЁЯЗпЁЯЗ╡ => ЁЯЗпЁЯЗ╡, рмЬрм╛рмкрм╛рми
ЁЯЗ░ЁЯЗк => ЁЯЗ░ЁЯЗк, рмХрнЗрмирм┐рнЯрм╛
ЁЯЗ░ЁЯЗм => ЁЯЗ░ЁЯЗм, рмХрм┐рм░рнНрмЧрм┐рмЬрм┐рм╕рнНрмдрм╛рми
ЁЯЗ░ЁЯЗн => ЁЯЗ░ЁЯЗн, рмХрм╛рморнНрммрнЛрмбрм┐рмЖ
ЁЯЗ░ЁЯЗо => ЁЯЗ░ЁЯЗо, рмХрм┐рм░рм┐рммрм╛рмЯрм┐
ЁЯЗ░ЁЯЗ▓ => ЁЯЗ░ЁЯЗ▓, рмХрнЛрморнЛрм░рм╕рнНтАМ
ЁЯЗ░ЁЯЗ│ => ЁЯЗ░ЁЯЗ│, рм╕рнЗрмгрнНрмЯ рмХрм┐рмЯрм╕рнНтАМ рмПрммрмВ рмирнЗрмнрм┐рм╕рнНтАМ
ЁЯЗ░ЁЯЗ╡ => ЁЯЗ░ЁЯЗ╡, рмЙрмдрнНрмдрм░ рмХрнЛрм░рм┐рмЖ
ЁЯЗ░ЁЯЗ╖ => ЁЯЗ░ЁЯЗ╖, рмжрмХрнНрм╖рм┐рмг рмХрнЛрм░рм┐рмЖ
ЁЯЗ░ЁЯЗ╝ => ЁЯЗ░ЁЯЗ╝, рмХрнБрмПрмдрнН
ЁЯЗ░ЁЯЗ╛ => ЁЯЗ░ЁЯЗ╛, рмХрнЗрморнНрнЯрм╛рмирнНтАМ рмжрнНрн▒рнАрмкрмкрнБрмЮрнНрмЬ
ЁЯЗ░ЁЯЗ┐ => ЁЯЗ░ЁЯЗ┐, рмХрм╛рмЬрм╛рмХрм╛рм╕рнНрмдрм╛рми
ЁЯЗ▒ЁЯЗж => ЁЯЗ▒ЁЯЗж, рм▓рм╛рмУрм╕рнН
ЁЯЗ▒ЁЯЗз => ЁЯЗ▒ЁЯЗз, рм▓рнЗрммрм╛рмирмирнН
ЁЯЗ▒ЁЯЗи => ЁЯЗ▒ЁЯЗи, рм╕рнЗрмгрнНрмЯ рм▓рнБрм╕рм┐рмЖ
ЁЯЗ▒ЁЯЗо => ЁЯЗ▒ЁЯЗо, рм▓рм┐рмЪрнЗрмЯрмирм╖рнНрмЯрнЗрмЗрмирнН
ЁЯЗ▒ЁЯЗ░ => ЁЯЗ▒ЁЯЗ░, рм╢рнНрм░рнАрм▓рмЩрнНрмХрм╛
ЁЯЗ▒ЁЯЗ╖ => ЁЯЗ▒ЁЯЗ╖, рм▓рм╛рмЗрммрнЗрм░рм┐рмЖ
ЁЯЗ▒ЁЯЗ╕ => ЁЯЗ▒ЁЯЗ╕, рм▓рнЗрм╕рнЛрмернЛ
ЁЯЗ▒ЁЯЗ╣ => ЁЯЗ▒ЁЯЗ╣, рм▓рм┐рмернБрмЖрмирм┐рмЖ
ЁЯЗ▒ЁЯЗ║ => ЁЯЗ▒ЁЯЗ║, рм▓рмХрнНрм╕рнЗрморммрм░рнНрмЧ
ЁЯЗ▒ЁЯЗ╗ => ЁЯЗ▒ЁЯЗ╗, рм▓рм╛рмЯрмнрм┐рмЖ
ЁЯЗ▒ЁЯЗ╛ => ЁЯЗ▒ЁЯЗ╛, рм▓рм┐рммрнНрнЯрм╛
ЁЯЗ▓ЁЯЗж => ЁЯЗ▓ЁЯЗж, рморнЛрм░рнЛрмХрнНрмХрнЛ
ЁЯЗ▓ЁЯЗи => ЁЯЗ▓ЁЯЗи, рморнЛрмирм╛рмХрнЛ
ЁЯЗ▓ЁЯЗй => ЁЯЗ▓ЁЯЗй, рморм╛рм▓рмбрнЛрмнрм╛
ЁЯЗ▓ЁЯЗк => ЁЯЗ▓ЁЯЗк, рмормгрнНрмЯрнЗрмирм┐рмЧрнНрм░рнЛ
ЁЯЗ▓ЁЯЗл => ЁЯЗ▓ЁЯЗл, рм╕рнЗрмгрнНрмЯ рморм╛рм░рнНрмЯрм┐рмирнН
ЁЯЗ▓ЁЯЗм => ЁЯЗ▓ЁЯЗм, рморм╛рмбрм╛рмЧрм╛рм╕рнНрмХрм░рнН
ЁЯЗ▓ЁЯЗн => ЁЯЗ▓ЁЯЗн, рморм╛рм░рнНрм╢рм╛рм▓рнНтАМ рмжрнНрн▒рнАрмкрмкрнБрмЮрнНрмЬ
ЁЯЗ▓ЁЯЗ░ => ЁЯЗ▓ЁЯЗ░, рморм╛рм╕рнЗрмбрнЛрмирм┐рмЖ
ЁЯЗ▓ЁЯЗ▒ => ЁЯЗ▓ЁЯЗ▒, рморм╛рм▓рм┐
ЁЯЗ▓ЁЯЗ▓ => ЁЯЗ▓ЁЯЗ▓, рморм┐рмЖрмБрморм╛рм░
ЁЯЗ▓ЁЯЗ│ => ЁЯЗ▓ЁЯЗ│, рмормЩрнНрмЧрнЛрм▓рм┐рмЖ
ЁЯЗ▓ЁЯЗ┤ => ЁЯЗ▓ЁЯЗ┤, рморм╛рмХрм╛рмЙ рмПрм╕рмПрмЖрм░рнНтАМ рмЪрм╛рмЗрмирм╛
ЁЯЗ▓ЁЯЗ╡ => ЁЯЗ▓ЁЯЗ╡, рмЙрмдрнНрмдрм░ рморм╛рм░рм┐рмЖрмирм╛ рмжрнНрн▒рнАрмкрмкрнБрмЮрнНрмЬ
ЁЯЗ▓ЁЯЗ╢ => ЁЯЗ▓ЁЯЗ╢, рморм╛рм░рнНрмЯрм┐рмирм┐рмХрнНрнЯрнБ
ЁЯЗ▓ЁЯЗ╖ => ЁЯЗ▓ЁЯЗ╖, рморнМрм░рм┐рмЯрм╛рмирм┐рмЖ
ЁЯЗ▓ЁЯЗ╕ => ЁЯЗ▓ЁЯЗ╕, рмормгрнНрмЯрнЗрм╕рнЗрм░рм╛рмЯрнН
ЁЯЗ▓ЁЯЗ╣ => ЁЯЗ▓ЁЯЗ╣, рморм╛рм▓рнНрмЯрм╛
ЁЯЗ▓ЁЯЗ║ => ЁЯЗ▓ЁЯЗ║, рморм░рм┐рм╕рм╕
ЁЯЗ▓ЁЯЗ╗ => ЁЯЗ▓ЁЯЗ╗, рморм╛рм▓рмжрм┐рмнрм╕рнНтАМ
ЁЯЗ▓ЁЯЗ╝ => ЁЯЗ▓ЁЯЗ╝, рморм╛рм▓рн▒рм┐
ЁЯЗ▓ЁЯЗ╜ => ЁЯЗ▓ЁЯЗ╜, рморнЗрмХрнНрм╕рм┐рмХрнЛ
ЁЯЗ▓ЁЯЗ╛ => ЁЯЗ▓ЁЯЗ╛, рморм╛рм▓рнЗрм╕рм┐рмЖ
ЁЯЗ▓ЁЯЗ┐ => ЁЯЗ▓ЁЯЗ┐, рморнЛрмЬрм╛рморнНрммрм┐рмХрнНтАМ
ЁЯЗ│ЁЯЗж => ЁЯЗ│ЁЯЗж, рмирм╛рморм┐рммрм┐рмЖ
ЁЯЗ│ЁЯЗи => ЁЯЗ│ЁЯЗи, рмирнВрмдрми рмХрм╛рм▓рнЗрмбрнЛрмирм┐рмЖ
ЁЯЗ│ЁЯЗк => ЁЯЗ│ЁЯЗк, рмирм╛рмЗрмЬрм░
ЁЯЗ│ЁЯЗл => ЁЯЗ│ЁЯЗл, рмирм░рнНрмлрмХрнНтАМ рмжрнНрн▒рнАрмк
ЁЯЗ│ЁЯЗм => ЁЯЗ│ЁЯЗм, рмирм╛рмЗрмЬрнЗрм░рм┐рмЖ
ЁЯЗ│ЁЯЗо => ЁЯЗ│ЁЯЗо, рмирм┐рмХрм╛рм░рм╛рмЧрнБрмЖ
ЁЯЗ│ЁЯЗ▒ => ЁЯЗ│ЁЯЗ▒, рмирнЗрмжрм░рм▓рнНрнЯрм╛рмгрнНрмб
ЁЯЗ│ЁЯЗ┤ => ЁЯЗ│ЁЯЗ┤, рмирм░рн▒рнЗ
ЁЯЗ│ЁЯЗ╡ => ЁЯЗ│ЁЯЗ╡, рмирнЗрмкрм╛рм│
ЁЯЗ│ЁЯЗ╖ => ЁЯЗ│ЁЯЗ╖, рмирм╛рмЙрм░рнБ
ЁЯЗ│ЁЯЗ║ => ЁЯЗ│ЁЯЗ║, рмирм┐рмЙ
ЁЯЗ│ЁЯЗ┐ => ЁЯЗ│ЁЯЗ┐, рмирнНрнЯрнБрмЬрм┐рм▓рм╛рмгрнНрмб
ЁЯЗ┤ЁЯЗ▓ => ЁЯЗ┤ЁЯЗ▓, рмУрморм╛рмирнН
ЁЯЗ╡ЁЯЗж => ЁЯЗ╡ЁЯЗж, рмкрм╛рмирм╛рморм╛
ЁЯЗ╡ЁЯЗк => ЁЯЗ╡ЁЯЗк, рмкрнЗрм░рнБ
ЁЯЗ╡ЁЯЗл => ЁЯЗ╡ЁЯЗл, рмлрнНрм░рнЗрмЮрнНрмЪ рмкрм▓рм┐рмирнЗрм╕рм┐рмЖ
ЁЯЗ╡ЁЯЗм => ЁЯЗ╡ЁЯЗм, рмкрмкрнБрмЖ рмирнНрнЯрнБ рмЧрнБрмПрмирм┐рмЖ
ЁЯЗ╡ЁЯЗн => ЁЯЗ╡ЁЯЗн, рмлрм┐рм▓рм┐рмкрм╛рмЗрмирм╕рнН
ЁЯЗ╡ЁЯЗ░ => ЁЯЗ╡ЁЯЗ░, рмкрм╛рмХрм┐рм╕рнНрмдрм╛рми
ЁЯЗ╡ЁЯЗ▒ => ЁЯЗ╡ЁЯЗ▒, рмкрнЛрм▓рм╛рмгрнНрмб
ЁЯЗ╡ЁЯЗ▓ => ЁЯЗ╡ЁЯЗ▓, рм╕рнЗрмгрнНрмЯ рмкрм┐рмПрм░рнЗ рмПрммрмВ рморм┐рмХрнНрн▒рнЗрм▓рмирнНтАМ
ЁЯЗ╡ЁЯЗ│ => ЁЯЗ╡ЁЯЗ│, рмкрм┐рмЯрмХрм╛рмЗрм░рм┐рмирнНтАМ рмжрнНрн▒рнАрмкрмкрнБрмЮрнНрмЬ
ЁЯЗ╡ЁЯЗ╖ => ЁЯЗ╡ЁЯЗ╖, рмкрнБрмПрм░рнНрмдрнНрмдрнЛ рм░рм┐рмХрнЛ
ЁЯЗ╡ЁЯЗ╕ => ЁЯЗ╡ЁЯЗ╕, рмкрм╛рм▓рнЗрм╖рнНрмЯрнЗрмирм┐рнЯ рмнрнВрмнрм╛рмЧ
ЁЯЗ╡ЁЯЗ╣ => ЁЯЗ╡ЁЯЗ╣, рмкрм░рнНрмдрнНрмдрнБрмЧрм╛рм▓рнН
ЁЯЗ╡ЁЯЗ╝ => ЁЯЗ╡ЁЯЗ╝, рмкрм╛рм▓рм╛рмЙ
ЁЯЗ╡ЁЯЗ╛ => ЁЯЗ╡ЁЯЗ╛, рмкрм╛рм░рм╛рмЧрнБрмП
ЁЯЗ╢ЁЯЗж => ЁЯЗ╢ЁЯЗж, рмХрмдрм╛рм░рнН
ЁЯЗ╢ЁЯЗ┤ => ЁЯЗ╢ЁЯЗ┤, рм╕рнАрморм╛рмирнНрмдрммрм░рнНрмдрнНрмдрнА рмУрм╕рнЗрмирм┐рмЖ
ЁЯЗ╖ЁЯЗк => ЁЯЗ╖ЁЯЗк, рм░рм┐рнЯрнБрмирм┐рмЕрмирнН
ЁЯЗ╖ЁЯЗ┤ => ЁЯЗ╖ЁЯЗ┤, рм░рнЛрморм╛рмирм┐рмЖ
ЁЯЗ╖ЁЯЗ╕ => ЁЯЗ╖ЁЯЗ╕, рм╕рм░рнНрммрм┐рмЖ
ЁЯЗ╖ЁЯЗ║ => ЁЯЗ╖ЁЯЗ║, рм░рнБрм╖рм┐рмЖ
ЁЯЗ╖ЁЯЗ╝ => ЁЯЗ╖ЁЯЗ╝, рм░рм╛рн▒рм╛рмгрнНрмбрм╛
ЁЯЗ╕ЁЯЗж => ЁЯЗ╕ЁЯЗж, рм╕рм╛рмЙрмжрм┐ рмЖрм░рммрм┐рмЖ
ЁЯЗ╕ЁЯЗз => ЁЯЗ╕ЁЯЗз, рм╕рнЛрм▓рнЛрмормирнНтАМ рмжрнНрн▒рнАрмкрмкрнБрмЮрнНрмЬ
ЁЯЗ╕ЁЯЗи => ЁЯЗ╕ЁЯЗи, рм╕рнЗрмЪрнЗрм▓рм╕рнН
ЁЯЗ╕ЁЯЗй => ЁЯЗ╕ЁЯЗй, рм╕рнБрмжрм╛рми
ЁЯЗ╕ЁЯЗк => ЁЯЗ╕ЁЯЗк, рм╕рнНрн▒рнЗрмбрнЗрмирнН
ЁЯЗ╕ЁЯЗм => ЁЯЗ╕ЁЯЗм, рм╕рм┐рмЩрнНрмЧрм╛рмкрнБрм░рнН
ЁЯЗ╕ЁЯЗн => ЁЯЗ╕ЁЯЗн, рм╕рнЗрмгрнНрмЯ рм╣рнЗрм▓рнЗрмирм╛
ЁЯЗ╕ЁЯЗо => ЁЯЗ╕ЁЯЗо, рм╕рнНрм▓рнЛрмнрнЗрмирм┐рмЖ
ЁЯЗ╕ЁЯЗп => ЁЯЗ╕ЁЯЗп, рм╕рм╛рм▓рммрм╛рм░рнНрмб рмПрммрмВ рмЬрм╛рмирнНтАМ рморм╛рнЯрнЗрмирнНтАМ
ЁЯЗ╕ЁЯЗ░ => ЁЯЗ╕ЁЯЗ░, рм╕рнНрм▓рнЛрмнрм╛рмХрм┐рмЖ
ЁЯЗ╕ЁЯЗ▒ => ЁЯЗ╕ЁЯЗ▒, рм╕рм┐рмПрм░рм╛ рм▓рм┐рмУрми
ЁЯЗ╕ЁЯЗ▓ => ЁЯЗ╕ЁЯЗ▓, рм╕рм╛рмирнН рморм╛рм░рм┐рмирнЛ
ЁЯЗ╕ЁЯЗ│ => ЁЯЗ╕ЁЯЗ│, рм╕рнЗрмирнЗрмЧрм╛рм▓рнН
ЁЯЗ╕ЁЯЗ┤ => ЁЯЗ╕ЁЯЗ┤, рм╕рнЛрморм╛рм▓рм┐рмЖ
ЁЯЗ╕ЁЯЗ╖ => ЁЯЗ╕ЁЯЗ╖, рм╕рнБрм░рм┐рмирм╛рмо
ЁЯЗ╕ЁЯЗ╕ => ЁЯЗ╕ЁЯЗ╕, рмжрмХрнНрм╖рм┐рмг рм╕рнБрмжрм╛рми
ЁЯЗ╕ЁЯЗ╣ => ЁЯЗ╕ЁЯЗ╣, рм╕рм╛рмУ рмЯрнЛрморнЗ рмПрммрмВ рмкрнНрм░рм┐рмирм╕рм┐рмкрм┐
ЁЯЗ╕ЁЯЗ╗ => ЁЯЗ╕ЁЯЗ╗, рмПрм▓рнН рм╕рм╛рм▓рмнрм╛рмбрнЛрм░рнН
ЁЯЗ╕ЁЯЗ╜ => ЁЯЗ╕ЁЯЗ╜, рм╕рм┐рмгрнНрмЯ рморм╛рм░рнНрмЯрнАрмирнНтАМ
ЁЯЗ╕ЁЯЗ╛ => ЁЯЗ╕ЁЯЗ╛, рм╕рм┐рм░рм┐рмЖ
ЁЯЗ╕ЁЯЗ┐ => ЁЯЗ╕ЁЯЗ┐, рм╕рнНрн▒рм╛рмЬрм┐рм▓рнНрнЯрм╛рмгрнНрмб
ЁЯЗ╣ЁЯЗж => ЁЯЗ╣ЁЯЗж, рмЯрнНрм░рм╛рмЗрм╖рнНрмЯрмирнНтАМ рмжрм╛ рмХрнБрмирнНтАМрмЪрм╛
ЁЯЗ╣ЁЯЗи => ЁЯЗ╣ЁЯЗи, рмдрнБрм░рнНрмХрм╕рнНтАМ рмПрммрмВ рмХрм╛рмЗрмХрнЛрм╕рнНтАМ рмжрнНрн▒рнАрмкрмкрнБрмЮрнНрмЬ
ЁЯЗ╣ЁЯЗй => ЁЯЗ╣ЁЯЗй, рмЪрм╛рмжрнН
ЁЯЗ╣ЁЯЗл => ЁЯЗ╣ЁЯЗл, рмлрм░рм╛рм╕рнА рмжрмХрнНрм╖рм┐рмг рмХрнНрм╖рнЗрмдрнНрм░
ЁЯЗ╣ЁЯЗм => ЁЯЗ╣ЁЯЗм, рмЯрнЛрмЧрнЛ
ЁЯЗ╣ЁЯЗн => ЁЯЗ╣ЁЯЗн, рмерм╛рмЗрм▓рнНрнЯрм╛рмгрнНрмб
ЁЯЗ╣ЁЯЗп => ЁЯЗ╣ЁЯЗп, рмдрм╛рмЬрм┐рмХрм┐рм╕рнНрмерм╛рмирнН
ЁЯЗ╣ЁЯЗ░ => ЁЯЗ╣ЁЯЗ░, рмЯрнЛрмХрнЗрм▓рм╛рмЙ
ЁЯЗ╣ЁЯЗ▒ => ЁЯЗ╣ЁЯЗ▒, рмдрм┐рморнЛрм░рнН-рм▓рнЗрм╖рнНрмЯрнЗ
ЁЯЗ╣ЁЯЗ▓ => ЁЯЗ╣ЁЯЗ▓, рмдрнБрм░рнНрмХрморнЗрмирм┐рм╕рнНрмдрм╛рми
ЁЯЗ╣ЁЯЗ│ => ЁЯЗ╣ЁЯЗ│, рмЯрнНрнЯрнБрмирм┐рм╕рм┐рмЖ
ЁЯЗ╣ЁЯЗ┤ => ЁЯЗ╣ЁЯЗ┤, рмЯрнЛрмЩрнНрмЧрм╛
ЁЯЗ╣ЁЯЗ╖ => ЁЯЗ╣ЁЯЗ╖, рмдрнБрм░рнНрмХрнА
ЁЯЗ╣ЁЯЗ╣ => ЁЯЗ╣ЁЯЗ╣, рмдрнНрм░рм┐рмирм┐рмжрм╛рмжрнН рмПрммрмВ рмЯрнЛрммрм╛рмЧрнЛ
ЁЯЗ╣ЁЯЗ╗ => ЁЯЗ╣ЁЯЗ╗, рмдрнБрмнрм╛рм▓рнБ
ЁЯЗ╣ЁЯЗ╝ => ЁЯЗ╣ЁЯЗ╝, рмдрм╛рмЗрн▒рм╛рми
ЁЯЗ╣ЁЯЗ┐ => ЁЯЗ╣ЁЯЗ┐, рмдрм╛рмЮрнНрмЬрм╛рмирм┐рмЖ
ЁЯЗ║ЁЯЗж => ЁЯЗ║ЁЯЗж, рнЯрнБрмХрнНрм░рнЗрмирнНтАМ
ЁЯЗ║ЁЯЗм => ЁЯЗ║ЁЯЗм, рмЙрмЧрм╛рмгрнНрмбрм╛
ЁЯЗ║ЁЯЗ▓ => ЁЯЗ║ЁЯЗ▓, рмпрнБрмХрнНрмдрм░рм╛рм╖рнНрмЯрнНрм░ рмЖрмЙрмЯрнНтАМрм▓рм╛рмЗрмЩрнНрмЧ рмжрнНрм╡рнАрмкрмкрнБрмЮрнНрмЬ
ЁЯЗ║ЁЯЗ│ => ЁЯЗ║ЁЯЗ│, рмЬрм╛рмдрм┐рм╕рмВрмШ
ЁЯЗ║ЁЯЗ╕ => ЁЯЗ║ЁЯЗ╕, рмпрнБрмХрнНрмд рм░рм╛рм╖рнНрмЯрнНрм░
ЁЯЗ║ЁЯЗ╛ => ЁЯЗ║ЁЯЗ╛, рмЙрм░рнБрмЧрнБрмП
ЁЯЗ║ЁЯЗ┐ => ЁЯЗ║ЁЯЗ┐, рмЙрмЬрммрнЗрмХрм┐рм╕рнНрмдрм╛рми
ЁЯЗ╗ЁЯЗж => ЁЯЗ╗ЁЯЗж, рмнрм╛рмЯрм┐рмХрм╛рмирнНтАМ рм╕рм┐рмЯрм┐
ЁЯЗ╗ЁЯЗи => ЁЯЗ╗ЁЯЗи, рм╕рнЗрмгрнНрмЯ рмнрм┐рмирм╕рнЗрмгрнНрмЯ рмПрммрмВ рмжрм┐ рмЧрнНрм░рнЗрмирм╛рмбрм┐рм╕рнН
ЁЯЗ╗ЁЯЗк => ЁЯЗ╗ЁЯЗк, рмнрнЗрмирнЗрмЬрнБрмПрм▓рм╛
ЁЯЗ╗ЁЯЗм => ЁЯЗ╗ЁЯЗм, рммрнНрм░рм┐рмЯрм┐рм╢рнНтАМ рмнрм░рнНрмЬрм┐рмирнН рмжрнНрн▒рнАрмкрмкрнБрмЮрнНрмЬ
ЁЯЗ╗ЁЯЗо => ЁЯЗ╗ЁЯЗо, рмпрнБрмХрнНрмдрм░рм╛рм╖рнНрмЯрнНрм░ рмнрм┐рм░рнНрмЬрм┐рмирнН рмжрнНрм╡рнАрмкрмкрнБрмЮрнНрмЬ
ЁЯЗ╗ЁЯЗ│ => ЁЯЗ╗ЁЯЗ│, рмнрм┐рмПрмдрмирм╛рморнН
ЁЯЗ╗ЁЯЗ║ => ЁЯЗ╗ЁЯЗ║, рмнрм╛рмирнБрмЖрмдрнБ
ЁЯЗ╝ЁЯЗл => ЁЯЗ╝ЁЯЗл, рн▒рм╛рм▓рм┐рм╕рнН рмПрммрмВ рмлрнБрмдрнБрмирм╛
ЁЯЗ╝ЁЯЗ╕ => ЁЯЗ╝ЁЯЗ╕, рм╕рм╛рморнЛрмЖ
ЁЯЗ╜ЁЯЗ░ => ЁЯЗ╜ЁЯЗ░, рмХрнЛрм╕рнЛрмнрнЛ
ЁЯЗ╛ЁЯЗк => ЁЯЗ╛ЁЯЗк, рнЯрнЗрморнЗрмирнН
ЁЯЗ╛ЁЯЗ╣ => ЁЯЗ╛ЁЯЗ╣, рморм╛рнЯрнЛрмЯрнЗ
ЁЯЗ┐ЁЯЗж => ЁЯЗ┐ЁЯЗж, рмжрмХрнНрм╖рм┐рмг рмЖрмлрнНрм░рм┐рмХрм╛
ЁЯЗ┐ЁЯЗ▓ => ЁЯЗ┐ЁЯЗ▓, рмЬрм╛рморнНрммрм┐рмЖ
ЁЯЗ┐ЁЯЗ╝ => ЁЯЗ┐ЁЯЗ╝, рмЬрм┐рморнНрммрм╛рн▒рнЗ
ЁЯЗ┐ЁЯЗ┐ => ЁЯЗ┐ЁЯЗ┐, рмЕрмЬрмгрм╛ рмЕрмЮрнНрмЪрм│