ЁЯП╗ => ЁЯП╗, рдЗрдореЛрдЬреА рдкрд░рд┐рдорд╛рд░реНрдЬрдХ, рдЫрд╛рд▓рд╛, рдЫрд╛рд▓рд╛рдХреЛ рдкреНрд░рдХрд╛рд░-рез-реи, рдЯреЛрди, рдлрд┐рдЯрдкрд╛рдЯреНрд░рд┐рдХ
ЁЯП╝ => ЁЯП╝, рдЗрдореЛрдЬреА рдкрд░рд┐рдорд╛рд░реНрдЬрдХ, рдЫрд╛рд▓рд╛, рдЫрд╛рд▓рд╛рдХреЛ рдкреНрд░рдХрд╛рд░-рей, рдЯреЛрди, рдлрд┐рдЯрдкрд╛рдЯреНрд░рд┐рдХ
ЁЯП╜ => ЁЯП╜, рдЗрдореЛрдЬреА рдкрд░рд┐рдорд╛рд░реНрдЬрдХ, рдЫрд╛рд▓рд╛, рдЫрд╛рд▓рд╛рдХреЛ рдкреНрд░рдХрд╛рд░-рек, рдЯреЛрди, рдлрд┐рдЯрдкрд╛рдЯреНрд░рд┐рдХ
ЁЯП╛ => ЁЯП╛, рдЗрдореЛрдЬреА рдкрд░рд┐рдорд╛рд░реНрдЬрдХ, рдЫрд╛рд▓рд╛, рдЫрд╛рд▓рд╛рдХреЛ рдкреНрд░рдХрд╛рд░-рел, рдЯреЛрди, рдлрд┐рдЯрдкрд╛рдЯреНрд░рд┐рдХ
ЁЯП┐ => ЁЯП┐, рдЗрдореЛрдЬреА рдкрд░рд┐рдорд╛рд░реНрдЬрдХ, рдЫрд╛рд▓рд╛, рдЫрд╛рд▓рд╛рдХреЛ рдкреНрд░рдХрд╛рд░-рем, рдЯреЛрди, рдлрд┐рдЯрдкрд╛рдЯреНрд░рд┐рдХ
ЁЯША => ЁЯША, рдЕрдиреБрд╣рд╛рд░, рд░рдорд╛рдПрдХреЛ рдЕрдиреБрд╣рд╛рд░, рд╣рдБрд╕рд┐рд▓реЛ
ЁЯШБ => ЁЯШБ, рдЕрдиреБрд╣рд╛рд░, рдЖрдБрдЦрд╛, рдореБрд╕реНрдХрд╛рди, рд░рдорд╛рдПрдХрд╛ рдЖрдБрдЦрд╛рд╕рд╣рд┐рдд рдордиреНрджрдореБрд╕реНрдХрд╛рдирдпреБрдХреНрдд рдЕрдиреБрд╣рд╛рд░, рд╣рдБрд╕рд┐рд▓реЛ
ЁЯШВ => ЁЯШВ, рдЕрдиреБрд╣рд╛рд░, рдЖрдБрд╕реБ, рдЦреБрд╢реА, рдЦреБрд╕реАрдХреЛ рдЖрдБрд╕реБ рджреЗрдЦрд┐рдПрдХреЛ рдЕрдиреБрд╣рд╛рд░, рд╣рд╛рдБрд╕реЛ
ЁЯдг => ЁЯдг, рдЕрддреНрдпрдиреНрддреИ рд╣рд╛рдБрд╕ рдЙрдареНрджреЛ, рдЕрдиреБрд╣рд╛рд░, рднреБрдИрдБ, рд▓рдбрд┐рдмреБрдбреА, рд╣рд╛рдБрд╕реЛ
ЁЯШГ => ЁЯШГ, рдЕрдиреБрд╣рд╛рд░, рдЦреБрд▓рд╛, рдЦреБрд▓рд╛ рдореБрдЦ рд╕рд╣рд┐рддрдХреЛ рд╣рдБрд╕рд┐рд▓реЛ рдЕрдиреБрд╣рд╛рд░, рдореБрдЦ, рдореБрд╕реНрдХрд╛рди
ЁЯШД => ЁЯШД, рдЕрдиреБрд╣рд╛рд░, рдЖрдБрдЦрд╛, рдЦреБрд▓рд╛, рдЦреБрд▓рд╛ рдореБрдЦ рд░ рдЪрдореНрдХрд┐рд▓рд╛ рдЖрдБрдЦрд╛ рд╕рд╣рд┐рддрдХреЛ рд╣рдБрд╕рд┐рд▓реЛ рдЕрдиреБрд╣рд╛рд░, рдореБрдЦ, рдореБрд╕реНрдХрд╛рди
ЁЯШЕ => ЁЯШЕ, рдЕрдиреБрд╣рд╛рд░, рдЦреБрд▓рд╛, рдЦреБрд▓рд╛ рдореБрдЦ рд░ рдЪрд┐рд╕реЛ рдкрд╕рд┐рдирд╛ рд╕рд╣рд┐рддрдХреЛ рд╣рдБрд╕рд┐рд▓реЛ рдЕрдиреБрд╣рд╛рд░, рдЪрд┐рд╕реЛ, рдкрд╕рд┐рдирд╛, рд╣рд╛рдБрд╕реЛ
ЁЯШЖ => ЁЯШЖ, рдЕрдиреБрд╣рд╛рд░, рдЦреБрд▓рд╛, рдЦреБрд▓рд╛ рдореБрдЦ рд░ рдЖрдБрдЦрд╛ рдЪрд┐рдореНрдо рднрдПрдХреЛ рд╣рдБрд╕рд┐рд▓реЛ рдЕрдиреБрд╣рд╛рд░, рдореБрдЦ, рдореБрд╕реНрдХрд╛рди, рд╕рдиреНрддреБрд╖реНрдЯрд┐, рд╣рдБрд╕рд╛рдЗ
ЁЯШЙ => ЁЯШЙ, рдЕрдиреБрд╣рд╛рд░, рдЖрдБрдЦрд╛ рдЭрд┐рдореНрдХрд╛рдЗрдПрдХреЛ рдЕрдиреБрд╣рд╛рд░, рдЖрдБрдЦрд╛ рдЭрд┐рдореНрдХрд╛рдПрдХреЛ
ЁЯШК => ЁЯШК, рдЕрдиреБрд╣рд╛рд░, рдЖрдБрдЦрд╛, рдЪрдореНрдХрд┐рд▓рд╛ рдЖрдБрдЦрд╛ рд░ рд╣рдБрд╕рд┐рд▓реЛ рдЕрдиреБрд╣рд╛рд░, рдореБрд╕реНрдХрд╛рди, рд▓рдЬрд╛рдПрдХреЛ
ЁЯШЛ => ЁЯШЛ, рдЕрдиреБрд╣рд╛рд░, рдорд┐рдареЛ, рдорд┐рд╕реНрдард╛рдиреНрди, рд╕реНрд╡рд╛рджрд┐рд╖реНрдЯ, рд╕реНрд╡рд╛рджрд┐рд╖реНрдЯ рдЦрд╛рдирд╛рдорд╛ рд░рдорд╛рдПрдХреЛ рдЕрдиреБрд╣рд╛рд░, рд╕реНрд╡рд╛рджрд┐рд╕реНрдЯ, рд╣рд╛рдБрд╕реЛ
ЁЯШО => ЁЯШО, рдЕрдиреБрд╣рд╛рд░, рдЖрдБрдЦрд╛, рдЖрдБрдЦрд╛рдорд╛ рд▓рдЧрд╛рдЙрдиреЗ, рдЙрдЬреНрдпрд╛рд▓реЛ, рдШрд╛рдордмрд╛рдЯ рдмрдЪреНрди рд▓рдЧрд╛рдЙрдиреЗ рдЪрд╕реНрдорд╛, рдЪрд╕реНрдорд╛, рдЪрд╕реНрдорд╛ рд▓рдЧрд╛рдПрдХреЛ рд╣рдБрд╕рд┐рд▓реЛ рдЕрдиреБрд╣рд╛рд░, рдореМрд╕рдо, рд░рд╛рдореНрд░реЛ, рд╕реВрд░реНрдп, рд╣рд╛рдБрд╕реЛ
ЁЯШН => ЁЯШН, рдЕрдиреБрд╣рд╛рд░, рдЖрдБрдЦрд╛, рдорд╛рдпрд╛, рдореБрдЯреБ, рдореБрдЯреБрдХреЛ-рдЖрдХрд╛рд░рдХреЛ рдЖрдБрдЦрд╛рд╕рд╣рд┐рддрдХреЛ рд╣рдБрд╕рд┐рд▓реЛ рдЕрдиреБрд╣рд╛рд░, рдореБрд╕реНрдХрд╛рди
ЁЯШШ => ЁЯШШ, рдЕрдиреБрд╣рд╛рд░, рдЪреБрдореНрдмрди, рдЪреБрдореНрдмрди рдлреНрдпрд╛рдБрдХрд┐рд░рд╣реЗрдХреЛ рдЕрдиреБрд╣рд╛рд░, рдореБрдЯреБ
ЁЯШЧ => ЁЯШЧ, рдЕрдиреБрд╣рд╛рд░, рдЪреБрдореНрдмрди, рдЪреБрдореНрдмрди рдЧрд░рд┐рд░рд╣реЗрдХреЛ рдЕрдиреБрд╣рд╛рд░
ЁЯШЩ => ЁЯШЩ, рдЕрдиреБрд╣рд╛рд░, рдЖрдБрдЦрд╛, рдЪреБрдореНрдмрди, рдореБрд╕реНрдХрд╛рди, рд╣рдБрд╕рд┐рд▓реЛ рдЖрдБрдЦрд╛рд╕рд╣рд┐рдд рдЪреБрдореНрдмрди рдЧрд░рд┐рд░рд╣реЗрдХреЛ рдЕрдиреБрд╣рд╛рд░
ЁЯШЪ => ЁЯШЪ, рдЕрдиреБрд╣рд╛рд░, рдЖрдБрдЦрд╛, рдЪреБрдореНрдмрди, рдмрдиреНрдж рдЖрдБрдЦрд╛рд╕рд╣рд┐рдд рдЪреБрдореНрдмрди рдЧрд░рд┐рд░рд╣реЗрдХреЛ рдЕрдиреБрд╣рд╛рд░, рдмрдиреНрдж рдЧрд░реЗрдХреЛ
тШ║ => тШ║, рдЕрдиреБрд╣рд╛рд░, рддрдирд╛рдмрдореБрдХреНрдд, рдмрд╛рд╣рд┐рд░ рд░реЗрдЦрд╛ рдЧрд░реЗрдХреЛ, рдореБрд╕реНрдХрд╛рди, рд╣рдБрд╕рд┐рд▓реЛ рдЕрдиреБрд╣рд╛рд░
ЁЯЩВ => ЁЯЩВ, рдЕрдиреБрд╣рд╛рд░, рдореБрд╕реНрдХрд╛рди, рд╣рд▓рдХрд╛ рд╣рдБрд╕рд┐рд▓реЛ рдЕрдиреБрд╣рд╛рд░
ЁЯдЧ => ЁЯдЧ, рдЕрдВрдЧрд╛рд▓реЛ, рдЕрдВрдЧрд╛рд▓реЛ рдорд╛рд░рд┐рд░рд╣реЗрдХреЛ, рдЕрдВрдЧрд╛рд▓реЛ рдорд╛рд░реЗрдХреЛ рдЕрдиреБрд╣рд╛рд░, рдЕрдиреБрд╣рд╛рд░
ЁЯдй => ЁЯдй, рдЕрдЪрдореНрднрд┐рдд, рдЕрдиреБрд╣рд╛рд░, рдЖрдБрдЦрд╛, рддрд╛рд░рд╛, рджрд╛рдБрдд рджреЗрдЦрд╛рдПрд░ рд╣рд╛рдБрд╕рд┐рд░рд╣реЗрдХреЛ рдЕрдиреБрд╣рд╛рд░
ЁЯдФ => ЁЯдФ, рдЕрдиреБрд╣рд╛рд░, рд╕реЛрдЪрдордЧреНрди рдЕрдиреБрд╣рд╛рд░, рд╕реЛрдЪрд┐рд░рд╣реЗрдХреЛ
ЁЯди => ЁЯди, рдЕрд╡рд┐рд╢реНрд╡рд╛рд╕, рдЫрдХреНрдХ рдкрд░реЗрдХреЛ рдЕрдиреБрд╣рд╛рд░, рд╢рдЩреНрдХрд╛рд▓реБ
ЁЯШР => ЁЯШР, рдЕрдиреБрд╣рд╛рд░, рддрдЯрд╕реНрде, рддрдЯрд╕реНрде рдЕрдиреБрд╣рд╛рд░, рднрд╛рд╡рд╣реАрди
ЁЯШС => ЁЯШС, рдЕрдиреБрд╣рд╛рд░, рдЕрднрд┐рд╡реНрдпрдХреНрддрд┐ рдмрд┐рдирд╛, рдЕрднрд┐рд╡реНрдпрдХреНрддрд┐ рдмрд┐рдирд╛рдХреЛ рдЕрдиреБрд╣рд╛рд░, рднрд╛рд╡рдирднрдПрдХреЛ, рднрд╛рд╡рд╢реБрдиреНрдп
ЁЯШ╢ => ЁЯШ╢, рдЕрдиреБрд╣рд╛рд░, рдЪреБрдк, рдореБрдЦ, рдореБрдЦ рдмрд┐рдирд╛рдХреЛ рдЕрдиреБрд╣рд╛рд░, рд╢рд╛рдиреНрдд
ЁЯЩД => ЁЯЩД, рдЕрдиреБрд╣рд╛рд░, рдЖрдБрдЦрд╛, рдШреБрдорд┐рд░рд╣реЗрдХреЛ, рдШреБрдорд┐рд░рд╣реЗрдХреЛ рдЖрдБрдЦрд╛ рд╕рд╣рд┐рддрдХреЛ рдЕрдиреБрд╣рд╛рд░
ЁЯШП => ЁЯШП, рдЕрдиреБрд╣рд╛рд░, рдмрдирд╛рд╡рдЯреА, рдмрдирд╛рд╡рдЯреА рдЕрдиреБрд╣рд╛рд░
ЁЯШг => ЁЯШг, рдЕрдиреБрд╣рд╛рд░, рджреГрдв рдЕрдиреБрд╣рд╛рд░, рджреГрдз
ЁЯШе => ЁЯШе, рдЕрдиреБрд╣рд╛рд░, рдЪрд┐рдиреНрддрд╛ рдореБрдХреНрдд рднрдПрдХреЛ, рдирд┐рд░рд╛рд╢ рддрд░ рдЪрд┐рдиреНрддрд╛ рдореБрдХреНрдд рдЕрдиреБрд╣рд╛рд░, рдирд┐рд░рд╛рд╢ рднрдПрдХреЛ, рд╣реНрд╡рд┐рдЙ
ЁЯШо => ЁЯШо, рдЕрдиреБрд╣рд╛рд░, рдЦреБрд▓рд╛, рдЦреБрд▓рд╛ рдореБрдЦ рд╕рд╣рд┐рддрдХреЛ рдЕрдиреБрд╣рд╛рд░, рдореБрдЦ, рд╕рд╣рд╛рдиреБрднреВрддрд┐
ЁЯдР => ЁЯдР, рдЕрдиреБрд╣рд╛рд░, рдЬрд┐рдкрд░, рдореБрдЦ, рдореБрдЦ рдЯрд╛рд▓рд┐рдПрдХреЛ рдЕрдиреБрд╣рд╛рд░
ЁЯШп => ЁЯШп, рдЕрдиреБрд╣рд╛рд░, рдЖрд╢реНрдЪрд░реНрдп рдЪрдХрд┐рдд рднрдПрдХреЛ, рд╢рд╛рдиреНрдд, рд╢рд╛рдиреНрдд рдЕрдиреБрд╣рд╛рд░, рд╣реИрд░рд╛рди рднрдПрдХреЛ
ЁЯШк => ЁЯШк, рдЕрдиреБрд╣рд╛рд░, рдирд┐рджреНрд░рд╛рд▓реБ рдЕрдиреБрд╣рд╛рд░, рд╕реБрддреЗрдХреЛ
ЁЯШл => ЁЯШл, рдЕрдиреБрд╣рд╛рд░, рдерд╛рдХреЗрдХреЛ, рдерд╛рдХреЗрдХреЛ рдЕрдиреБрд╣рд╛рд░
ЁЯШ┤ => ЁЯШ┤, рдЕрдиреБрд╣рд╛рд░, рдирд┐рджрд╛рдЗрд░рд╣реЗрдХреЛ рдЕрдиреБрд╣рд╛рд░, рдирд┐рджрд╛рдПрдХреЛ, рдирд┐рджреНрд░рд╛
ЁЯШМ => ЁЯШМ, рдЕрдиреБрд╣рд╛рд░, рдЪрд┐рдиреНрддрд╛ рдореБрдХреНрдд, рдЪрд┐рдиреНрддрд╛ рдореБрдХреНрдд рдЕрдиреБрд╣рд╛рд░
ЁЯШЫ => ЁЯШЫ, рдЕрдиреБрд╣рд╛рд░, рдЬрд┐рдмреНрд░реЛ рдмрд╛рд╣рд┐рд░ рдирд┐рд╕реНрдХреЗрдХреЛ, рдЬрд┐рдмреНрд░реЛ рдмрд╛рд╣рд┐рд░ рдирд┐рд╕реНрдХреЗрдХреЛ рдЕрдиреБрд╣рд╛рд░
ЁЯШЬ => ЁЯШЬ, рдЕрдиреБрд╣рд╛рд░, рдЖрдБрдЦрд╛, рдЖрдБрдЦрд╛ рдЭрд┐рдореНрдХрд╛рдЙрдиреЗ, рдЬрд┐рдмреНрд░реЛ, рдЬрд┐рдмреНрд░реЛ рдмрд╛рд╣рд┐рд░ рдирд┐рд╕реНрдХреЗрдХреЛ рд░ рдЖрдБрдЦрд╛ рдЭрд┐рдореНрдХрд╛рдПрдХреЛ рдЕрдиреБрд╣рд╛рд░, рд░рдорд╛рдЗрд▓реЛ
ЁЯШЭ => ЁЯШЭ, рдЕрдиреБрд╣рд╛рд░, рдЖрдБрдЦрд╛, рдЬрд┐рдмреНрд░реЛ, рдЬрд┐рдмреНрд░реЛ рдмрд╛рд╣рд┐рд░ рдирд┐рд╕реНрдХреЗрдХреЛ рд░ рдЖрдБрдЦрд╛ рдЪрд┐рдореНрдо рдЧрд░рд┐рдПрдХреЛ рдЕрдиреБрд╣рд╛рд░, рдбрд░рд▓рд╛рдЧреНрджреЛ, рд╕реНрд╡рд╛рдж
ЁЯдд => ЁЯдд, рдЕрдиреБрд╣рд╛рд░, рд░реНрдпрд╛рд▓ рдЭрд░реЗрдХреЛ, рд░реНрдпрд╛рд▓реЗ рдЕрдиреБрд╣рд╛рд░
ЁЯШТ => ЁЯШТ, рдЕрдиреБрд╣рд╛рд░, рдЕрдкреНрд░рд╕рдиреНрди, рдЕрдкреНрд░рд╕рдиреНрди рдЕрдиреБрд╣рд╛рд░, рд╡реЗрдЦреБрд╢реА
ЁЯШУ => ЁЯШУ, рдЕрдиреБрд╣рд╛рд░, рдЪрд┐рд╕реЛ, рдЪрд┐рд╕реЛ рдкрд╕рд┐рдирд╛ рд╕рд╣рд┐рддрдХреЛ рдЕрдиреБрд╣рд╛рд░, рдкрд╕рд┐рдирд╛
ЁЯШФ => ЁЯШФ, рдЕрдиреБрд╣рд╛рд░, рдЙрджрд╛рд╕, рдЪрд┐рдиреНрддрд╛рдЧреНрд░рд╕реНрдд, рдЪрд┐рдиреНрддрд╛рдЧреНрд░рд╕реНрдд рдЕрдиреБрд╣рд╛рд░
ЁЯШХ => ЁЯШХ, рдЕрдиреБрд╣рд╛рд░, рджреЛрдзрд╛рд░рдпреБрдХреНрдд, рджреЛрдзрд╛рд░рдпреБрдХреНрдд рдЕрдиреБрд╣рд╛рд░
ЁЯЩГ => ЁЯЩГ, рдЕрдиреБрд╣рд╛рд░, рдорд╛рдерд┐-рддрд▓ рднрдПрдХреЛ, рдорд╛рдерд┐-рддрд▓ рднрдПрдХреЛ рдЕрдиреБрд╣рд╛рд░
ЁЯдС => ЁЯдС, рдЕрдиреБрд╣рд╛рд░, рдкреИрд╕рд╛, рдкреИрд╕рд╛рдХреЛ-рдореБрдЦ рднрдПрдХреЛ рдЕрдиреБрд╣рд╛рд░, рдореБрдЦ
ЁЯШ▓ => ЁЯШ▓, рдЕрдиреБрд╣рд╛рд░, рдЪрдХрд┐рдд, рдЪрдХрд┐рдд рдЕрдиреБрд╣рд╛рд░, рджрдВрдЧ рднрдПрдХреЛ, рдкреВрд░реИ
тШ╣ => тШ╣, рдЕрдиреБрд╣рд╛рд░, рдХреБрдбрд┐рдПрдХреЛ рдЕрдиреБрд╣рд╛рд░, рд░рд┐рд╕рд╛рдПрдХреЛ
ЁЯЩБ => ЁЯЩБ, рдЕрдиреБрд╣рд╛рд░, рд░рд┐рд╕рд╛рдПрдХреЛ, рд╣рд▓реНрдХрд╛ рд░рд┐рд╕рд╛рдПрдХреЛ рдЕрдиреБрд╣рд╛рд░
ЁЯШЦ => ЁЯШЦ, рдЕрдиреБрд╣рд╛рд░, рдЪрдХрд┐рдд, рджреБрд╡рд┐рдзрд╛рдпреБрдХреНрдд рдЕрдиреБрд╣рд╛рд░
ЁЯШЮ => ЁЯШЮ, рдЕрдиреБрд╣рд╛рд░, рдирд┐рд░рд╛рд╢ рдЕрдиреБрд╣рд╛рд░, рдирд┐рд░рд╛рд╢ рднрдПрдХреЛ
ЁЯШЯ => ЁЯШЯ, рдЕрдиреБрд╣рд╛рд░, рдЪрд┐рдиреНрддрд┐рдд, рдЪрд┐рдиреНрддрд┐рдд рдЕрдиреБрд╣рд╛рд░
ЁЯШд => ЁЯШд, рдЕрдиреБрд╣рд╛рд░, рдирд╛рдХрдмрд╛рдЯ рд╡рд╛рдл рд╕рд╣рд┐рддрдХреЛ рдЕрдиреБрд╣рд╛рд░, рд╡рд┐рдЬрдпреА, рд╕рдлрд▓рддрд╛
ЁЯШв => ЁЯШв, рдЕрдиреБрд╣рд╛рд░, рдЖрдБрд╢реБ, рджреБрдГрдЦреА, рд░реЛрдПрдХреЛ, рд░реЛрдПрдХреЛ рдЕрдиреБрд╣рд╛рд░
ЁЯШн => ЁЯШн, рдЕрдиреБрд╣рд╛рд░, рдЖрдБрд╢реБ, рдЬреЛрдбрд▓реЗ рд░реЛрдПрдХреЛ рдЕрдиреБрд╣рд╛рд░, рджреБрдГрдЦреА, рд░реЛрдПрдХреЛ, рд╕реБрдХреНрдХрд╕реБрдХреНрдХ
ЁЯШж => ЁЯШж, рдЕрдиреБрд╣рд╛рд░, рдЦреБрд▓рд╛, рдЦреБрд▓рд╛ рдореБрдЦ рд╕рд╣рд┐рддрдХреЛ рд░рд┐рд╕рд╛рдПрдХреЛ рдЕрдиреБрд╣рд╛рд░, рддреЗрд╡рд░, рдореБрдЦ
ЁЯШз => ЁЯШз, рдЕрдиреБрд╣рд╛рд░, рджреБ:рдЦреА рдЕрдиреБрд╣рд╛рд░, рджреБрдЦреА
ЁЯШи => ЁЯШи, рдЕрдиреБрд╣рд╛рд░, рдбрд░рд▓рд╛рдЧреНрджреЛ, рдбрд░рд╛рдПрдХреЛ, рдбрд░рд╛рдПрдХреЛ рдЕрдиреБрд╣рд╛рд░, рднрдпрд╡рд┐рдд
ЁЯШй => ЁЯШй, рдЕрдиреБрд╣рд╛рд░, рдЬреНрдпрд╛рджреИ рдерд╛рдХреЗрдХреЛ, рдердХрд┐рдд, рд╡рд┐рдЪрд▓рд┐рдд рдЕрдиреБрд╣рд╛рд░
ЁЯдп => ЁЯдп, рдмрд┐рд╕реНрдлреЛрдЯ рднрдЗрд░рд╣реЗрдХреЛ рдЯрд╛рдЙрдХреЛ, рд╕реНрддрдмреНрдз
ЁЯШм => ЁЯШм, рдЕрдиреБрд╣рд╛рд░, рдореБрдЦ рдмрдирд╛рдПрдХреЛ, рдореБрдЦ рдмрдирд╛рдПрдХреЛ рдЕрдиреБрд╣рд╛рд░
ЁЯШ░ => ЁЯШ░, рдЕрдиреБрд╣рд╛рд░, рдЦреБрд▓рд╛, рдЦреБрд▓рд╛ рдореБрдЦ рд░ рдЪрд┐рд╕реЛ рдкрд╕рд┐рдирд╛ рд╕рд╣рд┐рддрдХреЛ рдЕрдиреБрд╣рд╛рд░, рдЪрд┐рд╕реЛ, рдиреАрд▓реЛ, рдкрд╕рд┐рдирд╛, рдореБрдЦ, рд╣рддрд╛рд░рд┐рдПрдХреЛ
ЁЯШ▒ => ЁЯШ▒, рдЕрдиреБрд╣рд╛рд░, рдЪрдкрд╛рдЙрдиреЗ, рдЪрд┐рдЪреНрдпрд╛рдЙрдиреЗ, рдбрд░рд▓рд╛рдЧреНрджреЛ, рдбрд░рд▓реЗ рдЪрд┐рдЪреНрдЪрд╛рдПрдХреЛ рдЕрдиреБрд╣рд╛рд░, рдбрд░рд╛рдПрдХреЛ, рднрдпрд╡рд┐рдд
ЁЯШ│ => ЁЯШ│, рдЕрдиреБрд╣рд╛рд░, рд░рд╛рддреЛ рднрдПрдХреЛ, рд░рд╛рддреЛ рднрдПрдХреЛ рдЕрдиреБрд╣рд╛рд░, рд╕реНрддрдмреНрдз
ЁЯдк => ЁЯдк, рдЖрдБрдЦрд╛, рдареВрд▓реЛ, рдореВрд░реНрдЦ рдЕрдиреБрд╣рд╛рд░, рд╕рд╛рдиреЛ
ЁЯШ╡ => ЁЯШ╡, рдЕрдиреБрд╣рд╛рд░, рд░рд┐рдВрдЧрдЯрд╛ рд▓рд╛рдЧреЗрдХреЛ, рд░рд┐рдВрдЧрдЯрд╛ рд▓рд╛рдЧреЗрдХреЛ рдЕрдиреБрд╣рд╛рд░
ЁЯШб => ЁЯШб, рдЕрдиреБрд╣рд╛рд░, рдЙрдЧреНрд░, рдкрд╛рдЧрд▓, рдореБрдЦ рдлреБрд▓рд╛рдПрдХреЛ, рдореБрдЦ рдлреБрд▓рд╛рдПрдХреЛ рдЕрдиреБрд╣рд╛рд░, рд░рд╛рддреЛ, рд░рд┐рд╕рд╛рдПрдХреЛ
ЁЯШа => ЁЯШа, рдЕрдиреБрд╣рд╛рд░, рдкрд╛рдЧрд▓, рд░рд┐рд╕рд╛рдПрдХреЛ, рд░рд┐рд╕рд╛рдПрдХреЛ рдЕрдиреБрд╣рд╛рд░
ЁЯдм => ЁЯдм, рдЕрдкрд╢рдмреНрдж рдмреЛрд▓реЗрдХреЛ рдЕрдиреБрд╣рд╛рд░, рдореБрдЦрдорд╛ рдмрд┐рднрд┐рдиреНрди рдкреНрд░рддрд┐рдХ рднрдПрдХреЛ рдЕрдиреБрд╣рд╛рд░
ЁЯШ╖ => ЁЯШ╖, рдЕрдиреБрд╣рд╛рд░, рдФрд╖рдзрд┐, рдЪрд┐рдХрд┐рддреНрд╕рд╛ рдорд╛рд╕реНрдХ рд╕рд╣рд┐рддрдХреЛ рдЕрдиреБрд╣рд╛рд░, рдЪрд┐рд╕реЛ, рдбрд╛рдХреНрдЯрд░, рдмрд┐рдорд╛рд░реА, рдорд╛рдХреНрд╕
ЁЯдТ => ЁЯдТ, рдЕрдиреБрд╣рд╛рд░, рдЬреНрд╡рд░реЛ, рдерд░реНрдореЛрдорд┐рдЯрд░, рдерд░реНрдореЛрдорд┐рдЯрд░ рд╕рд╣рд┐рддрдХреЛ рдЕрдиреБрд╣рд╛рд░, рдмрд┐рдорд╛рд░реА
ЁЯдХ => ЁЯдХ, рдЕрдиреБрд╣рд╛рд░, рдШрд╛рдЙ, рдЪреЛрдЯ, рдЯрд╛рдЙрдХреЛрдХреЛ-рдкрдЯреНрдЯрд┐ рд╕рд╣рд┐рддрдХреЛ рдЕрдиреБрд╣рд╛рд░, рдкрдЯреНрдЯрд┐
ЁЯдв => ЁЯдв, рдЕрдиреБреБрд╣рд╛рд░, рдмрд╛рдиреНрддрд╛, рдмрд╛рдиреНрддрд╛ рдЧрд░реЗрдХреЛ, рдмрд╛рдиреНрддрд╛ рдЧрд░реЗрдХреЛ рдЕрдиреБрд╣рд╛рд░
ЁЯдо => ЁЯдо, рдмрд╛рдиреНрддрд╛, рдмрд╛рдиреНрддрд╛ рдЧрд░реНрджреИ рдЧрд░реЗрдХреЛ рдЕрдиреБрд╣рд╛рд░, рдмрд┐рд░рд╛рдореА
ЁЯдз => ЁЯдз, рдЕрдиреБрд╣рд╛рд░, рдЬрд┐рд╕реБрдирдбрд┐рд╣рд╛рдЗрдЯ, рд╣рд╛рдЪреНрдЫрд┐рдЙрдБ, рд╣рд╛рдЪреНрдЫрд┐рдЙрдБ рдЧрд░реЗрдХреЛ рдЕрдиреБрд╣рд╛рд░
ЁЯШЗ => ЁЯШЗ, рдЕрдиреБрд╣рд╛рд░, рдЦреЗрд╕реНрд░рд╛ рдХрд▓реНрдкрдирд╛, рдирд┐рд░реНрджреЛрд╖, рдкрд░реА, рдкрд░реАрдХреЛ рдХрдерд╛, рдореБрд╕реНрдХрд╛рди, рд╣реЗрд▓реЛ, рд╣реНрдпрд╛рд▓реЛ рд╕рд╣рд┐рддрдХреЛ рд╣рдБрд╕рд┐рд▓реЛ рдЕрдиреБрд╣рд╛рд░
ЁЯда => ЁЯда, рдЕрдиреБрд╣рд╛рд░, рдХрд╛рдЙрдЧрд░реНрд▓, рдХрд╛рдЙрд╡реНрд╡рд╛рдЗ, рдХрд╛рдЙрд╡реНрд╡рд╛рдЗ рд╣реНрдпрд╛рдЯ рдЕрдиреБрд╣рд╛рд░, рд╣реНрдпрд╛рдЯ
ЁЯдб => ЁЯдб, рдЕрдиреБрд╣рд╛рд░, рд╣рд╕рд╛рдЙрдБрдиреЗ рдорд╛рдиреНрдЫреЗ, рд╣рд╕рд╛рдЙрдБрдиреЗ рдорд╛рдиреНрдЫреЗрдХреЛ рдЕрдиреБрд╣рд╛рд░
ЁЯде => ЁЯде, рдЕрдиреБрд╣рд╛рд░, рдЭреБрдЯ, рдЭреБрдЯ рдмреЛрд▓реЗрдХреЛ рдЭрд▓реНрдХрд┐рдиреЗ рдЕрдиреБрд╣рд╛рд░, рдкрд┐рдиреЛрдЪреНрдЪрд┐рдпреЛ
ЁЯдл => ЁЯдл, рдЪреБрдк рд▓рд╛рдЧреНрди рдЖрдЧреНрд░рд╣, рдЪреБрдк рд▓рд╛рдЧреНрди рдЖрдЧреНрд░рд╣ рдЧрд░рд┐рд░рд╣реЗрдХреЛ рдЕрдиреБрд╣рд╛рд░, рдореМрдВрди
ЁЯдн => ЁЯдн, рдЫрдХреНрдХ рдкрд░реЗрдХреЛ рднрд╛рд╡ рднрдПрдХреЛ рдЕрдиреБрд╣рд╛рд░, рд╣реБрдкреНрд╕
ЁЯзР => ЁЯзР, рдореЛрдиреЛрдХрд▓рд╕рд╣рд┐рддрдХреЛ рдЕрдиреБрд╣рд╛рд░, рд░реБрд╖реНрдЯ
ЁЯдУ => ЁЯдУ, рдЕрдиреБрд╣рд╛рд░, рдХрд┐рддрд╛рдмрдХреЛ рдХрд┐рд░рд╛, рдкрдврдиреНрджрд╛рд╕ рдЕрдиреБрд╣рд╛рд░, рд╡рд┐рдЬреНрдЮ
ЁЯШИ => ЁЯШИ, рдЕрдиреБрд╣рд╛рд░, рдЦреЗрд╕реНрд░рд╛ рдХрд▓реНрдкрдирд╛, рдкрд░реАрдХреЛ рдХрдерд╛, рд╕рд┐рдВрдЩ, рд╕рд┐рдЩ рд╕рд╣рд┐рддрдХреЛ рд╣рдБрд╕рд┐рд▓реЛ рдЕрдиреБрд╣рд╛рд░, рд╣рд╛рдБрд╕реЛ
ЁЯС┐ => ЁЯС┐, рдЕрдиреБрд╣рд╛рд░, рдЦреЗрд╕реНрд░рд╛ рдХрд▓реНрдкрдирд╛, рдкрд░реАрдХреЛ рдХрдерд╛, рдкрд┐рд╢рд╛рдЪ, рд░рд╛рдХреНрд╖рд╖, рд╕рд┐рдЩ рд╕рд╣рд┐рддрдХреЛ рд░рд┐рд╕рд╛рд╣рд╛ рдЕрдиреБрд╣рд╛рд░
ЁЯС╣ => ЁЯС╣, рдЕрдиреБрд╣рд╛рд░, рдЦреЗрд╕реНрд░рд╛ рдХрд▓реНрдкрдирд╛, рдЬрд╛рдкрд╛рдирд┐рдЬ, рдЬреАрд╡, рдкрд░реАрдХреЛ рдХрдерд╛, рд░рд╛рдХреНрд╖рд╕
ЁЯС║ => ЁЯС║, рдЕрдиреБрд╣рд╛рд░, рдЦреЗрд╕реНрд░рд╛ рдХрд▓реНрдкрдирд╛, рдЬрд╛рдкрд╛рдирд┐рдЬ, рдЬреАрд╡, рдкрд░реАрдХреЛ рдХрдерд╛, рд░рд╛рдХреНрд╖рд╕, рд╕рд╛рдиреЛ рднреВрдд
ЁЯТА => ЁЯТА, рдЕрдиреБрд╣рд╛рд░, рдЦреЗрд╕реНрд░рд╛ рдХрд▓реНрдкрдирд╛, рдЦреЛрдкрдбреА, рдореГрддреНрдпреБ, рд░рд╛рдХреНрд╖рд╕, рд╢рд░реАрд░
тШа => тШа, рдЕрдиреБрд╣рд╛рд░, рдЦрдкреНрдкрд░, рдЦреЛрдкрдбреА, рдЦреЛрдкрдбреА рд░ рдЦрддрд░рд╛рдХреЛ рдЪрд┐рдиреНрд╣, рдореГрддреНрдпреБ, рд░рд╛рдХреНрд╖рд╕, рд╢рд░реАрд░
ЁЯС╗ => ЁЯС╗, рдЕрдиреБрд╣рд╛рд░, рдЦреЗрд╕реНрд░рд╛ рдХрд▓реНрдкрдирд╛, рдЬреАрд╡, рдкрд░реАрдХреЛ рдХрдерд╛, рднреВрдд, рд░рд╛рдХреНрд╖рд╕
ЁЯС╜ => ЁЯС╜, рдЕрдЬреНрдЮрд╛рдд рдЙрдбреНрдиреЗ рд╡рд╕реНрддреБ, рдЕрдВрддрд░рд┐рдХреНрд╖, рдЕрдВрддрд░рд┐рдХреНрд╖рд╡рд╛рд╕реА, рдЕрдиреБрд╣рд╛рд░, рдЦреЗрд╕реНрд░рд╛ рдХрд▓реНрдкрдирд╛, рдЬреАрд╡, рдкрд░рджреЗрд╢реА, рдкрд░реАрдХреЛ рдХрдерд╛
ЁЯС╛ => ЁЯС╛, рдЕрдЬреНрдЮрд╛рдд рдЙрдбреНрдиреЗ рд╡рд╕реНрддреБ, рдЕрдВрддрд░рд┐рдХреНрд╖, рдЕрдВрддрд░рд┐рдХреНрд╖рд╡рд╛рд╕реА, рдЕрдиреБрд╣рд╛рд░, рдЦреЗрд╕реНрд░рд╛ рдХрд▓реНрдкрдирд╛, рдЬреАрд╡, рдкрд░рджреЗрд╢реА рд░рд╛рдХреНрд╖рд╕, рдкрд░реАрдХреЛ рдХрдерд╛, рд░рд╛рдХреНрд╖рд╕
ЁЯдЦ => ЁЯдЦ, рдЕрдиреБрд╣рд╛рд░, рд░рд╛рдХреНрд╖рд╕, рд░реЛрдмреЛрдЯ, рд░реЛрдмреЛрдЯ рдЕрдиреБрд╣рд╛рд░
ЁЯТй => ЁЯТй, рдЕрдВрдзрдХреБрдк, рдЕрдиреБрд╣рд╛рд░, рдкрдк, рдкреБ, рдкреБрдХреЛ рдереБрдкреНрд░реЛ, рд░рд╛рдХреНрд╖рд╕, рд╣рд╛рд╕реНрдпрдкреНрд░рдж
ЁЯШ║ => ЁЯШ║, рдЕрдиреБрд╣рд╛рд░, рдЦреБрд▓рд╛, рдЦреБрд▓рд╛ рдореБрдЦ рд╕рд╣рд┐рддрдХреЛ рд╣рдБрд╕рд┐рд▓реЛ рдмрд┐рд░рд╛рд▓реЛрдХреЛ рдЕрдиреБрд╣рд╛рд░, рдмрд┐рд░рд╛рд▓реЛ, рдореБрдЦ, рдореБрд╕реНрдХрд╛рди
ЁЯШ╕ => ЁЯШ╕, рдЕрдиреБрд╣рд╛рд░, рдЖрдБрдЦрд╛, рдЪрдореНрдХрд┐рд▓рд╛ рдЖрдБрдЦрд╛ рд╕рд╣рд┐рддрдХреЛ рд╣рдБрд╕рд┐рд▓реЛ рдмрд┐рд░рд╛рд▓реЛрдХреЛ рдЕрдиреБрд╣рд╛рд░, рдмрд┐рд░рд╛рд▓реЛ, рдореБрд╕реНрдХрд╛рди, рд╣рдБрд╕рд┐рд▓реЛ
ЁЯШ╣ => ЁЯШ╣, рдЕрдиреБрд╣рд╛рд░, рдЖрдБрд╢реБ, рдЦреБрд╕реАрдХреЛ рдЖрдБрд╢реБ рд╕рд╣рд┐рддрдХреЛ рдмрд┐рд░рд╛рд▓реЛрдХреЛ рдЕрдиреБрд╣рд╛рд░, рдмрд┐рд░рд╛рд▓реЛ, рд░рдорд╛рдПрдХреЛ
ЁЯШ╗ => ЁЯШ╗, рдЕрдиреБрд╣рд╛рд░, рдЖрдБрдЦрд╛, рдмрд┐рд░рд╛рд▓реЛ, рдорд╛рдпрд╛, рдореБрдЯреБ, рдореБрдЯреБрдХреЛ-рдЖрдХрд╛рд░рдХреЛ рдЖрдБрдЦрд╛ рднрдПрдХреЛ рд╣рдБрд╕рд┐рд▓реЛ рдмрд┐рд░рд╛рд▓реЛрдХреЛ рдЕрдиреБрд╣рд╛рд░, рдореБрд╕реНрдХрд╛рди
ЁЯШ╝ => ЁЯШ╝, рдЕрдиреБрд╣рд╛рд░, рдмрд┐рд░рд╛рд▓реЛ, рдореБрд╕реНрдХрд╛рди, рд╡реНрдпрдВрдЧрд╛рддреНрдордХ, рд╡реНрдпрдВрдЧреНрдпрдкреВрд░реНрдг рд╣рд╛рдБрд╕реЛ, рд╡реНрдпрдВрдЧреНрдпрдкреВрд░реНрдг рд╣рд╛рдБрд╕реЛ рд╕рд╣рд┐рддрдХреЛ рдмрд┐рд░рд╛рд▓реЛрдХреЛ рдЕрдиреБрд╣рд╛рд░
ЁЯШ╜ => ЁЯШ╜, рдЕрдиреБрд╣рд╛рд░, рдЖрдБрдЦрд╛, рдЪреБрдореНрдмрди, рдмрдиреНрдж рдЖрдБрдЦрд╛ рд╕рд╣рд┐рддрдХреЛ рдЪреБрдореНрдмрди рдЧрд░рд┐рд░рд╣реЗрдХреЛ рдмрд┐рд░рд╛рд▓реЛрдХреЛ рдЕрдиреБрд╣рд╛рд░, рдмрд┐рд░рд╛рд▓реЛ
ЁЯЩА => ЁЯЩА, рдЕрдирд╛рд╣рд╛рд░ рдЕрд╣реЛ, рдЖрд╢реНрдЪрд░реНрдпрдЪрдХрд┐рдд, рдерд╛рдХреЗрдХреЛ, рдерд╛рдХреЗрдХреЛ рдмрд┐рд░рд╛рд▓реЛрдХреЛ рдЕрдиреБрд╣рд╛рд░, рдмрд┐рд░рд╛рд▓реЛ
ЁЯШ┐ => ЁЯШ┐, рдЕрдиреБрд╣рд╛рд░, рдЖрдБрд╢реБ, рджреБрдГрдЦреА, рдмрд┐рд░рд╛рд▓реЛ, рд░реЛрдЗрд░рд╣реЗрдХреЛ, рд░реЛрдЗрд░рд╣реЗрдХреЛ рдмрд┐рд░рд╛рд▓реЛрдХреЛ рдЕрдиреБрд╣рд╛рд░
ЁЯШ╛ => ЁЯШ╛, рдЕрдиреБрд╣рд╛рд░, рдмрд┐рд░рд╛рд▓реЛ, рдореБрдЦ рдлреБрд▓рд╛рдЗрд░рд╣реЗрдХреЛ, рдореБрдЦ рдлреБрд▓рд╛рдЗрд░рд╣реЗрдХреЛ рдмрд┐рд░рд╛рд▓реЛрдХреЛ рдЕрдиреБрд╣рд╛рд░
ЁЯЩИ => ЁЯЩИ, рдЕрдиреБрд╣рд╛рд░, рдЗрд╢рд╛рд░рд╛, рдХреБрдиреИ-рдирдЪрд╛рд╣рд┐рдиреЗ рдХреБрд░рд╛-рджреЗрдЦреНрджреИрди, рдЫреИрди, рджреБрд╖реНрдЯрддрд╛, рдирд┐рд╖реЗрдз рдЧрд░рд┐рдПрдХреЛ, рдирд┐рд╖реЗрдзрд┐рдд, рдмрд╛рдБрджрд░, рд╣реЗрд░реНрди, рд╣реЛрдЗрди
ЁЯЩЙ => ЁЯЩЙ, рдЕрдиреБрд╣рд╛рд░, рдЗрд╢рд╛рд░рд╛, рдХреБрдиреИ-рдирдЪрд╛рд╣рд┐рдиреЗ рдХреБрд░рд╛-рд╕реБрдиреНрджреИрди, рдЫреИрди, рджреБрд╖реНрдЯрддрд╛, рдирд┐рд╖реЗрдз рдЧрд░рд┐рдПрдХреЛ, рдирд┐рд╖реЗрдзрд┐рдд, рдмрд╛рдБрджрд░, рд╕реБрдиреНрдиреЗ, рд╣реЛрдЗрди
ЁЯЩК => ЁЯЩК, рдЕрдиреБрд╣рд╛рд░, рдЗрд╢рд╛рд░рд╛, рдХреБрдиреИ-рдирдЪрд╛рд╣рд┐рдиреЗ рдХреБрд░рд╛-рдмреЛрд▓реНрджреИрди, рдЫреИрди, рджреБрд╖реНрдЯрддрд╛, рдирд┐рд╖реЗрдз рдЧрд░рд┐рдПрдХреЛ, рдирд┐рд╖реЗрдзрд┐рдд, рдмрд╛рдБрджрд░, рдмреЛрд▓реНрди, рд╣реЛрдЗрди
ЁЯС╢ => ЁЯС╢, рдмрдЪреНрдЪрд╛, рд╢рд┐рд╢реБ
ЁЯзТ => ЁЯзТ, рдЬрд╡рд╛рди, рдмрдЪреНрдЪрд╛, рд▓реИрдЩреНрдЧрд┐рдХ рд╣рд┐рд╕рд╛рдмрд▓реЗ рддрдЯрд╕реНрде
ЁЯСж => ЁЯСж, рдХреЗрдЯрд╛, рдкреБрд░реВрд╖
ЁЯСз => ЁЯСз, рдХрдиреНрдпрд╛, рдХреБрдорд╛рд░реА, рдХреЗрдЯреА, рд░рд╛рд╢рд┐
ЁЯзС => ЁЯзС, рд▓реИрдЩреНрдЧрд┐рдХ рд╣рд┐рд╕рд╛рдмрд▓реЗ рддрдЯрд╕реНрде, рд╡рдпрд╕реНрдХ
ЁЯСи => ЁЯСи, рдЫреЛрд░рд╛ рдорд╛рдиреНрдЫреЗ, рдкреБрд░реВрд╖
ЁЯСй => ЁЯСй, рдЫреЛрд░реА рдорд╛рдиреНрдЫреЗ, рдорд╣рд┐рд▓рд╛
ЁЯзУ => ЁЯзУ, рдкрд╛рдХреЛ рд╡рдпрд╕реНрдХ, рд▓реИрдЩреНрдЧрд┐рдХ рд╣рд┐рд╕рд╛рдмрд▓реЗ рддрдЯрд╕реНрде
ЁЯС┤ => ЁЯС┤, рдЫреЛрд░рд╛рдорд╛рдиреНрдЫреЗ, рдмреВрдвреЛ, рдмреВрдвреЛ рдЫреЛрд░рд╛рдорд╛рдиреНрдЫреЗ
ЁЯС╡ => ЁЯС╡, рдмреВрдвреА, рдмреВрдвреА рдЖрдЗрдорд╛рдИ, рдорд╣рд┐рд▓рд╛
ЁЯСитАНтЪХ => ЁЯСитАНтЪХ, рдЪрд┐рдХрд┐рддреНрд╕рдХ, рдЫреЛрд░рд╛ рдорд╛рдиреНрдЫреЗ, рдереЗрд░рд╛рдкрд┐рд╕реНрдЯ, рдирд░реНрд╕, рдкреБрд░реВрд╖, рдкреБрд░реВрд╖ рд╕реНрд╡рд╛рд╕реНрдереНрдпрдХрд░реНрдореА, рд╕реНрд╡рд╛рд╕реНрдереНрдпрдХреЛ рд╣реЗрд░рд╡рд┐рдЪрд╛рд░
ЁЯСйтАНтЪХ => ЁЯСйтАНтЪХ, рдЪрд┐рдХрд┐рддреНрд╕рдХ, рдЫреЛрд░реА рдорд╛рдиреНрдЫреЗ, рдереЗрд░рд╛рдкрд┐рд╕реНрдЯ, рдирд░реНрд╕, рдорд╣рд┐рд▓рд╛, рдорд╣рд┐рд▓рд╛ рд╕реНрд╡рд╛рд╕реНрдереНрдпрдХрд░реНрдореА, рд╕реНрд╡рд╛рд╕реНрдереНрдпрдХреЛ рд╣реЗрд░рд╡рд┐рдЪрд╛рд░
ЁЯСитАНЁЯОУ => ЁЯСитАНЁЯОУ, рдЫреЛрд░рд╛ рдорд╛рдиреНрдЫреЗ, рдкреБрд░реВрд╖, рдкреБреБрд░реВрд╖ рд╡рд┐рджреНрдпрд╛рд░реНрдереА, рд╡рд┐рджреНрдпрд╛рд░реНрдереА, рд╢реИрдХреНрд╖рд┐рдХ рдпреЛрдЧреНрддрд╛ рдкреНрд░рд╛рдкреНрдд рд╡реНрдпрдХреНрддрд┐
ЁЯСйтАНЁЯОУ => ЁЯСйтАНЁЯОУ, рдЫреЛрд░реА рдорд╛рдиреНрдЫреЗ, рдорд╣рд┐рд▓рд╛, рдорд╣рд┐рд▓рд╛ рд╡рд┐рджреНрдпрд╛рд░реНрдереА, рд╡рд┐рджреНрдпрд╛рд░реНрдереА, рд╢реИрдХреНрд╖рд┐рдХ рдпреЛрдЧреНрдпрддрд╛ рдкреНрд░рд╛рдкреНрдд рд╡реНрдпрдХреНрддрд┐
ЁЯСитАНЁЯПл => ЁЯСитАНЁЯПл, рдЫреЛрд░рд╛ рдорд╛рдиреНрдЫреЗ, рдкреБрд░реВрд╖, рдкреБрд░реВрд╖ рд╢рд┐рдХреНрд╖рдХ, рдкреНрд░рд╢рд┐рдХреНрд╖рдХ, рдкреНрд░рд╛рдзреНрдпрд╛рдкрдХ, рд╢рд┐рдХреНрд╖рдХ
ЁЯСйтАНЁЯПл => ЁЯСйтАНЁЯПл, рдЫреЛрд░реА рдорд╛рдиреНрдЫреЗ, рдкреНрд░рд╢рд┐рдХреНрд╖рдХ, рдкреНрд░рд╛рдзреНрдпрд╛рдкрдХ, рдорд╣рд┐рд▓рд╛, рдорд╣рд┐рд▓рд╛ рд╢рд┐рдХреНрд╖рд┐рдХрд╛, рд╢рд┐рдХреНрд╖рдХ
ЁЯСитАНтЪЦ => ЁЯСитАНтЪЦ, рдЫреЛрд░рд╛ рдорд╛рдиреНрдЫреЗ, рдиреНрдпрд╛рдп, рдкреБрд░реВрд╖, рдкреБрд░реВрд╖ рдиреНрдпрд╛рдпрдзрд┐рд╢, рд╕реНрдХреЗрд▓
ЁЯСйтАНтЪЦ => ЁЯСйтАНтЪЦ, рдЫреЛрд░реА рдорд╛рдиреНрдЫреЗ, рдиреНрдпрд╛рдпрдзрд┐рд╢, рдорд╣рд┐рд▓рд╛, рдорд╣рд┐рд▓рд╛ рдиреНрдпрд╛рдпрдзрд┐рд╢, рд╕реНрдХреЗрд▓
ЁЯСитАНЁЯМ╛ => ЁЯСитАНЁЯМ╛, рдХреГрд╖рдХ, рдЫреЛрд░рд╛ рдорд╛рдиреНрдЫреЗ, рдкреБрд░реВрд╖, рдкреБрд░реВрд╖ рдХреГрд╖рдХ, рдорд╛рд▓реА, рд░реНрдпрд╛рдиреНрдЪрд░
ЁЯСйтАНЁЯМ╛ => ЁЯСйтАНЁЯМ╛, рдХреГрд╖рдХ, рдЫреЛрд░реА рдорд╛рдиреНрдЫреЗ, рдорд╣рд┐рдХрд╛ рдХреГрд╖рдХ, рдорд╣рд┐рд▓рд╛, рдорд╛рд▓реА, рд░реНрдпрд╛рдиреНрдЪрд░
ЁЯСитАНЁЯН│ => ЁЯСитАНЁЯН│, рдЫреЛрд░рд╛ рдорд╛рдиреНрдЫреЗ, рдкреБрд░реВрд╖, рдкреБрд░реВрд╖ рднрд╛рдиреНрд╕реЗ, рднрд╛рдиреНрд╕реЗ, рд╕реЗрдл
ЁЯСйтАНЁЯН│ => ЁЯСйтАНЁЯН│, рдЫреЛрд░реА рдорд╛рдиреНрдЫреЗ, рднрд╛рдиреНрд╕реЗ, рдорд╣рд┐рд▓рд╛, рдорд╣рд┐рд▓рд╛ рднрд╛рдиреНрд╕реЗ, рд╕реЗреЗрдл
ЁЯСитАНЁЯФз => ЁЯСитАНЁЯФз, рдЫреЛрд░рд╛ рдорд╛рдиреНрдЫреЗ, рдкреБрд░реВрд╖, рдкреБрд░реВрд╖ рдорд┐рд╕реНрддреНрд░реА, рдкреНрд▓рдореНрдмрд░, рдмрд┐рдЬреБрд▓реАрдХреЛ рдХрд╛рдо рдЧрд░реНрдиреЗ рд╡реНрдпрдХреНрддрд┐, рдорд┐рд╕реНрддреНрд░реА, рд╡реНрдпрд╛рдкрд╛рд░реА
ЁЯСйтАНЁЯФз => ЁЯСйтАНЁЯФз, рдЫреЛрд░реА рдорд╛рдиреНрдЫреЗ, рдкреНрд▓рдореНрдмрд░, рдмрд┐рдЬреБреБрд▓реАрдХреЛ рдХрд╛рдо рдЧрд░реНрдиреЗ рд╡реНрдпрдХреНрддрд┐, рдорд╣рд┐рд▓рд╛, рдорд╣рд┐рд▓рд╛ рдорд┐рд╕реНрддреНрд░реА, рдорд┐рд╕реНрддреНрд░реА, рд╡реНрдпрд╛рдкрд╛рд░реА
ЁЯСитАНЁЯПн => ЁЯСитАНЁЯПн, рдФрджреНрдпреЛрдЧрд┐рдХ, рдХрд╛рд░рдЦрд╛рдирд╛, рдХрд╛рд░рдЦрд╛рдирд╛рдХреЛ рдкреБрд░реВрд╖ рдордЬрджреБрд░, рдЫреЛрд░рд╛ рдорд╛рдиреНрдЫреЗ, рдкреБрд░реВрд╖, рдордЬрджреБрд░, рд╕рднрд╛
ЁЯСйтАНЁЯПн => ЁЯСйтАНЁЯПн, рдФрджреНрдпреЛрдЧрд┐рдХ, рдХрд╛рд░рдЦрд╛рдирд╛, рдХрд╛рд░рдЦрд╛рдирд╛рдХреЛ рдорд╣рд┐рд▓рд╛ рдордЬрджреБрд░, рдЫреЛрд░реА рдорд╛рдиреНрдЫреЗ, рдордЬрджреБрд░, рдорд╣рд┐рд▓рд╛, рд╕рднрд╛
ЁЯСитАНЁЯТ╝ => ЁЯСитАНЁЯТ╝, рдЖрд░реНрдХрд┐рдЯреЗрдХреНрдЯ, рдХрд╛рд░реНрдпрд╛рд▓рдп, рдХрд╛рд░реНрдпрд╛рд▓рдпрдХреЛ рдкреБрд░реВрд╖рдХрд░реНрдореА, рдЫреЛрд░рд╛ рдорд╛рдиреНрдЫреЗ, рдкреБрд░реВрд╖, рдкреНрд░рдмрдиреНрдзрдХ, рд╡реНрдпрд╡рд╕рд╛рдп, рд╕реЗрддреЛ рд░рдЩреНрдЧрдХреЛ рдХрдард╛рд▓реЛ рднрдПрдХреЛ рд▓реБрдЧрд╛
ЁЯСйтАНЁЯТ╝ => ЁЯСйтАНЁЯТ╝, рдЖрд░реНрдХрд┐рдЯреЗреЗрдХреНрдЯ, рдХрд╛рд░реНрдпрд╛рд▓рдп, рдХрд╛рд░реНрдпрд╛рд▓рдпрдХреЛ рдорд╣рд┐рд▓рд╛рдХрд░реНрдореА, рдЫреЛрд░реА рдорд╛рдиреНрдЫреЗ, рдкреНрд░рдмрдиреНрдзрдХ, рдорд╣рд┐рд▓рд╛, рд╡реНрдпрд╡рд╕рд╛рдп, рд╕реЗрддреЛ рд░рдЩреНрдЧрдХреЛ рдХрдард╛рд▓реЛ рднрдПрдХреЛ рд▓реБрдЧрд╛
ЁЯСитАНЁЯФм => ЁЯСитАНЁЯФм, рдЗрдЮреНрдЬрд┐рдирд┐рдпрд░, рдЧрдгрд┐рдд рд╕рдореНрдмрдиреНрдзреА рд╡рд┐рд╢реЗрд╖рдЬреНрдЮ, рдЫреЛрд░рд╛ рдорд╛рдиреНрдЫреЗ, рдЬреАрд╡ рд╢рд╛рд╕реНрддреНрд░реА, рдкреБрд░реВрд╖, рдкреБрд░реВрд╖ рд╡реИрдЬреНрдЮрд╛рдирд┐рдХ, рднреМрддрд┐рдХ рд╢рд╛рд╕реНрддреНрд░реА, рд░рд╕рд╛рдпрди рд╢рд╛рд╕реНрддреНрд░реА, рд╡реИрдЬреНрдЮрд╛рдирд┐рдХ
ЁЯСйтАНЁЯФм => ЁЯСйтАНЁЯФм, рдЗрдЮреНрдЬрд┐рдирд┐рдпрд░, рдЧрдгрд┐рдд рд╕рдореНрдмрдиреНрдзреА рд╡рд┐рд╢реЗрд╖рдЬреНрдЮ, рдЫреЛрд░реА рдорд╛рдиреНрдЫреЗ, рдЬреАрд╡ рд╢рд╛рд╕реНрддреНрд░реА, рднреМрддрд┐рдХ рд╢рд╛рд╕реНрддреНрд░реА, рдорд╣рд┐рд▓рд╛, рдорд╣рд┐рд▓рд╛ рд╡реИрдЬреНрдЮрд╛рдирд┐рдХ, рд░рд╕рд╛рдпрди рд╢рд╛рд╕реНрддреНрд░реА, рд╡реИрдЬреНрдЮрд╛рдирд┐рдХ
ЁЯСитАНЁЯТ╗ => ЁЯСитАНЁЯТ╗, рдЖрд╡рд┐рд╖реНрдХрд╛рд░рдХ, рдХреЛрдбрд░, рдЫреЛрд░рд╛ рдорд╛рдиреНрдЫреЗ, рдЯреЗрдХреНрдиреЛрд▓реЛрдЬрд┐рд╕реНрдЯ, рдкреБрд░реВрд╖, рдкреБрд░реВрд╖ рдЯреЗрдХреНрдиреЛрд▓реЛрдЬрд┐рд╕реНрдЯ, рд╡рд┐рдХрд╛рд╕рдХрд░реНрддрд╛, рд╕рдлреНрдЯрд╡реЗрдпрд░
ЁЯСйтАНЁЯТ╗ => ЁЯСйтАНЁЯТ╗, рдЖрд╡рд┐рд╖реНрдХрд╛рд░рдХ, рдХреЛрдбрд░, рдЫреЛрд░реА рдорд╛рдиреНрдЫреЗ, рдЯреЗрдХреНрдиреЛрд▓реЛрдЬрд┐рд╕реНрдЯ, рдорд╣рд┐рд▓рд╛, рдорд╣рд┐рд▓рд╛ рдЯреЗрдХреНрдиреЛрд▓реЛрдЬрд┐рд╕реНрдЯ, рд╡рд┐рдХрд╛рд╕рдХрд░реНрддрд╛, рд╕рдлреНрдЯрд╡реЗрдпрд░
ЁЯСитАНЁЯОд => ЁЯСитАНЁЯОд, рдХрд▓рд╛рдХрд╛рд░, рдЧрд╛рдпрдХ, рдЫреЛрд░рд╛ рдорд╛рдиреНрдЫреЗ, рддрд╛рд░рд╛, рдкреБрд░реВрд╖, рдкреБрд░реВрд╖ рдЧрд╛рдпрдХ, рдордиреЛрд░рдЮреНрдЬрдХ, рд░рдХ
ЁЯСйтАНЁЯОд => ЁЯСйтАНЁЯОд, рдХрд▓рд╛рдХрд╛рд░, рдЧрд╛рдпрдХ, рдЫреЛрд░реА рдорд╛рдиреНрдЫреЗ, рддрд╛рд░рд╛, рдордиреЛрд░рдЮреНрдЬрдХ, рдорд╣рд┐рд▓рд╛, рдорд╣рд┐рд▓рд╛ рдЧрд╛рдпрд┐рдХрд╛, рд░рдХ
ЁЯСитАНЁЯОи => ЁЯСитАНЁЯОи, рдХрд▓рд╛рдХрд╛рд░, рдЫреЛрд░рд╛ рдорд╛рдиреНрдЫреЗ, рдкреБрд░реВрд╖, рдкреБрд░реВрд╖ рдХрд▓рд╛рдХрд╛рд░, рдкреНрдпрд╛рд▓реЗрдЯ
ЁЯСйтАНЁЯОи => ЁЯСйтАНЁЯОи, рдХрд▓рд╛рдХрд╛рд░, рдЫреЛрд░реА рдорд╛рдиреНрдЫреЗ, рдкреНрдпрд╛рд▓реЗрдЯ, рдорд╣рд┐рд▓рд╛, рдорд╣рд┐рд▓рд╛ рдХрд▓рд╛рдХрд╛рд░
ЁЯСитАНтЬИ => ЁЯСитАНтЬИ, рдЫреЛрд░рд╛ рдорд╛рдиреНрдЫреЗ, рдкрд╛рдЗрд▓рдЯ, рдкреБрд░реВрд╖, рдкреБрд░реВрд╖ рдкрд╛рдЗрд▓рдЯ, рдкреНрд▓реЗрди
ЁЯСйтАНтЬИ => ЁЯСйтАНтЬИ, рдЫреЛрд░реА рдорд╛рдиреНрдЫреЗ, рдкрд╛рдЗрд▓рдЯ, рдкреНрд▓реЗрди, рдорд╣рд┐рд▓рд╛, рдорд╣рд┐рд▓рд╛ рдкрд╛рдЗрд▓рдЯ
ЁЯСитАНЁЯЪА => ЁЯСитАНЁЯЪА, рдЕрдиреБреНрддрд░рд┐рдХреНрд╖ - рдпрд╛рддреНрд░реА, рдЕрдиреНрддрд░рд┐рдХреНрд╖, рдЫреЛрд░рд╛ рдорд╛рдиреНрдЫреЗ, рдкреБрд░реВрд╖, рдкреБрд░реВрд╖ рдЕрдиреНрддрд░рд┐рдХреНрд╖-рдпрд╛рддреНрд░реА, рд░рдХреЗрдЯ
ЁЯСйтАНЁЯЪА => ЁЯСйтАНЁЯЪА, рдЕрдиреНрддрд░рд┐рдХреНрд╖, рдЕрдиреНрддрд░рд┐рдХреНрд╖-рдпрд╛рддреНрд░реА, рдЫреЛрд░реА рдорд╛рдиреНрдЫреЗ, рдорд╣рд┐рд▓рд╛, рдорд╣рд┐рд▓рд╛ рдЕрдиреНрддрд░рд┐рдХреНрд╖-рдпрд╛рддреНрд░реА, рд░рдХреЗрдЯ
ЁЯСитАНЁЯЪТ => ЁЯСитАНЁЯЪТ, рдЖрдЧреЛ рдирд┐рдпрдиреНрддреНрд░рдХ, рдЫреЛрд░рд╛ рдорд╛рдиреНрдЫреЗ, рджрдордХрд▓, рдкреБрд░реВрд╖, рдкреБрд░реВрд╖ рдЖрдЧреЛ рдирд┐рдпрдиреНрддреНрд░рдХ
ЁЯСйтАНЁЯЪТ => ЁЯСйтАНЁЯЪТ, рдЖрдЧреЛ рдирд┐рдпрдиреНрддреНрд░рдХ, рдЫреЛрд░реА рдорд╛рдиреНрдЫреЗ, рджрдордХрд▓, рдорд╣рд┐рд▓рд╛, рдорд╣рд┐рд▓рд╛ рдЖрдЧреЛ рдирд┐рдпрдиреНрддреНрд░рдХ
ЁЯСо => ЁЯСо, рдЕрдлрд┐рд╕рд░, рдкреБрд▓рд┐рд╕, рдкреНрд░рд╣рд░реА рдЕрдзрд┐рдХреГрдд
ЁЯСотАНтЩВ => ЁЯСотАНтЩВ, рдЕрдзрд┐рдХреГрдд, рдЫреЛрд░рд╛ рдорд╛рдиреНрдЫреЗ, рдкреБрд░реВрд╖, рдкреБрд░реВрд╖ рдкреНрд░рд╣рд░реА рдЕрдзрд┐рдХреГрдд, рдкреНрд░рд╣рд░реА
ЁЯСотАНтЩА => ЁЯСотАНтЩА, рдЕрдзрд┐рдХреГрдд, рдЫреЛрд░реА рдорд╛рдиреНрдЫреЗ, рдкреНрд░рд╣рд░реА, рдорд╣рд┐рд▓рд╛, рдорд╣рд┐рд▓рд╛ рдкреБрд░реВрд╖ рдЕрдзрд┐рдХреГрдд
ЁЯХ╡ => ЁЯХ╡, рдЧреБрдкреНрддрдЪрд░, рдЬрд╛рд╕реБрд╕, рд╕реНрд▓рд┐рдЙрде
ЁЯХ╡тАНтЩВ => ЁЯХ╡тАНтЩВ, рдЧреБрдкреНрддрдЪрд░, рдЫреЛрд░рд╛ рдорд╛рдиреНрдЫреЗ, рдЬрд╛рд╕реБрд╕, рдкреБрд░реВрд╖, рдкреБрд░реВрд╖ рдЕрдиреБрд╕рдиреНрдзрд╛рдирдХрд░реНрддрд╛, рд╕реНрд▓рд┐рдЙрде
ЁЯХ╡тАНтЩА => ЁЯХ╡тАНтЩА, рдЧреБрдкреНрддрдЪрд░, рдЫреЛрд░реА рдорд╛рдиреНрдЫреЗ, рдЬрд╛рд╕реБрд╕, рдорд╣рд┐рд▓рд╛, рдорд╣рд┐рд▓рд╛ рдЕрдиреБрд╕рдиреНрдзрд╛рдирдХрд░реНрддрд╛, рд╕реНрд▓рд┐рдЙрде
ЁЯТВ => ЁЯТВ, рдвреЛрдХреЗрдкрд╛рд▓, рдкрд╣рд░реЗрджрд╛рд░
ЁЯТВтАНтЩВ => ЁЯТВтАНтЩВ, рдЧрд╛рд░реНрдб, рдЫреЛрд░рд╛ рдорд╛рдиреНрдЫреЗ, рдкреБрд░реВрд╖, рдкреБрд░реВрд╖ рдЧрд╛рд░реНрдб
ЁЯТВтАНтЩА => ЁЯТВтАНтЩА, рдЧрд╛рд░реНрдб, рдЫреЛрд░реА рдорд╛рдиреНрдЫреЗ, рдорд╣рд┐рд▓рд╛, рдорд╣рд┐рд▓рд╛ рдЧрд╛рд░реНрдб
ЁЯС╖ => ЁЯС╖, рдХрд░реНрдордЪрд╛рд░реА, рдЯреЛрдкреА, рдирд┐рд░реНрдорд╛рдг, рдирд┐рд░реНрдорд╛рдг рдХрд░реНрдордЪрд╛рд░реА
ЁЯС╖тАНтЩВ => ЁЯС╖тАНтЩВ, рдЫреЛрд░рд╛ рдорд╛рдиреНрдЫреЗ, рдирд┐рд░реНрдорд╛рдг, рдирд┐рд░реНрдорд╛рдгрдХреЛ рдкреБрд░реВрд╖ рдХрд╛рдорджрд╛рд░, рдкреБрд░реВрд╖, рдордЬрджреБрд░
ЁЯС╖тАНтЩА => ЁЯС╖тАНтЩА, рдЫреЛрд░реА рдорд╛рдиреНрдЫреЗ, рдирд┐рд░реНрдорд╛рдг, рдирд┐рд░реНрдорд╛рдгрдХреЛ рдорд╣рд┐рд▓рд╛ рдХрд╛рдорджрд╛рд░, рдордЬрджреБрд░, рдорд╣рд┐рд▓рд╛
ЁЯд┤ => ЁЯд┤, рд░рд╛рдЬрдХреБрдорд╛рд░
ЁЯС╕ => ЁЯС╕, рдЦреЗрд╕реНрд░рд╛ рдХрд▓реНрдкрдирд╛, рдкрд░реАрдХреЛ рдХрдерд╛, рд░рд╛рдЬрдХреБрдорд╛рд░реА
ЁЯС│ => ЁЯС│, рдлреЗрдЯрд╛, рдлреЗрдЯрд╛ рд▓рдЧрд╛рдПрдХреЛ рдорд╛рдиреНрдЫреЗ, рдорд╛рдиреНрдЫреЗ
ЁЯС│тАНтЩВ => ЁЯС│тАНтЩВ, тАМ рдлреЗрдЯрд╛, рдЫреЛрд░реА рдорд╛рдиреНрдЫреЗ, рдлреЗрдЯрд╛ рд▓рдЧрд╛рдПрдХреЛ рдЫреЛрд░рд╛рдорд╛рдиреНрдЫреЗ, рдорд╣рд┐рд▓рд╛
ЁЯС│тАНтЩА => ЁЯС│тАНтЩА, рдЫреЛрд░рд╛ рдорд╛рдиреНрдЫреЗ, рдкреБрд░реВрд╖, рдлреЗрдЯрд╛, рдлреЗреЗрдЯрд╛ рд▓рдЧрд╛рдПрдХреА рдЫреЛрд░реАрдорд╛рдиреНрдЫреЗ
ЁЯС▓ => ЁЯС▓, рдЪрд┐рдирд┐рдпрд╛рдБ, рдЪрд┐рдирд┐рдпрд╛рдБ рдЯреЛрдкреА рд▓рдЧрд╛рдПрдХреЛ рдорд╛рдиреНрдЫреЗ, рдЯреЛрдкреА, рдорд╛рдиреНрдЫреЗ
ЁЯзХ => ЁЯзХ, рдЯрд╛рдЙрдХреЛрдорд╛ рдЧрд▓рдмрдиреНрджреА рднрдПрдХреА рдЫреЛрд░реАрдорд╛рдиреНрдЫреЗ, рдЯрд╛рдЙрдХреЛрдорд╛ рд▓рдЧрд╛рдЗрдиреЗ рдЧрд▓рдмрдиреНрджреА, рдЯрд┐рдЪреЗрд▓, рдорд╛рдиреНрдЯрд┐рд▓рд╛, рд╣рд┐рдЬрд╛рдм
ЁЯзФ => ЁЯзФ, рджрд╛рд╣реНрд░реА, рджрд╛рд╣реНрд░реАрд╡рд╛рд▓ рдорд╛рдиреНрдЫреЗ
ЁЯС▒ => ЁЯС▒, рдХреИрд▓реЛ рдХрдкрд╛рд▓ рднрдПрдХреЛ рдорд╛рдиреНрдЫреЗ, рдлреБрд▓реЗрдХреЛ
ЁЯС▒тАНтЩВ => ЁЯС▒тАНтЩВ, рдХреИрд▓реЛ, рдХреИрд▓реЛ рдХрдкрд╛рд▓ рднрдПрдХреЛ рдЫреЛрд░рд╛рдорд╛рдиреНрдЫреЗ, рдЫреЛрд░рд╛ рдорд╛рдиреНрдЫреЗ, рдкреБрд░реВрд╖
ЁЯС▒тАНтЩА => ЁЯС▒тАНтЩА, рдХреИрд▓реЛ, рдХреИрд▓реЛ рдХрдкрд╛рд▓ рднрдПрдХреА рдЫреЛрд░реАрдорд╛рдиреНрдЫреЗ, рдЫреЛрд░рд╛ рдорд╛рдиреНрдЫреЗ, рдкреБрд░реВрд╖
ЁЯд╡ => ЁЯд╡, рдмреЗрд╣реБрд▓реЛ, рдорд╛рдиреНрдЫреЗ, рд╕реБрдЯ, рд╕реБрдЯ рдкрд╣рд┐рд░рдирдорд╛ рдорд╛рдиреНрдЫреЗ
ЁЯС░ => ЁЯС░, рдШреБрдореНрдЯреЛ, рдШреБрдореНрдЯреЛ рд╕рд╣рд┐рддрдХреА рдмреЗрд╣реБрд▓реА, рдмрд┐рд╡рд╛рд╣, рдмреЗрд╣реБрд▓реА
ЁЯд░ => ЁЯд░, рдЖрдЗрдорд╛рдИ, рдЧрд░реНрднрд╡рддреА, рдЧрд░реНрднрд╡рддреА рдЖрдЗрдорд╛рдИ
ЁЯд▒ => ЁЯд▒, рд╢рд┐рд╢реБ, рд╕реНрддрди, рд╕реНрддрдирдкрд╛рди, рд╕реНрдпрд╛рд╣рд╛рд░рд╕реБрд╕рд╛рд░
ЁЯС╝ => ЁЯС╝, рдЕрдиреБрд╣рд╛рд░, рдЦреЗрд╕реНрд░рд╛ рдХрд▓реНрдкрдирд╛, рдкрд░реА, рдкрд░реАрдХреЛ рдХрдерд╛, рдмрдЪреНрдЪрд╛, рдмрдЪреНрдЪрд╛ рдкрд░реА
ЁЯОЕ => ЁЯОЕ, рдЦреЗрд╕реНрд░рд╛ рдХрд▓реНрдкрдирд╛, рдкрд░реАрдХреЛ рдХрдерд╛, рдмреБрдмрд╛, рд╕рдорд╛рд░реЛрд╣, рд╕рд╛рдиреНрддрд╛, рд╕рд╛рдиреНрддрд╛ рдХреНрд▓рд╕
ЁЯд╢ => ЁЯд╢, рдЖрдорд╛, рдХреНрд░рд┐рд╕реНрдорд╕, рдХреНрд░рд┐рд╕реНрдорд╕рдХреЛ рдЖрдорд╛, рд╢реНрд░реАрдорддреА рдХреНрд▓рд╛рдЙрд╕
ЁЯзЩ => ЁЯзЩ, рдЬрд╛рджреБрдЧрд░, рдЯреБрдирд╛рдореБрдирд╛ рдЬрд╛рдиреНрдиреЗ рдЫреЛрд░рд╛рдорд╛рдиреНрдЫреЗ, рдЯреБрдирд╛рдореБрдирд╛ рдЬрд╛рдиреНрдиреЗ рдЫреЛрд░реАрдорд╛рдиреНрдЫреЗ, рдмреЛрдХреНрд╕рд╛, рдмреЛрдХреНрд╕реА
ЁЯзЩтАНтЩА => ЁЯзЩтАНтЩА, рдЫреЛрд░реАрдорд╛рдиреНрдЫреЗ рдЬрд╛рджреБрдЧрд░, рдЯреБрдирд╛рдореБрдирд╛ рдЬрд╛рдиреНрдиреЗ рдЫреЛрд░реАрдорд╛рдиреНрдЫреЗ, рдмреЛрдХреНрд╕реА
ЁЯзЩтАНтЩВ => ЁЯзЩтАНтЩВ, рдЫреЛрд░рд╛рдорд╛рдиреНрдЫреЗ рдЬрд╛рджреБрдЧрд░, рдЯреБрдирд╛рдореБрдирд╛ рдЬрд╛рдиреНрдиреЗ рдЫреЛрд░рд╛рдорд╛рдиреНрдЫреЗ, рдмреЛрдХреНрд╕рд╛
ЁЯзЪ => ЁЯзЪ, рдУрдмреЗрд░рди, рдЯрд┐рдЯрд╛рдирд┐рдпрд╛, рдкрдХ, рдкрд░реА
ЁЯзЪтАНтЩА => ЁЯзЪтАНтЩА, рдЫреЛрд░реАрдорд╛рдиреНрдЫреЗ рдкрд░реА, рдЯрд┐рдЯрд╛рдирд┐рдпрд╛
ЁЯзЪтАНтЩВ => ЁЯзЪтАНтЩВ, рдУрдмреЗрд░рди, рджреЗрд╡рджреВрдд, рдкрдХ
ЁЯзЫ => ЁЯзЫ, рдкрд┐рд╢рд╛рдЪ, рднреВрдд, рдореГрдд рдЖрддреНрдорд╛
ЁЯзЫтАНтЩА => ЁЯзЫтАНтЩА, рдХрд┐рдЪрдХрдиреНрдиреА, рдореГрдд рдЖрддреНрдорд╛
ЁЯзЫтАНтЩВ => ЁЯзЫтАНтЩВ, рднреВрдд, рдореБрд░реНрдХрдЯреНрдЯрд╛, рдореГрдд рдЖрддреНрдорд╛
ЁЯзЬ => ЁЯзЬ, рдЬрд▓рдкрд░реА, рдорддреНрд╕реНрдпрдЫреЛрд░рд╛рдорд╛рдиреНрдЫреЗ, рдорддреНрд╕реНрдпрдЫреЛрд░реАрдорд╛рдиреНрдЫреЗ, рдорддреНрд╕реНрдпрдорд╛рдиреНрдЫреЗ
ЁЯзЬтАНтЩА => ЁЯзЬтАНтЩА, рдЬрд▓рдкрд░реА, рдорддреНрд╕реНрдпрдЫреЛрд░реАрдорд╛рдиреНрдЫреЗ
ЁЯзЬтАНтЩВ => ЁЯзЬтАНтЩВ, рдЯреНрд░рд┐рдЯрди, рдорддреНрд╕реНрдпрдЫреЛрд░рд╛рдорд╛рдиреНрдЫреЗ
ЁЯзЭ => ЁЯзЭ, рдЬрд╛рджреБрдордп, рд╕рд╛рдиреЛ рдорд╛рдирд╡ рдЬрд╕реНрддреЛ рдЬреАрд╡
ЁЯзЭтАНтЩА => ЁЯзЭтАНтЩА, рдЬрд╛рджреБрдордп, рд╕рд╛рдиреЛ рдЫреЛрд░реАрдорд╛рдиреНрдЫреЗрдХреЛ рд╕реНрд╡рд░реБрдк рднрдПрдХреЛ рдЬреАрд╡
ЁЯзЭтАНтЩВ => ЁЯзЭтАНтЩВ, рдЬрд╛рджреБрдордп, рд╕рд╛рдиреЛ рдЫреЛрд░реЛрдорд╛рдиреНрдЫреЗрдХреЛ рд╕реНрд╡рд░реБрдк рднрдПрдХреЛ рдЬреАрд╡
ЁЯзЮ => ЁЯзЮ, рдЕрд▓реМрдВрдХрд┐рдХ рд╢рдХреНрддрд┐, рдЬрд┐рди
ЁЯзЮтАНтЩА => ЁЯзЮтАНтЩА, рдЕрд▓реМрдВрдХрд┐рдХ рд╢рдХреНрддрд┐ рднрдПрдХреА рдЫреЛрд░реАрдорд╛рдиреНрдЫреЗ, рдЬрд┐рди
ЁЯзЮтАНтЩВ => ЁЯзЮтАНтЩВ, рдЕрд▓реМрдВрдХрд┐рдХ рд╢рдХреНрддрд┐ рднрдПрдХреЛ рдЫреЛрд░рд╛рдорд╛рдиреНрдЫреЗ, рдЬрд┐рди
ЁЯзЯ => ЁЯзЯ, рдореБрд░реНрдХрдЯреНрдЯрд╛, рдореГрдд рдЖрддреНрдорд╛, рд╡реНрдпреБрдБрддреЗрдХреЛ рдореГрдд рдорд╛рдиреНрдЫреЗ
ЁЯзЯтАНтЩА => ЁЯзЯтАНтЩА, рдореБрд░реНрдХрдЯреНрдЯрд╛, рдореГрдд рдЖрддреНрдорд╛, рд╡реНрдпреБрдБрддреЗрдХреЛ рдореГрдд рдЫреЛрд░реАрдорд╛рдиреНрдЫреЗ
ЁЯзЯтАНтЩВ => ЁЯзЯтАНтЩВ, рдореБрд░реНрдХрдЯреНрдЯрд╛, рдореГрдд рдЖрддреНрдорд╛, рд╡реНрдпреБрдБрддреЗрдХреЛ рдореГрдд рдЫреЛрд░рд╛рдорд╛рдиреНрдЫреЗ
ЁЯЩН => ЁЯЩН, рднрд╛рд╡ рдкреНрд░рджрд░реНрд╢рди, рд░рд┐рд╕рд╛рдПрдХреЛ рд╡реНрдпрдХреНрддрд┐
ЁЯЩНтАНтЩВ => ЁЯЩНтАНтЩВ, рдЖрдБрдЦрд╛ рддрд░рд┐рд░рд╣реЗрдХреЛ, рдЖрдБрдЦрд╛ рддрд░рд┐рд░рд╣реЗрдХреЛ рдорд╛рдиреНрдЫреЗ, рдЗрд╕рд╛рд░рд╛, рдЫреЛрд░рд╛ рдорд╛рдиреНрдЫреЗ, рдкреБрд░реВрд╖
ЁЯЩНтАНтЩА => ЁЯЩНтАНтЩА, рдЖрдБрдБрдЦрд╛ рддрд░рд┐рд░рд╣реЗрдХреА рдорд╛рдиреНрдЫреЗ, рдЖрдБрдЦрд╛ рддрд░рд┐рд░рд╣реЗрдХреЛ, рдЗрд╕рд╛рд░рд╛, рдЫреЛрд░рд╛ рдорд╛рдиреНрдЫреЗ, рдорд╣рд┐рд▓рд╛
ЁЯЩО => ЁЯЩО, рднрд╛рд╡ рдкреНрд░рджрд░реНрд╢рди, рдореБрдЦ рдлреБрд▓рд╛рдЗрд░рд╣реЗрдХреЛ рд╡реНрдпрдХреНрддрд┐
ЁЯЩОтАНтЩВ => ЁЯЩОтАНтЩВ, рдЗрд╕рд╛рд░рд╛, рдЫреЛрд░рд╛ рдорд╛рдиреНрдЫреЗ, рдереБрддреБрдиреЛ рддреЗрд░реНрд╕рд╛рдЗрд░рд╣реЗрдХреЛ, рдереБрддреБрдиреЛ рддреЗрд░реНрд╕рд╛рдЗрд░рд╣реЗрдХреЛ рдЫреЛрд░реЛрдорд╛рдиреНрдЫреЗ, рдкреБрд░реВрд╖
ЁЯЩОтАНтЩА => ЁЯЩОтАНтЩА, рдЗрд╕рд╛рд░рд╛, рдЫреЛрд░реА рдорд╛рдиреНрдЫреЗ, рдереБрддреБрдиреЛ рддреЗрд░реНрд╕рд╛рдЗрд░рд╣реЗрдХреЛ, рдереБрддреБреБрдиреЛ рддреЗрд░реНрд╕рд╛рдЗрд░рд╣реЗрдХреА рдЫреЛрд░реАрдорд╛рдиреНрдЫреЗ, рдкреБрд░реВрд╖, рдорд╣рд┐рд▓рд╛
ЁЯЩЕ => ЁЯЩЕ, рдЕрдиреБрдорддрд┐ рдирднрдПрдХреЛ, рдЗрд╕рд╛рд░рд╛, рдареАрдХ рдирднрдПрдХреЛ рд╕рдВрдХреЗрдд рджрд┐рдиреЗ рд╡реНрдпрдХреНрддрд┐, рдирд╛рдИ, рдирд┐рд╖реЗрдз, рд╣рд╛рдд, рд╣реИрди
ЁЯЩЕтАНтЩВ => ЁЯЩЕтАНтЩВ, рдЕрдиреБрдорддрд┐ рдирднрдПрдХреЛ, рдЗрд╕рд╛рд░рд╛, рдЫреЛрд░рд╛ рдорд╛рдиреНрдЫреЗ, рдареАрдХ рдЫреИрди, рдареАрдХ рдирднрдПрдХреЛ рд╕рдВрдВрдХреЗрдд рджрд┐рдиреЗ рдЫреЛрд░рд╛рдорд╛рдиреНрдЫреЗ, рдирд╛рдИ, рдирд┐рд╖реЗреЗрдз, рдкреБрд░реВрд╖, рд╣рд╛рдд
ЁЯЩЕтАНтЩА => ЁЯЩЕтАНтЩА, рдЕрдиреБрдорддрд┐ рдирднрдПрдХреЛ, рдЗрд╕рд╛рд░рд╛, рдЫреЛрд░реА рдорд╛рдиреНрдЫреЗ, рдареАрдХ рдЫреИрди, рдареАрдХ рдирднрдПрдХреЛ рд╕рдВрдХреЗреЗрдд рджрд┐рдиреЗ рдЫреЛрд░реАрдорд╛рдиреНрдЫреЗ, рдирд╛рдИ, рдирд┐рд╖реЗрдз, рдорд╣рд┐рд▓рд╛, рд╣рд╛рдд
ЁЯЩЖ => ЁЯЩЖ, рдареАрдХ, рднрд╛рд╡ рдкреНрд░рджрд░реНрд╢рди, рднрд╛рд╡ рдкреНрд░рджрд░реНрд╢рди рдареАрдХ рдЫ, рд╣рд╛рдд
ЁЯЩЖтАНтЩВ => ЁЯЩЖтАНтЩВ, рдЗрд╕рд╛рд░рд╛, рдЫреЛрд░рд╛ рдорд╛рдиреНрдЫреЗ, рдареАрдХ рдЫ, рдареАрдХ рднрдПрдХреЛ рд╕рдВрдХреЗрдд рджрд┐рдиреЗ рдЫреЛрд░рд╛рдорд╛рдиреНрдЫреЗ, рдкреБрд░реВрд╖, рд╣рд╛рдд
ЁЯЩЖтАНтЩА => ЁЯЩЖтАНтЩА, рдЗрд╕рд╛рд░рд╛, рдЫреЛрд░реА рдорд╛рдиреНрдЫреЗ, рдареАрдХ рдЫ, рдареАрдХ рднрдПрдХреЛ рд╕рдВрдВрдХреЗрдд рджрд┐рдиреЗ рдЫреЛрд░реАрдорд╛рдиреНрдЫреЗ, рдорд╣рд┐рд▓рд╛, рд╣рд╛рдд
ЁЯТБ => ЁЯТБ, рдорджреНрджрдд рдЬрд╛рдирдХрд╛рд░реА, рд╕реВрдЪрдирд╛ рдбреЗрд╕реНрдХрдХреЛ рд╡реНрдпрдХреНрддрд┐, рд╕реЗрд╕реА, рд╣рд╛рдд
ЁЯТБтАНтЩВ => ЁЯТБтАНтЩВ, рдЫреЛрд░рд╛ рдорд╛рдиреНрдЫреЗ, рдкреБрд░реВрд╖, рд╕реВрдЪрдирд╛ рджрд┐рдиреЗ рдЫреЛрд░рд╛рдорд╛рдиреНрдЫреЗ, рд╕реВрдЪрдирд╛ рджрд┐рдиреЗ рд╣рд╛рдд, рд╕реНрдпрд╛рд╕реНрд╕реА
ЁЯТБтАНтЩА => ЁЯТБтАНтЩА, рдЫреЛрд░реА рдорд╛рдиреНрдЫреЗ, рдорд╣рд┐рд▓рд╛, рд╕реВрдЪрдирд╛ рджрд┐рдиреЗ рд╣рд╛рдд, рд╕реВреВрдЪрдирд╛ рджрд┐рдиреЗ рдЫреЛрд░реАрдорд╛рдиреНрдЫреЗ, рд╕реНрдпрд╛рд╕реНрд╕реА
ЁЯЩЛ => ЁЯЩЛ, рдЙрдард╛рдПрдХреЛ, рдЦреБрд╢реА, рднрд╛рд╡ рдкреНрд░рджрд░реНрд╢рди, рд╣рд╛рдд, рд╣рд╛рдд рдЙрдард╛рдЗрд╣реЗрдХреЛ рдЦреБрд╢реА рд╡реНрдпрдХреНрддрд┐
ЁЯЩЛтАНтЩВ => ЁЯЩЛтАНтЩВ, рдЗрд╕рд╛рд░рд╛, рдЙрдард┐рд░рд╣реЗрдХреЛ рд╣рд╛рдд, рдЫреЛрд░рд╛ рдорд╛рдиреНрдЫреЗ, рдкреБреБрд░реВрд╖, рд╣рд╛рдд рдЙрдард╛рдЗрд░рд╣реЗрдХреЛ рдЫреЛрд░рд╛рдорд╛рдиреНрдЫреЗ
ЁЯЩЛтАНтЩА => ЁЯЩЛтАНтЩА, рдЗрд╕рд╛рд░рд╛, рдЙрдард┐рд░рд╣реЗрдХреЛ рд╣рд╛рдд, рдЫреЛрд░реА рдорд╛рдиреНрдЫреЗ, рдорд╣рд┐рд▓рд╛, рд╣рд╛рдд рдЙрдард╛рдЗрд░рд╣реЗрдХреЛ рдЫреЛрд░реАрдорд╛рдиреНрдЫреЗ
ЁЯЩЗ => ЁЯЩЗ, рдХреНрд╖рдорд╛, рдЦреА, рджреБ, рдирд┐рд╣реБрд░рд┐рд░рд╣реЗрдХреЛ рд╡реНрдпрдХреНрддрд┐, рдмреЛ, рднрд╛рд╡ рдкреНрд░рджрд░реНрд╢рди
ЁЯЩЗтАНтЩВ => ЁЯЩЗтАНтЩВ, рдЖрджрд░рднрд╛рд╡рд▓реЗ рдирд┐рд╣реБрд░рд┐рд░рд╣реЗрдХреЛ рдЫреЛрд░рд╛рдорд╛рдиреНрдЫреЗ, рдЗрд╕рд╛рд░рд╛, рдЫреЛрд░рд╛ рдорд╛рдиреНрдЫреЗ, рджреБ:рдЦреА, рдирд┐рд╣реБрд░рд┐рд░рд╣реЗрдХреЛ, рдкреБрд░реВрд╖, рдорд╛рдлреА, рд╕рд╣рдпреЛрдЧ
ЁЯЩЗтАНтЩА => ЁЯЩЗтАНтЩА, рдЖрджрд░рднрд╛рд╡рд▓реЗреЗ рдирд┐рд╣реБрд░рд┐рд░рд╣реЗрдХреА рдЫреЛрд░реАрдорд╛рдиреНрдЫреЗ, рдЗрд╕рд╛рд░рд╛, рдЫреЛрд░реА рдорд╛рдиреНрдЫреЗ, рджреБ:рдЦреА, рдирд┐рд╣реБрд░рд┐рд░рд╣реЗрдХреЛ, рдорд╣рд┐рд▓рд╛, рдорд╛рдлреА, рд╕рд╣рдпреЛрдЧ
ЁЯдж => ЁЯдж, рдЕрдиреБрд╣рд╛рд░, рдЕрд╡рд┐рд╢реНрд╡рд╛рд╕, рдЙрддреНрддреЗрдЬрдирд╛, рдЪрд┐рдиреНрддрд┐рдд, рд╣рддреНрдХреЗрд▓рд╛
ЁЯджтАНтЩВ => ЁЯджтАНтЩВ, рдЕрд╡рд┐рд╢реНрд╡рд╛рд╕, рдЪрд┐рдиреНрддрд┐рдд рдЫреЛрд░рд╛рдорд╛рдиреНрдЫреЗ, рдЪрд┐рдиреНрддрд┐рдд рдореБрджреНрд░рд╛, рдЫреЛрд░реА рдорд╛рдиреНрдЫреЗ, рдорд╣рд┐рд▓рд╛, рд╕реБрд╕реНрдХреЗрд░рд╛
ЁЯджтАНтЩА => ЁЯджтАНтЩА, рдЕрд╡рд┐рд╢реНрд╡рд╛рд╕, рдЪрд┐рдиреНрддрд┐рдд рдЫреЛрд░реАрдорд╛рдиреНрдЫреЗ, рдЪрд┐рдиреНрддрд┐рдд рдореБрджреНрд░рд╛, рдЫреЛрд░рд╛ рдорд╛рдиреНрдЫреЗ, рдкреБрд░реВрд╖, рд╕реБрд╕реНрдХреЗрд░рд╛
ЁЯд╖ => ЁЯд╖, рдЕрдЬреНрдЮрд╛рдирддрд╛, рдХрд╛рдБрдз рдЙрдЪрд╛рд▓реНрдиреЗ, рд╡реЗрд╡рд╛рд╕реНрддрд╛, рд╡реЗрд╡рд╛рд╕реНрддрд╛ рдЬрдирд╛рдЙрдиреЗ, рд╢рдЩреНрдХрд╛
ЁЯд╖тАНтЩВ => ЁЯд╖тАНтЩВ, рдЙрдкреЗрдХреНрд╖рд╛, рдХреБрдо рд╣рд▓реНрд▓рд╛рдЙрдиреЗ рдХрд╛рд░реНрдп, рдЫреЛрд░рд╛ рдорд╛рдиреНрдЫреЗ, рдкреБрд░реВрд╖, рд╡реЗрд╡рд╛рд╕реНрддрд╛, рд╡реЗрд╡рд╛рд╕реНрддрд╛ рдЬрдирд╛рдЙрдиреЗ рдЫреЛрд░рд╛рдорд╛рдиреНрдЫреЗ, рд╢рдЩреНрдХрд╛
ЁЯд╖тАНтЩА => ЁЯд╖тАНтЩА, рдЙрдкреЗрдХреНрд╖рд╛, рдХреБрдо рд╣рд▓реНрд▓рд╛рдЙрдиреЗ рдХрд╛рд░реНрдп, рдЫреЛрд░рд╛ рдорд╛рдиреНрдЫреЗ, рдЫреЛрд░реА рдорд╛рдиреНрдЫреЗ, рдорд╣рд┐рд▓рд╛, рд╡реЗрд╡рд╛рд╕реНрддрд╛, рд╡реЗреЗрд╡рд╛рд╕реНрддрд╛ рдЬрдирд╛рдЙрдиреЗ рдЫреЛрд░реАрдорд╛рдиреНрдЫреЗ, рд╢рдЩреНрдХрд╛
ЁЯТЖ => ЁЯТЖ, рдЕрдиреБрд╣рд╛рд░рдХреЛ рдорд╕рд╛рдЬ, рдорд╕рд╛рдЬ, рд╕реИрд▓реБрди
ЁЯТЖтАНтЩВ => ЁЯТЖтАНтЩВ, рдЕрдиреБрд╣рд╛рд░, рдЕрдиреБрд╣рд╛рд░рдХреЛ рдорд╕рд╛рдЬ рд▓рд┐рдЗрд░рд╣реЗрдХреЛ рдЫреЛрд░рд╛рдорд╛рдиреНрдЫреЗ, рдЫреЛрд░рд╛ рдорд╛рдиреНрдЫреЗ, рдкреБрд░реВрд╖, рдорд╕рд╛рдЬ
ЁЯТЖтАНтЩА => ЁЯТЖтАНтЩА, рдЕрдиреБрд╣рд╛рд░, рдЕрдиреБрд╣рд╛рд░рдХреЛ рдорд╕рд╛рдЬ рд▓рд┐рдЗрд░рд╣реЗрдХреА рдЫреЛрд░реАрдорд╛рдиреНрдЫреЗ, рдЫреЛрд░реА рдорд╛рдиреНрдЫреЗ, рдорд╕рд╛рдЬ, рдорд╣рд┐рд▓рд╛
ЁЯТЗ => ЁЯТЗ, рдХрдкрд╛рд▓ рдХрд╛рдЯреНрдиреЗ, рдкрд╛рд░реНрд▓рд░, рд╕реБрдиреНрджрд░
ЁЯТЗтАНтЩВ => ЁЯТЗтАНтЩВ, рдХрдкрд╛рд▓ рдХрдЯрд╛рдЗ, рдХрдкрд╛рд▓ рдХрдЯрд╛рдЗрд░рд╣реЗрдХреЛ рдЫреЛрд░рд╛рдорд╛рдиреНрдЫреЗ, рдЫреЛрд░рд╛ рдорд╛рдиреНрдЫреЗ, рдкреБрд░реВрд╖
ЁЯТЗтАНтЩА => ЁЯТЗтАНтЩА, рдХрдкрд╛рд▓ рдХрдЯрд╛рдЗ, рдХрдкрд╛рд▓ рдХрдЯрд╛рдЗрд░рд╣реЗреЗрдХреА рдЫреЛрд░реАрдорд╛рдиреНрдЫреЗ, рдЫреЛрд░реА рдорд╛рдиреНрдЫреЗ, рдорд╣рд┐рд▓рд╛
ЁЯЪ╢ => ЁЯЪ╢, рдкрджрдпрд╛рддреНрд░реА, рд╣рд╛рдЗрдХ, рд╣рд┐рдБрдбрд┐рд░рд╣реЗрдХреЛ, рд╣рд┐рдбреНрдиреЗ
ЁЯЪ╢тАНтЩВ => ЁЯЪ╢тАНтЩВ, рдЫреЛрд░рд╛ рдорд╛рдиреНрдЫреЗ, рдкреБрд░реВрд╖, рдкреИрджрд▓ рдпрд╛рддреНрд░рд╛, рдкреИрджрд▓ рд╣рд┐рдбрд┐рд░рд╣реЗрдХреЛ рдЫреЛрд░рд╛рдорд╛рдиреНрдЫреЗ, рд╣рд┐рдбреНрдиреЗ рдХрд╛рд░реНрдп
ЁЯЪ╢тАНтЩА => ЁЯЪ╢тАНтЩА, рдЫреЛрд░реА рдорд╛рдиреНрдЫреЗ, рдкреИрджрд▓ рдпрд╛рддреНрд░рд╛, рдкреИрджрд▓ рд╣рд┐рдбрд┐рд░рд╣реЗреЗрдХреА рдЫреЛрд░реАрдорд╛рдиреНрдЫреЗ, рдорд╣рд┐рд▓рд╛, рд╣рд┐рдбреНрдиреЗ рдХрд╛рд░реНрдп
ЁЯПГ => ЁЯПГ, рдзрд╛рд╡рдХ, рдореНрдпрд╛рд░рд╛рдереБрди
ЁЯПГтАНтЩВ => ЁЯПГтАНтЩВ, рдЫреЛрд░рд╛ рдорд╛рдиреНрдЫреЗ, рджреМрдВрдб, рджреМрдВрдбрд┐рд░рд╣реЗрдХреЛ, рджреМрдВрдбрд┐рд░рд╣реЗрдХреЛ рдЫреЛрд░рд╛рдорд╛рдиреНрдЫреЗ, рдкреБрд░реВрд╖, рдореНрдпрд╛рд░рд╛рдерди
ЁЯПГтАНтЩА => ЁЯПГтАНтЩА, рдЫреЛрд░реА рдорд╛рдиреНрдЫреЗ, рджреМрдВрдб, рджреМрдВрдбрд┐рд░рд╣реЗрдХреЛ, рджреМрдВрдбрд┐рд░рд╣реЗреЗрдХреА рдЫреЛрд░реАрдорд╛рдиреНрдЫреЗ, рдорд╣рд┐рд▓рд╛, рдореНрдпрд╛рд░рд╛рдерди
ЁЯТГ => ЁЯТГ, рдЫреЛрд░реА рдорд╛рдиреНрдЫреЗ, рдирд╛рдЪрд┐рд░рд╣рд░рдХреЛ, рдирд╛рдЪрд┐рд░рд╣реЗрдХреА рдЫреЛрд░реАрдорд╛рдиреНрдЫреЗ
ЁЯХ║ => ЁЯХ║, рдирд╛рдЪрд┐рд░рд╣реЗрдХреЛ рдорд╛рдиреНрдЫреЗ, рдиреГрддреНрдп, рдорд╛рдиреНрдЫреЗ
ЁЯСп => ЁЯСп, рдХрд╛рди, рдХреЗрдЯреА, рдирд░реНрддрдХреА, рдкрд╛рд░реНрдЯреАрдорд╛ рд░рдорд┐рд░рд╣реЗрдХрд╛ рдорд╣рд┐рд▓рд╛, рдмрдиреА, рдорд╣рд┐рд▓рд╛
ЁЯСптАНтЩВ => ЁЯСптАНтЩВ, рдЦрд░рд╛рдпреЛрд░реВрдкреА рдХрд╛рди, рдЫреЛрд░рд╛ рдорд╛рдиреНрдЫреЗ, рдирд╛рдЪреНрдиреЗ рдорд╛рдиреНрдЫреЗ, рдкрд╛рд░реНрдЯреА, рдкрд╛рд░реНрдЯреАрдорд╛ рд░рдорд┐рд░рд╣реЗрдХрд╛ рдЫреЛрд░рд╛рдорд╛рдиреНрдЫреЗ, рдкреБрд░реВрд╖
ЁЯСптАНтЩА => ЁЯСптАНтЩА, рдЦрд░рд╛рдпреЛрд░реВрдкреА рдХрд╛рди, рдЫреЛрд░реА рдорд╛рдиреНрдЫреЗ, рдирд╛рдЪреНрдиреЗ рдорд╛рдиреНрдЫреЗ, рдкрд╛рд░реНрдЯреА, рдкрд╛рд░реНрдЯреАрдорд╛ рд░рдорд┐рд░рд╣реЗреЗрдХреА рдЫреЛрд░реАрдорд╛рдиреНрдЫреЗ, рдорд╣рд┐рд▓рд╛
ЁЯзЦ => ЁЯзЦ, рд╡рд╛рдл рдХреЛрдард╛, рд╡рд╛рдл рдХреЛрдард╛рдХреЛ рд╡реНрдпрдХреНрддрд┐, рд╡рд╛рд╕реНрдкрд╕реНрдирд╛рди
ЁЯзЦтАНтЩА => ЁЯзЦтАНтЩА, рд╡рд╛рдл рдХреЛрдард╛, рд╡рд╛рдл рдХреЛрдард╛рдХреА рдЫреЛрд░реАрдорд╛рдиреНрдЫреЗ, рд╡рд╛рд╕реНрдкрд╕реНрдирд╛рди
ЁЯзЦтАНтЩВ => ЁЯзЦтАНтЩВ, рд╡рд╛рдл рдХреЛрдард╛, рд╡рд╛рдл рдХреЛрдард╛рдХреЛ рдЫреЛрд░рд╛рдорд╛рдиреНрдЫреЗ, рд╡рд╛рд╕реНрдкрд╕реНрдирд╛рди
ЁЯзЧ => ЁЯзЧ, рдЖрд░реЛрд╣реА, рдкреБрд░реБрд╖ рдЖрд░реЛрд╣реА
ЁЯзЧтАНтЩА => ЁЯзЧтАНтЩА, рдЖрд░реЛрд╣реА, рд╕реНрддреНрд░реА рдЖрд░реЛрд╣реА
ЁЯзЧтАНтЩВ => ЁЯзЧтАНтЩВ, рдЖрд░реЛрд╣реА, рдкрд░реБрд╖ рдЖрд░реЛрд╣реА
ЁЯзШ => ЁЯзШ, рдзреНрдпрд╛рди, рдкрджреНрдорд╛рд╕рд╛рдирдорд╛ рд╡реНрдпрдХреНрддрд┐, рдпреЛрдЧрд╛
ЁЯзШтАНтЩА => ЁЯзШтАНтЩА, рдзреНрдпрд╛рди, рдкрджреНрдорд╛рд╕рд╛рдирдорд╛ рдЫреЛрд░реАрдорд╛рдиреНрдЫреЗ, рдпреЛрдЧрд╛
ЁЯзШтАНтЩВ => ЁЯзШтАНтЩВ, рдзреНрдпрд╛рди, рдкрджреНрдорд╛рд╕рд╛рдирдорд╛ рдЫреЛрд░рд╛рдорд╛рдиреНрдЫреЗ, рдпреЛрдЧрд╛
ЁЯЫА => ЁЯЫА, рдиреБрд╣рд╛рдЙрдиреЗ рд╡реНрдпрдХреНрддрд┐, рдмрд╛рде, рдмрд╛рдердЯрдм
ЁЯЫМ => ЁЯЫМ, рдЦрд╛рдЯрдорд╛ рднрдПрдХреЛ рд╡реНрдпрдХреНрддрд┐, рд╕реБрддреНрдиреЗ, рд╣реЛрдЯреЗрд▓
ЁЯХ┤ => ЁЯХ┤, рдкреБрд░реБрд╖, рд╡реНрдпрд╡рд╕рд╛рдп, рд╡реНрдпрд╡рд╕рд╛рдпрд┐рдХ рд╕реБрдЯрдорд╛ рдкреБрд░реБрд╖, рд╕реБрдЯ
ЁЯЧг => ЁЯЧг, рдЕрдиреБрд╣рд╛рд░, рдЫрд╛рдпрд╛рдБ, рдЯрд╛рдЙрдХреЛ, рдмреЛрд▓рд┐рд░рд╣реЗрдХреЛ, рдмреЛрд▓рд┐рд░рд╣реЗрдХреЛ рд╡реНрдпрдХреНрддрд┐, рдмреЛрд▓реНрдиреБ
ЁЯСд => ЁЯСд, рдЫрд╛рдпрд╛рдЪрд┐рддреНрд░, рдЫрд╛рдпрд╛рдЪрд┐рддреНрд░рдорд╛ рдмрд╕реНрдЯ, рдмрд╕реНрдЯ
ЁЯСе => ЁЯСе, рдЫрд╛рдпрд╛рдЪрд┐рддреНрд░, рдЫрд╛рдпрд╛рдЪрд┐рддреНрд░рдорд╛ рдмрд╕реНрдЯрд╣рд░реВ, рдмрд╕реНрдЯ
ЁЯд║ => ЁЯд║, рдЦреЗрд▓, рддрд░рд╡рд╛рд░, рдлреЗрдиреНрд╕рд░, рдлреЗрдиреНрд╕рд┐рдЩ, рд╡реНрдпрдХреНрддрд┐
ЁЯПЗ => ЁЯПЗ, рдШреЛрдбрд╛, рдШреЛрдбрд╛ рджреМрдб, рдШреЛрдбрд╛рд╕рд╡рд╛рд░, рджреМрдбрд┐рдиреЗ, рджреМрдбрд┐рдиреЗрдШреЛрдбрд╛
тЫ╖ => тЫ╖, рд╕реНрдХреА, рд╕реНрдХреА рдЦреЗрд▓рд╛рдбреА, рд╣рд┐рдЙрдБ
ЁЯПВ => ЁЯПВ, рд╕реНрдХреА, рд╕реНрдиреЛрдмреЛрд░реНрдбрд░, рд╣рд┐рдЙрдБ
ЁЯПМ => ЁЯПМ, рдЧреЛрд▓реНрдл, рдЧреЛрд▓реНрдлрд░, рдмрд▓
ЁЯПМтАНтЩВ => ЁЯПМтАНтЩВ, рдЧреЛрд▓реНрдл, рдЧреЛрд▓реНрдл рдЦреЗрд▓реНрджреИ рдЧрд░реЗрдХреЛ рдЫреЛрд░рд╛рдорд╛рдиреНрдЫреЗ, рдЫреЛрд░рд╛ рдорд╛рдиреНрдЫреЗ, рдкреБрд░реВрд╖
ЁЯПМтАНтЩА => ЁЯПМтАНтЩА, рдЧрд╛реЛрд▓реНрдл, рдЧреЛрд▓реНрдл рдЦреЗреЗрд▓реНрджреИ рдЧрд░реЗрдХреА рдЫреЛрд░реАрдорд╛рдиреНрдЫреЗ, рдЫреЛрд░реА рдорд╛рдиреНрдЫреЗ, рдорд╣рд┐рд▓рд╛
ЁЯПД => ЁЯПД, рд╕рд░реНрдлрд░, рд╕рд░реНрдлрд┐рдЩреН
ЁЯПДтАНтЩВ => ЁЯПДтАНтЩВ, рдЫреЛрд░рд╛ рдорд╛рдиреНрдЫреЗ, рдкреБрд░реВрд╖, рд╕рд░реНрдл рдЧрд░рд┐рд░рд╣реЗрдХреЛ рдЫреЛрд░рд╛рдорд╛рдиреНрдЫреЗ, рд╕рд░реНрдлрд┐рдЩ
ЁЯПДтАНтЩА => ЁЯПДтАНтЩА, рдЫреЛрд░реА рдорд╛рдиреНрдЫреЗ, рдорд╣рд┐рд▓рд╛, рд╕рд░реНрдл рдЧрд░рд┐рд░рд╣реЗреЗрдХреА рдЫреЛрд░реАрдорд╛рдиреНрдЫреЗ, рд╕рд░реНрдлрд┐рдЩ
ЁЯЪг => ЁЯЪг, рдЧрд╛рдбреА, рдбреБрдЩреНрдЧрд╛, рд░реЛрдмреЛрдЯ
ЁЯЪгтАНтЩВ => ЁЯЪгтАНтЩВ, рдЦрд┐рдпрд╛рдЙрдиреЗ рдбреБрдЩреНрдЧрд╛, рдЫреЛрд░рд╛ рдорд╛рдиреНрдЫреЗ, рдбреБрдЩреНрдЧрд╛, рдбреБрдЩреНрдЧрд╛ рдЪрд▓рд╛рдЗрд░рд╣реЗрдХреЛ рдЫреЛрд░рд╛рдорд╛рдиреНрдЫреЗ, рдкреБрд░реВрд╖
ЁЯЪгтАНтЩА => ЁЯЪгтАНтЩА, рдЦрд┐рдпрд╛рдЙрдиреЗ рдбреБрдЩреНрдЧрд╛, рдЫреЛрд░реА рдорд╛рдиреНрдЫреЗ, рдбреБрдЩреНрдЧрд╛ рдЪрд▓рд╛рдЗрд░рд╣реЗреЗрдХреА рдЫреЛрд░реАрдорд╛рдиреНрдЫреЗ, рдбреБреБрдЩреНрдЧрд╛, рдорд╣рд┐рд▓рд╛
ЁЯПК => ЁЯПК, рдкреЛрдВрдбрд┐рд╡рд╛рдЬ, рдкреМрдбреА
ЁЯПКтАНтЩВ => ЁЯПКтАНтЩВ, рдЫреЛрд░рд╛ рдорд╛рдиреНрдЫреЗ, рдкреБрд░реВрд╖, рдкреМрдВрдбреА, рдкреМрдВрдбреА рдЦреЗрд▓рд┐рд░рд╣реЗрдХреЛ рдЫреЛрд░рд╛рдорд╛рдиреНрдЫреЗ
ЁЯПКтАНтЩА => ЁЯПКтАНтЩА, рдЫреЛрд░реА рдорд╛рдиреНрдЫреЗ, рдкреМрдВрдбреА, рдкреМрдВрдВрдбреА рдЦреЗрд▓рд┐рд░рд╣реЗрдХреА рдЫреЛрд░реАрдорд╛рдиреНрдЫреЗ, рдорд╣рд┐рд▓рд╛
тЫ╣ => тЫ╣, рдмрд▓, рдмрд▓ рдЦреЗрд▓реНрджреИ рдЧрд░реЗрдХреЛ рд╡реНрдпрдХреНрддрд┐
тЫ╣тАНтЩВ => тЫ╣тАНтЩВ, рдЫреЛрд░рд╛ рдорд╛рдиреНрдЫреЗ, рдкреБрд░реВрд╖, рдмрд▓, рдмрд▓ рдЦреЗрд▓реНрджреИ рдЧрд░реЗрдХреЛ рдЫреЛрд░рд╛рдорд╛рдиреНрдЫреЗ
тЫ╣тАНтЩА => тЫ╣тАНтЩА, рдЫреЛрд░реА рдорд╛рдиреНрдЫреЗ, рдмрд▓, рдмрд▓ рдЦреЗреЗрд▓реНрджреИ рдЧрд░реЗрдХреА рдЫреЛрд░реАрдорд╛рдиреНрдЫреЗ, рдорд╣рд┐рд▓рд╛
ЁЯПЛ => ЁЯПЛ, рддреМрд▓, рдлрд┐рд▓реНрдЯрд░, рднрд╛рд░ рддреМрдВрд▓ рдЦреЗрд▓рд╛рдбреА
ЁЯПЛтАНтЩВ => ЁЯПЛтАНтЩВ, рдЫреЛрд░рд╛ рдорд╛рдиреНрдЫреЗ, рддреМрдВрд▓ рдЙрдард╛рдЙрдиреЗ рдорд╛рдиреНрдЫреЗ, рдкреБрд░реВрд╖, рднрд╛рд░ рддреМрд▓рдорд╛ рд╕рдВрд▓рдЧреНрди рдЫреЛрд░рд╛рдорд╛рдиреНрдЫреЗ
ЁЯПЛтАНтЩА => ЁЯПЛтАНтЩА, рддреМрдВрд▓ рдЙрдард╛рдЙрдиреЗ рдорд╛рдиреНрдЫреЗ, рднрд╛рд░ рддреМрд▓рдорд╛ рд╕рдВрд▓рдЧреНрди рдЫреЛрд░реАрдорд╛рдиреНрдЫреЗ, рдорд╣рд┐рд▓рд╛
ЁЯЪ┤ => ЁЯЪ┤, рдмрд╛рдЗрдХ, рд╕рд╛рдЗрдХрд▓, рд╕рд╛рдЗрдХрд▓ рдЪрд▓рд╛рдЙрдиреЗ, рд╕рд╛рдЗрдХрд▓ рдЪрд▓рд╛рдЙрдиреЗ рд╡реНрдпрдХреНрддрд┐
ЁЯЪ┤тАНтЩВ => ЁЯЪ┤тАНтЩВ, рдЫреЛрд░рд╛ рдорд╛рдиреНрдЫреЗ, рдмрд╛рдЗрдХ рдЪрд▓рд╛рдЙрдиреЗ рдХрд╛рд░реНрдп, рд╕рд╛рдЗрдХрд▓, рд╕рд╛рдЗрдХрд▓ рдЪрд▓рд╛рдЗрд░рд╣реЗрдХреЛ рдЫреЛрд░рд╛рдорд╛рдиреНрдЫреЗ, рд╕рд╛рдЗрдХрд▓ рдЪрд▓рд╛рдЙрдиреЗ рдорд╛рдиреНрдЫреЗ
ЁЯЪ┤тАНтЩА => ЁЯЪ┤тАНтЩА, рдЫреЛрд░реА рдорд╛рдиреНрдЫреЗ, рдмрд╛рдЗрдХ рдЪрд▓рд╛рдЙрдиреЗ рдХрд╛рд░реНрдп, рдорд╣рд┐рд▓рд╛, рд╕рд╛рдЗрдХрд▓, рд╕рд╛рдЗрдХрд▓ рдЪрд▓рд╛рдЗрд░рд╣реЗреЗрдХреА рдЫреЛрд░реАрдорд╛рдиреНрдЫреЗ, рд╕рд╛рдЗрдХрд▓ рдЪрд▓рд╛рдЙрдиреЗ рдорд╛рдиреНрдЫреЗ
ЁЯЪ╡ => ЁЯЪ╡, рдмрд╛рдЗрдХ, рдорд╛рдЙрдиреНрдЯреЗрди, рдорд╛рдЙрдиреНрдЯреЗрди рдмрд╛рдЗрдХрд░, рд╕рд╛рдЗрдХрд▓, рд╕рд╛рдЗрдХрд▓ рдЪрд▓рд╛рдЙрдиреЗ
ЁЯЪ╡тАНтЩВ => ЁЯЪ╡тАНтЩВ, рдЫреЛрд░рд╛ рдорд╛рдиреНрдЫреЗ, рдкреБрд░реВрд╖, рдмрд╛рдЗрдХ, рдорд╛рдЙрдиреНрдЯреЗрди рдмрд╛рдЗрдХ рдЪрд▓рд╛рдЗрд░рд╣реЗрдХреЛ рдЫреЛрд░рд╛рдорд╛рдиреНрдЫреЗ, рд╕рд╛рдЗрдХрд▓, рд╕рд╛рдЗрдХрд▓ рдЪрд▓рд╛рдЙрдиреЗ рдорд╛рдиреНрдЫреЗ, рд╣рд┐рдорд╛рд▓
ЁЯЪ╡тАНтЩА => ЁЯЪ╡тАНтЩА, рдЫреЛрд░реА рдорд╛рдиреНрдЫреЗ, рдмрд╛рдЗрдХ, рдмрд╛рдЗрдХ рдЪрд▓рд╛рдЙрдиреЗ рдХрд╛рд░реНрдп, рдорд╣рд┐рд▓рд╛, рдорд╛рдЙрдиреНрдЯреЗрди рдмрд╛рдЗрдХ рдЪрд▓рд╛рдЗрд░рд╣реЗреЗрдХреА рдЫреЛрд░реАрдорд╛рдиреНрдЫреЗ, рд╕рд╛рдЗрдХрд▓, рд╕рд╛рдЗрдХрд▓ рдЪрд▓рд╛рдЙрдиреЗ рдорд╛рдиреНрдЫреЗ, рд╣рд┐рдорд╛рд▓
ЁЯПО => ЁЯПО, рдХрд╛рд░, рджреМрдВрдб, рджреМрдВрдбрд╡рд╛рд▓рд╛ рдХрд╛рд░
ЁЯПН => ЁЯПН, рджреМрдВрдб, рдореЛрдЯрд░рд╕рд╛рдЗрдХрд▓
ЁЯд╕ => ЁЯд╕, рдХрд╛рд░реНрдЯрд╣реНрд╡рд┐рд▓, рдЦреЗрд▓, рдЬрд┐рдордиреНрдпрд╛рд╕реНрдЯрд┐рдХреНрд╕, рд╡реНрдпрдХреНрддрд┐
ЁЯд╕тАНтЩВ => ЁЯд╕тАНтЩВ, рдХрд╛рд░реНрдЯрд╣реНрд╡рд┐рд▓, рдХрд╛рд░реНрдЯрд╣реНрд╡рд┐рд▓ рдЧрд░рд┐рд░рд╣реЗрдХреЛ рдЫреЛрд░рд╛рдорд╛рдиреНрдЫреЗ, рдЦреЗрд▓, рдЫреЛрд░рд╛ рдорд╛рдиреНрдЫреЗ, рдЬрд┐рдореНрдиреНрдпрд╛рд╕реНрдЯрд┐рдХреНрд╕, рдкреБрд░реВрд╖, рд╡реНрдпрдХреНрддрд┐
ЁЯд╕тАНтЩА => ЁЯд╕тАНтЩА, рдХрд╛рд░реНрдЯрд╣реНрд╡рд┐рд▓, рдХрд╛рд░реНрдЯрд╣реНрд╡рд┐рд▓ рдЧрд░рд┐рд░рд╣реЗрдХреЛ рдЫреЛрд░реАрдорд╛рдиреНрдЫреЗ, рдЦреЗрд▓, рдЫреЛрд░реА рдорд╛рдиреНрдЫреЗ, рдЬрд┐рдореНрдиреНрдпрд╛рд╕реНрдЯрд┐рдХреНрд╕, рдорд╣рд┐рд▓рд╛, рд╡реНрдпрдХреНрддрд┐
ЁЯд╝ => ЁЯд╝, рдХреБрд╕реНрддрд┐рд╡рд╛рдЬ, рдХреБрд╕реНрддреА рдЦреЗрд▓реНрдиреБ, рдЦреЗрд▓, рд╡реНрдпрдХреНрддрд┐
ЁЯд╝тАНтЩВ => ЁЯд╝тАНтЩВ, рдХреБрд╕реНрддреА, рдХреБрд╕реНрддреА рдЦреЗрд▓рд┐рд░рд╣реЗрдХрд╛ рдЫреЛрд░рд╛рдорд╛рдиреНрдЫреЗрд╣рд░реВ, рдЦреЗрд▓, рдЫреЛрд░рд╛ рдорд╛рдиреНрдЫреЗрд╣рд░реВ, рдкреБрд░реВрд╖, рд╡реНрдпрдХреНрддрд┐
ЁЯд╝тАНтЩА => ЁЯд╝тАНтЩА, рдХреБрд╕реНрддреА, рдХреБрд╕реНрддреА рдЦреЗреЗрд▓рд┐рд░рд╣реЗрдХрд╛ рдЫреЛрд░реАрдорд╛рдиреНрдЫреЗрд╣рд░реВ, рдЦреЗрд▓, рдЫреЛрд░реА рдорд╛рдиреНрдЫреЗрд╣рд░реВ, рдорд╣рд┐рд▓рд╛, рд╡реНрдпрдХреНрддрд┐
ЁЯд╜ => ЁЯд╜, рдЦреЗрд▓, рдкрд╛рдиреА, рдкреЛрд▓реЛ, рд╡рд╛рдЯрд░ рдкреЛрд▓реЛ, рд╡реНрдпрдХреНрддрд┐
ЁЯд╜тАНтЩВ => ЁЯд╜тАНтЩВ, рдЦреЗрд▓, рдЫреЛрд░рд╛ рдорд╛рдиреНрдЫреЗ, рдкреБрд░реВрд╖, рд╡рд╛рдЯрд░ рдкреЛрд▓реЛ, рд╡рд╛рдЯрд░ рдкреЛрд▓реЛ рдЦреЗрд▓рд┐рд░рд╣реЗрдХреЛ рдЫреЛрд░рд╛рдорд╛рдиреНрдЫреЗ
ЁЯд╜тАНтЩА => ЁЯд╜тАНтЩА, рдЦреЗрд▓, рдЫреЛрд░реА рдорд╛рдиреНрдЫреЗ, рдорд╣рд┐рд▓рд╛, рд╡рд╛рдЯрд░ рдкреЛрд▓реЛ, рд╡рд╛рдЯрд░ рдкреЛрд▓реЛ рдЦреЗреЗрд▓рд┐рд░рд╣реЗрдХреЛ рдЫреЛрд░реАрдорд╛рдиреНрдЫреЗ
ЁЯд╛ => ЁЯд╛, рдЦреЗрд▓, рдмрд▓, рд╡реНрдпрдХреНрддрд┐, рд╣реНрдпрд╛рдиреНрдбрдмрд▓
ЁЯд╛тАНтЩВ => ЁЯд╛тАНтЩВ, рдЦреЗрд▓, рдЫреЛрд░рд╛ рдорд╛рдиреНрдЫреЗ, рдкреБрд░реВрд╖, рд╣реНрдпрдиреНрдбрдмрд▓ рдЦреЗрд▓рд┐рд░рд╣реЗрдХреЛ рдЫреЛрд░рд╛рдорд╛рдиреНрдЫреЗ, рд╣реНрдпрд╛рдиреНрдбрдмрд▓
ЁЯд╛тАНтЩА => ЁЯд╛тАНтЩА, рдЦреЗрд▓, рдЫреЛрд░реА рдорд╛рдиреНрдЫреЗ, рдорд╣рд┐рд▓рд╛, рд╣реНрдпрдиреНрдбрдмрд▓, рд╣реНрдпрдиреНрдбрдмрд▓ рдЦреЗреЗрд▓рд┐рд░рд╣реЗрдХреА рдЫреЛрд░реАрдорд╛рдиреНрдЫреЗ
ЁЯд╣ => ЁЯд╣, рдЬрдЧрд▓ рдЧрд░реНрдиреБ, рдЬрдЧреНрд▓рд┐рдЩ, рдмрд╣реБрдХрд╛рд░реНрдп, рд╕рдиреНрддреБрд▓рди, рд╕реАрдк
ЁЯд╣тАНтЩВ => ЁЯд╣тАНтЩВ, рдЫреЛрд░рд╛ рдорд╛рдиреНрдЫреЗ, рдЬрдЧреНрд▓рд┐рдЩ, рдЬрдЧреНрд▓рд┐рдЩ рдЧрд░рд┐рд░рд╣реЗрдХреЛ рдЫреЛрд░рд╛рдорд╛рдиреНрдЫреЗ, рдкреБрд░реВрд╖, рдмрд╣реБ рдХрд╛рд░реНрдп
ЁЯд╣тАНтЩА => ЁЯд╣тАНтЩА, рдЫреЛрд░реА рдорд╛рдиреНрдЫреЗ, рдЬрдЧреНрд▓рд┐рдЩ, рдЬрдЧреНрд▓рд┐рдЩ рдЧрд░рд┐рд░рд╣реЗрдХреЛ рдЫреЛрд░реАрдорд╛рдиреНрдЫреЗ, рдмрд╣реБ рдХрд╛рд░реНрдп, рдорд╣рд┐рд▓рд╛
ЁЯСл => ЁЯСл, рдЬреЛрдбреА, рдкреБрд░реБрд╖, рдорд╣рд┐рд▓рд╛, рд╕рдорд╛рддреЗрдХреЛ, рд╣рд╛рдд, рд╣рд╛рдд рд╕рдорд╛рддрд┐рд░рд╣реЗрдХрд╛ рдкреБрд░реБрд╖ рд░ рдорд╣рд┐рд▓рд╛
ЁЯСм => ЁЯСм, рдЬреЛрдбреА, рдкреБрд░реБрд╖, рдорд┐рдереБрди, рд░рд╛рд╢рд┐, рд╕рдорд╛рддреЗрдХреЛ, рд╣рд╛рдд, рд╣рд╛рдд рд╕рдорд╛рддрд┐рд░рд╣реЗрдХрд╛ рджреБрдИ рдкреБрд░реБрд╖
ЁЯСн => ЁЯСн, рдЬреЛрдбреА, рдорд╣рд┐рд▓рд╛, рд╕рдорд╛рддреЗрдХреЛ, рд╣рд╛рдд, рд╣рд╛рдд рд╕рдорд╛рддрд┐рд░рд╣реЗрдХрд╛ рджреБрдИ рдорд╣рд┐рд▓рд╛
ЁЯТП => ЁЯТП, рдЪреБрдореНрдмрди, рдЬреЛрдбреА, рдордиреЛрд░рдиреНрдЬрди
ЁЯТС => ЁЯТС, рдЬреЛрдбреА, рдордиреЛрд░рдиреНрдЬрди, рдорд╛рдпрд╛, рдореБрдЯреБ, рдореБрдЯреБ рд╕рд╣рд┐рддрдХреЛ рдЬреЛрдбреА
ЁЯСк => ЁЯСк, рдЖрдорд╛, рдкрд░рд┐рд╡рд╛рд░, рдмрдЪреНрдЪрд╛, рдмреБрдмрд╛
ЁЯд│ => ЁЯд│, рдХреНрдпрд╛рдореЗрд░рд╛, рдлреЛрди, рд╕реЗрд▓реНрдлреА
ЁЯТк => ЁЯТк, рдлреБрд▓рд╛рдПрдХреЛ рдмрд╛рдЗрд╕реЗрдкреНрд╕, рдлреНрд▓реЗрдХреНрд╕, рдмрд╛рдЗрд╕реЗрдкреНрд╕, рдорд╛рдВрд╢рдкреЗрд╢реА, рд╢рд░реАрд░, рд╣рдБрд╕рд╛рдЙрдиреЗ
ЁЯСИ => ЁЯСИ, рдкрдЫрд╛рдбрд┐рдХреЛ рд╣рд╛рдд, рдмрд╛рдпрд╛рдБ рддрд┐рд░ рджреЗрдЦрд╛рдЗрд░рд╣реЗрдХреЛ рдЙрд▓реНрдЯреЛ рд╣рд╛рддрдХреЛ рдЪреЛрд░ рдФрдВрд▓рд╛, рд╢рд░реАрд░ рдФрдВрд▓рд╛, рд╕рдВрдХреЗрдд, рд╕реВрдЪрдХ, рд╣рд╛рдд
ЁЯСЙ => ЁЯСЙ, рдФрдВрд▓рд╛, рджрд╛рдпрд╛рдБ рддрд┐рд░ рджреЗрдЦрд╛рдЗрд░рд╣реЗрдХреЛ рдЙрд▓реНрдЯреЛ рд╣рд╛рддрдХреЛ рдЫреЛрд░ рдФрдВрд▓рд╛, рдкрдЫрд╛рдбрд┐рдХреЛ рд╣рд╛рдд, рд╢рд░реАрд░, рд╕рдВрдХреЗрдд, рд╕реВрдЪрдХ, рд╣рд╛рдд
тШЭ => тШЭ, рдФрдВрд▓рд╛, рдорд╛рдерд┐, рдорд╛рдерд┐ рддрд┐рд░ рджреЗрдЦрд╛рдЗрд░рд╣реЗрдХреЛ рдЪреЛрд░ рдФрдВрд▓рд╛, рд╢рд░реАрд░, рд╕рдВрдХреЗрдд, рд╕реВрдЪрдХ, рд╣рд╛рдд
ЁЯСЖ => ЁЯСЖ, рдФрдВрд▓рд╛, рдкрдЫрд╛рдбрд┐рдХреЛ рд╣рд╛рдд, рдорд╛рдерд┐, рдорд╛рдерд┐ рддрд┐рд░ рджреЗрдЦрд╛рдЗрд░рд╣реЗрдХреЛ рдЙрд▓реНрдЯреЛ рд╣рд╛рддрдХреЛ рдЪреЛрд░ рдФрдВрд▓рд╛, рд╢рд░реАрд░, рд╕рдВрдХреЗрдд, рд╕реВрдЪрдХ, рд╣рд╛рдд
ЁЯЦХ => ЁЯЦХ, рдФрдВрд▓рд╛, рдмреАрдЪрдХреЛ рдФрдВрд▓рд╛, рд╢рд░реАрд░, рд╣рд╛рдд
ЁЯСЗ => ЁЯСЗ, рдФрдВрд▓рд╛, рддрд▓, рддрд▓ рддрд┐рд░ рджреЗрдЦрд╛рдЗрд░рд╣реЗрдХреЛ рдЙрд▓реНрдЯреЛ рд╣рд╛рддрдХреЛ рдЪреЛрд░ рдФрдВрд▓рд╛, рдкрдЫрд╛рдбрд┐рдХреЛ рд╣рд╛рдд, рд╢рд░реАрд░, рд╕рдВрдХреЗрдд, рд╕реВрдЪрдХ, рд╣рд╛рдд
тЬМ => тЬМ, рдЬрд┐рддрдХреЛ рдЬрдирд╛рдЙрдиреЗ рдФрдВрд▓рд╛, рднреА, рд╡рд┐рдЬрдпреА, рд╢рд░реАрд░, рд╣рд╛рдд
ЁЯдЮ => ЁЯдЮ, рдФрдВрд▓рд╛, рдХрд╛рдЯреНрдиреБ, рдкреНрд░рд╛рд░реНрдердирд╛ рдЧрд░рд┐рд░рд╣реЗрдХреЛ рдореБрджреНрд░рд╛, рднрд╛рдЧреНрдп, рд╣рд╛рдд
ЁЯЦЦ => ЁЯЦЦ, рдФрдВрд▓рд╛, рдмрд▓реНрдХрди, рдмрд▓реНрдХрди рд╕рд▓рд╛рдореА, рд╢рд░реАрд░, рд╕рд▓рд╛рдореА, рд╣рд╛рдд
ЁЯдШ => ЁЯдШ, рдФрдВрд▓рд╛, рд░рдХ-рдЕрди, рд╢рд░реАрд░, рд╕рд┐рдВрдЩрдХреЛ рдЪрд┐рдиреНрд╣, рд╕рд┐рдЩреН, рд╣рд╛рдд
ЁЯдЩ => ЁЯдЩ, рдлреЛрди рдЧрд░реНрдиреБ, рдорд▓рд╛рдИ рдлреЛрди рдЧрд░реНрдиреБ рднрдиреНрдиреЗ рд╕рдЩреНрдХреЗрдд, рд╣рд╛рдд
ЁЯЦР => ЁЯЦР, рдФрдВрд▓рд╛, рдлреИрд▓рд╛рдПрдХреЛ, рдлреИрд▓рд╛рдПрдХреЛ рдФрдВрд▓рд╛рд╣рд░реВ рд╕рд╣рд┐рдд рдЙрдард╛рдЗрдПрдХрд╛ рд╣рд╛рдд, рд╢рд░реАрд░, рд╣рд╛рдд
тЬЛ => тЬЛ, рдЙрдард╛рдЗрдПрдХреЛ рд╣рд╛рдд, рд╢рд░реАрд░, рд╣рд╛рдд
ЁЯСМ => ЁЯСМ, рдареАрдХ, рдареАрдХ рдЫ рдЬрдирд╛рдЙрдиреЗ рдФрдВрд▓рд╛, рд╢рд░реАрд░, рд╣рд╛рдд
ЁЯСН => ЁЯСН, тАМ+1, рдЧрдЬрдм, рдмреВрдвреА рдФрдВрд▓рд╛, рдорд╛рдерд┐, рд╢рд░реАрд░, рд╣рд╛рдд
ЁЯСО => ЁЯСО, рдЧрд╛рд▓реА, рддрд▓, рдмреБрдвреА рдФрдВрд▓рд╛, рд╢рд░реАрд░, рд╣рд╛рдд
тЬК => тЬК, рдЙрдард╛рдЗрдПрдХреЛ рдореБрдареНрдареА, рдХреНрд▓реЗрдиреНрдЪ рдЧрд░рд┐рдПрдХреЛ, рдореБрдХреНрдХрд╛, рдореБрдареНрдареА, рд╢рд░реАрд░, рд╣рд╛рдд
ЁЯСК => ЁЯСК, рдХреНрд▓реЗрдиреНрдЪ рдЧрд░рд┐рдПрдХреЛ, рдмрдиреНрдиреЗ рдореБрдареНрдареА, рдореБрдХреНрдХрд╛, рдореБрдареНрдареА, рд╢рд░реАрд░, рд╣рд╛рдд
ЁЯдЫ => ЁЯдЫ, рдмрд╛рдпрд╛рдБ рдлрд░реНрдХреЗрдХреЛ рдореБрдбреНрдХреА, рдмрд╛рдпрд╛рдБрддрд░реНрдл, рдореБрдбреНрдХреА
ЁЯдЬ => ЁЯдЬ, рджрд╛рдпрд╛рдБ рдлрд░реНрдХреЗрдХреЛ рдореБрдбреНрдХреА, рджрд╛рдпрд╛рдБрддрд░реНрдл, рдореБреБрдбреНрдХреА
ЁЯдЪ => ЁЯдЪ, рдЙрдареЗрдХреЛ, рдкрдЫрд╛рдбрд┐рдмрд╛рдЯ рдЙрдареЗрдХреЛ рд╣рд╛рдд, рд╣рд╛рддрдХреЛ рдкрдЫрд╛рдбрд┐ рдкрд╛рдЯреЛ
ЁЯСЛ => ЁЯСЛ, рд╢рд░реАрд░, рд╣рд▓реНрд▓рд╛рдЗрд░рд╣реЗрдХреЛ, рд╣рд▓реНрд▓рд╛рдЗрд░рд╣реЗрдХреЛ рд╣рд╛рдд, рд╣рд▓реНрд▓реЗрдХреЛ, рд╣рд╛рдд
ЁЯдЯ => ЁЯдЯ, ILY, рдкреНрд░реЗрдордкреВрд░реНрдг рднрд╛рд╡, рд╣рд╛рдд
тЬН => тЬН, рд▓реЗрдЦрд┐рд░рд╣реЗрдХреЛ рд╣рд╛рдд, рд▓реЗрдЦреНрдиреЗ, рд╢рд░реАрд░, рд╣рд╛рдд
ЁЯСП => ЁЯСП, рддрд╛рд▓реА, рддрд╛рд▓реА рдмрдЬрд┐рд░рд╣реЗрдХрд╛ рд╣рд╛рддрд╣рд░реВ, рд╢рд░реАрд░, рд╣рд╛рдд
ЁЯСР => ЁЯСР, рдЦреБрд▓рд╛, рдЦреБрд▓рд╛ рд╣рд╛рддрд╣рд░реВ, рд╢рд░реАрд░, рд╣рд╛рдд
ЁЯЩМ => ЁЯЩМ, рдЙрдард╛рдПрдХреЛ, рднрд╛рд╡ рдкреНрд░рджрд░реНрд╢рди, рд╢рд░реАрд░, рд╕рдорд╛рд░реЛрд╣, рд╣рд╛рдд, рд╣рд╛рдд рдЙрдард╛рдЗрд░рд╣реЗрдХреЛ рд╡реНрдпрдХреНрддрд┐, рд╣реБрд░реНрд░реЗ
ЁЯд▓ => ЁЯд▓, рдкреНрд░рд╛рд░реНрдердирд╛, рдорд╛рдерд┐ рдЬреЛрдбрд┐рдПрдХреЛ рдЬреЛрд░ рд╣рд╛рдд
ЁЯЩП => ЁЯЩП, рдХреГрдкрдпрд╛, рдЬреЛрдбреЗрдХреЛ рд╣рд╛рддрд╣рд░реВ, рджреЛрдмреНрд░реЗрдХреЛ, рдзрдиреНрдпрд╡рд╛рдж, рдкреНрд░рд╛рдердирд╛, рдмреЛ, рднрд╛рд╡ рдкреНрд░рджрд░реНрд╢рди, рд╢рд░реАрд░, рд╕реЛрдзреНрди, рд╣рд╛рдд
ЁЯдЭ => ЁЯдЭ, рдмреИрдардХ, рд╕рдореНрдЭреМрдВрддрд╛, рд╣рд▓реНрд▓рд╛рдЙрдиреЗ, рд╣рд╕реНрддрдорд┐рд▓рди, рд╣рд╛рдд
ЁЯТЕ => ЁЯТЕ, рдирдЩ рдкрд╛рд▓рд┐рд╕, рдирдЩреН, рдкрд╛рд▓рд┐рд╕, рдореНрдпрд╛рдирд┐рдХреНрдпреБрд░, рд╢рд░реАрд░, рд╢реНрд░реГрдЩреНрдЧрд╛рд░, рд╣реЗрд░рдЪрд╛рд╣
ЁЯСВ => ЁЯСВ, рдХрд╛рди, рд╢рд░реАрд░
ЁЯСГ => ЁЯСГ, рдирд╛рдХ, рд╢рд░реАрд░
ЁЯСг => ЁЯСг, рдХрдкрдбрд╛, рдЦреБрдЯреНрдЯрд╛рдХреЛ рдбреЛрдм, рдбреЛрдм, рд╢рд░реАрд░
ЁЯСА => ЁЯСА, рдЕрдиреБрд╣рд╛рд░, рдЖрдБрдЦрд╛, рдЖрдБрдЦрд╛рд╣рд░реВ, рд╢рд░реАрд░
ЁЯСБ => ЁЯСБ, рдЖрдБрдЦрд╛, рд╢рд░реАрд░
ЁЯСБтАНЁЯЧи => ЁЯСБтАНЁЯЧи, рдЖрдБрдЦрд╛, рдЖрдБрдЦрд╛рдорд╛ рд╡рд╛рдХреНрдп рдмрдмрд▓, рд╡рд╛рдХреНрдп рдмрдмрд▓, рд╕рд╛рдХреНрд╖реА
ЁЯза => ЁЯза, рддреАрдХреНрд╖реНрдг рдмреБрджреНрджреА рднрдПрдХреЛ, рджрд┐рдорд╛рдЧ
ЁЯСЕ => ЁЯСЕ, рдЬрд┐рдмреНрд░реЛ, рд╢рд░реАрд░
ЁЯСД => ЁЯСД, рдУрда, рдореБрдЦ, рд╢рд░реАрд░
ЁЯТЛ => ЁЯТЛ, рдУрда, рдЪрд┐рдиреНрд╣, рдЪреБрдореНрдмрди, рдЪреБрдореНрдмрдирдХреЛ рдЪрд┐рдиреНрд╣, рдордиреЛрд░рдиреНрдЬрди, рдореБрдЯреБ
ЁЯТШ => ЁЯТШ, рдХреБрдкрд┐рдб, рдордиреЛрд░рдиреНрдЬрди, рдореБрдЯреБ, рд╡рд╛рдг, рд╡рд╛рдг рд╕рд╣рд┐рддрдХреЛ рдореБрдЯреБ
тЭд => тЭд, рдореБрдЯреБ, рд░рд╛рддреЛ рдореБрдЯреБ
ЁЯТУ => ЁЯТУ, рдзрдбреНрдХрд┐рд░рд╣реЗрдХреЛ, рдзрдбреНрдХрд┐рд░рд╣реЗрдХреЛ рдореБрдЯреБ, рдкрд▓реНрд╕реЗрдЯрд┐рдЩ, рдореБрдЯреБ, рдореБрдЯреБрдХреЛ рдзрдбреНрдХрди
ЁЯТФ => ЁЯТФ, рдЯреБрдХреНрд░рд┐рдПрдХреЛ, рдЯреБрдХреНрд░рд┐рдПрдХреЛ рдореБрдЯреБ, рдЯреБрдЯреЗрдХреЛ, рдореБрдЯреБ
ЁЯТХ => ЁЯТХ, рджреБрдИрд╡рдЯрд╛ рдореБрдЯреБрд╣рд░реВ, рдорд╛рдпрд╛, рдореБрдЯреБ
ЁЯТЦ => ЁЯТЦ, рдЙрддреНрд╕рд╛рд╣рд┐рдд, рдЪрдордХрджрд╛рд░, рдЪрдордХрджрд╛рд░ рдореБрдЯреБ, рдореБрдЯреБ
ЁЯТЧ => ЁЯТЧ, рдЙрддреНрд╕рд╛рд╣рд┐рдд, рдЪрд┐рдиреНрддрд┐рдд, рдмрдврд┐рд░рд╣реЗрдХреЛ рдореБрдЯреБ, рдореБрдЯреБ, рд╡рд┐рдХрд╕рд┐рдд, рд╣рд░реНрдЯрдкреНрд▓рд╕
ЁЯТЩ => ЁЯТЩ, рдиреАрд▓реЛ, рдиреАрд▓реЛ рдореБрдЯреБ, рдореБрдЯреБ
ЁЯТЪ => ЁЯТЪ, рдореБрдЯреБ, рд╣рд░рд┐рдпреЛ, рд╣рд░рд┐рдпреЛ рдореБрдЯреБ
ЁЯТЫ => ЁЯТЫ, рдкрд╣реЗрдБрд▓реЛ, рдкрд╣реЗрдБрд▓реЛ рдореБрдЯреБ, рдореБрдЯреБ
ЁЯзб => ЁЯзб, рд╕реБрдиреНрддрд▓рд╛, рд╕реБрдиреНрддрд▓рд╛ рд░рдЩрдХреЛ рдореБрдЯреБ
ЁЯТЬ => ЁЯТЬ, рдкреНрдпрд╛рдЬреА, рдкреНрдпрд╛рдЬреА рдореБрдЯреБ, рдореБрдЯреБ
ЁЯЦд => ЁЯЦд, рдЕрд░реВрдХреЛ рднрд▓реЛ рдирдЪрд┐рддрд╛рдЙрдиреЗ, рдХрд╛рд▓реЛ, рдЦрд░рд╛рд╡, рджреБрд╖реНрдЯ, рдореБрдЯреБ
ЁЯТЭ => ЁЯТЭ, рднреНрдпрд╛рд▓реЗрдиреНрдЯрд╛рдЗрди, рдореБрдЯреБ, рд░рд┐рдмрди, рд░рд┐рдмрди рд╕рд╣рд┐рддрдХреЛ рдореБрдЯреБ
ЁЯТЮ => ЁЯТЮ, рдШреБрдорд┐рд░рд╣реЗрдХреЛ, рдШреБрдорд┐рд░рд╣реЗрдХреЛ рдореБрдЯреБрд╣рд░реВ, рдореБрдЯреБ
ЁЯТЯ => ЁЯТЯ, рдореБрдЯреБ, рдореБрдЯреБрдХреЛ рд╕рдЬрд╛рд╡рдЯ
тЭг => тЭг, рдЧрд╛рдврд╛ рдореБрдЯреБрдХреЛ рд╡рд┐рд╕реНрдордпрд╛рдзрд┐рдмреЛрдзрдХ рдЪрд┐рдиреНрд╣рдХреЛ рд╕рдЬрд╛рд╡рдЯ, рдЪрд┐рдиреНрд╣, рдореБрдЯреБ, рд╡рд┐рд░рд╛рдо рдЪрд┐рдиреНрд╣, рд╡рд┐рд╕реНрдордпрд╛рдзрд┐рдмрдзрдХ рдЪрд┐рдиреНрд╣
ЁЯТМ => ЁЯТМ, рдЪрд┐рдареНрдареА, рдкреНрд░реЗрдо рдкрддреНрд░, рдордиреЛрд░рдиреНрдЬрди, рдорд╛рдпрд╛, рдореБрдЯреБ, рдореЗрд▓
ЁЯТд => ЁЯТд, рдЕрд▓реНрдЫреА рд▓рд╛рдЧреЗрдХреЛ, рд╣рдБрд╕рд╛рдЙрдиреЗ
ЁЯТв => ЁЯТв, рдкрд╛рдЧрд▓, рд░рд┐рд╕, рд░рд┐рд╕рдХреЛ рд╕рдВрдХреЗрдд, рд╣рдБрд╕рд╛рдЙрдиреЗ
ЁЯТг => ЁЯТг, рдмрдо, рд╣рдБрд╕рд╛рдЙрдиреЗ
ЁЯТе => ЁЯТе, рдЯрдХреНрдХрд░, рдмреБрдо, рд╣рдБрд╕рд╛рдЙрдиреЗ
ЁЯТж => ЁЯТж, рдкрд╕рд┐рдирд╛, рдкрд╕рд┐рдирд╛рдХреЛ рдереЛрдкрд╛, рд╕реНрдкреНрд▓реНрдпрд╛рд╕рд┐рдЩреН, рд╣рдБрд╕рд╛рдЙрдиреЗ
ЁЯТи => ЁЯТи, рдЬреЛрдбрд▓реЗ, рдбреНрдпрд╛рд╢, рджреМрдбрд┐рд░рд╣реЗрдХреЛ, рд╣рдБрд╕рд╛рдЙрдиреЗ
ЁЯТл => ЁЯТл, рдЪрдХреНрдХрд░, рддрд╛рд░рд╛, рд╣рдБрд╕рд╛рдЙрдиреЗ
ЁЯТм => ЁЯТм, рдлреЛрдХрд╛, рдмреЗрд▓реБрди, рд╡рд╛рдХреНрдп, рд╡рд╛рдХреНрдп рдмреЗрд▓реБрди, рд╕рдВрд╡рд╛рдж, рд╣рдБрд╕рд╛рдЙрдиреЗ
ЁЯЧи => ЁЯЧи, рдмрд╛рдпрд╛рдБ рд╡рд╛рдХреНрдп рдмрдмрд▓, рд╡рд╛рдХреНрдп, рд╕рдореНрд╡рд╛рдж
ЁЯЧп => ЁЯЧп, рджрд╛рдпрд╛рдБ рд░рд┐рд╕рдХреЛ рдмрдмрд▓, рдкрд╛рдЧрд▓, рдлреЛрдХрд╛, рдмреЗрд▓реБрди, рд░рд┐рд╕
ЁЯТн => ЁЯТн, рдлреЛрдХрд╛, рдмреЗрд▓реБрди, рд╡рд┐рдЪрд╛рд░, рд╕реЛрдЪ рдмреЗрд▓реБрди, рд╣рдБрд╕рд╛рдЙрдиреЗ
ЁЯХ│ => ЁЯХ│, рдкреНрд╡рд╛рд▓
ЁЯСУ => ЁЯСУ, рдЖрдБрдЦрд╛, рдЖрдБрдЦрд╛рдХреЛ рдЪрд╕реНрдорд╛, рдЖрдБрдЦрд╛рдорд╛ рд▓рдЧрд╛рдЙрдиреЗ, рдХрдкрдбрд╛, рдЪрд╢реНрдорд╛
ЁЯХ╢ => ЁЯХ╢, рдЕрдБрдзреНрдпрд╛рд░реЛ, рдЖрдБрдЦрд╛, рдЖрдБрдЦрд╛рдорд╛ рд▓рдЧрд╛рдЙрдиреЗ, рдШрд╛рдордорд╛ рд▓рдЧрд╛рдЙрдиреЗ рдЪрд╢реНрдорд╛, рдЪрд╕реНрдорд╛
ЁЯСФ => ЁЯСФ, рдХрдкрдбрд╛, рдЯрд╛рдИ
ЁЯСХ => ЁЯСХ, рдХрдкрдбрд╛, рдЯрд┐-рд╕рд░реНрдЯ, рдЯрд┐рд╕рд░реНрдЯ
ЁЯСЦ => ЁЯСЦ, рдХрдкрдбрд╛, рдЬрд┐рдиреНрд╕, рдЯреНрд░рд╛рдЙрдЬрд░, рдкреЗрдиреНрдЯ
ЁЯзг => ЁЯзг, рдЧрд▓рдмрдиреНрджреА, рдШрд╛рдБрдЯреА
ЁЯзд => ЁЯзд, рдкрдиреНрдЬрд╛, рд╣рд╛рдд
ЁЯзе => ЁЯзе, рдХреЛрдЯ, рдЬреНрдпрд╛рдХреЗрдЯ
ЁЯзж => ЁЯзж, рдореЛрдЬрд╛, рд▓рд╛рдореЛ рдореЛрдЬрд╛
ЁЯСЧ => ЁЯСЧ, рдХрдкрдбрд╛, рд▓реБрдЧрд╛
ЁЯСШ => ЁЯСШ, рдХрдкрдбрд╛, рдХрд┐рдореЛрдиреЛ
ЁЯСЩ => ЁЯСЩ, рдХрдкрдбрд╛, рдкреМрдбрд┐рдиреЗ, рдмрд┐рдХрд┐рдиреА
ЁЯСЪ => ЁЯСЪ, рдХрдкрдбрд╛, рдорд╣рд┐рд▓рд╛, рдорд╣рд┐рд▓рд╛рдХреЛ рдХрдкрдбрд╛
ЁЯСЫ => ЁЯСЫ, рдХрдкрдбрд╛, рдкрд░реНрд╕, рд╕рд┐рдХреНрдХрд╛
ЁЯСЬ => ЁЯСЬ, рдХрдкрдбрд╛, рдмреНрдпрд╛рдЧ, рд╣рд╛рддреЗрдмреНрдпрд╛рдЧ
ЁЯСЭ => ЁЯСЭ, рдХрдкрдбрд╛, рдереИрд▓реА, рдмреНрдпрд╛рдЧ
ЁЯЫН => ЁЯЫН, рдХрд┐рдирдореЗрд▓, рдХрд┐рдирдореЗрд▓ рдЧрд░реНрдиреЗ рдЭреЛрд▓рд╛, рдЭреЛрд▓рд╛, рд╣реЛрдЯреЗрд▓
ЁЯОТ => ЁЯОТ, рдЭреЛрд▓рд╛, рд╡рд┐рджреНрдпрд╛рд▓рдп, рд╕реНрдХреВрд▓реЗ рдЭреЛрд▓рд╛, рд╕реНрдХреВрд▓реЗ рдмреНрдпрд╛рдХрдкреНрдпрд╛рдХ
ЁЯСЮ => ЁЯСЮ, рдХрдкрдбрд╛, рдЬреБрддреНрддрд╛, рдкреБрд░реБрд╖рдХреЛ, рдкреБрд░реБрд╖рдХреЛ рдЬреБрддреНрддрд╛
ЁЯСЯ => ЁЯСЯ, рдЦреЗрд▓рдХреБрдж рд╕рдореНрдмрдиреНрдзреА, рдЬреБрддреНрддрд╛, рджреМрдбрджрд╛ рд▓рдЧрд╛рдЙрдиреЗ рдЬреБрддреНрддрд╛, рд▓реБрдЧрд╛ рд▓рд╡рд╛рдЗ, рд╕реНрдирд┐рдХрд░
ЁЯСа => ЁЯСа, рдЕрдЧреНрд▓реЛ рд╣рд┐рд▓ рднрдПрдХреЛ рдЬреБрддреНрддрд╛, рдХрдкрдбрд╛, рдЫреЛрд░реА рдорд╛рдиреНрдЫреЗ, рдЬреБрддреНрддрд╛, рд╣рд┐рд▓
ЁЯСб => ЁЯСб, рдХрдкрдбрд╛, рдЫреЛрд░реА рдорд╛рдиреНрдЫреЗ, рдЫреЛрд░реА рдорд╛рдиреНрдЫреЗрдХреЛ рдЪрдкреНрдкрд▓
ЁЯСв => ЁЯСв, рдХрдкрдбрд╛, рдЫреЛрд░реА рдорд╛рдиреНрдЫреЗ, рдЫреЛрд░реА рдорд╛рдиреНрдЫреЗрдХреЛ рдмреБрдЯ рдЬреБрддреНрддрд╛, рдЬреБрддреНрддрд╛, рдмреБрдЯ
ЁЯСС => ЁЯСС, рдХрдкрдбрд╛, рдХреНрд░рд╛рдЙрди, рд░рд╛рдЬрд╛, рд░рд╛рдиреА
ЁЯСТ => ЁЯСТ, рдХрдкрдбрд╛, рдЯреЛрдкреА, рдорд╣рд┐рд▓рд╛, рдорд╣рд┐рд▓рд╛рдХреЛ рдЯреЛрдкреА
ЁЯОй => ЁЯОй, рдЕрдЧреНрд▓реЛ рдЯреЛрдкреА, рдХрдкрдбрд╛, рдЯреЛрдкреА, рд╢реАрд░реНрд╖, рд╢реАрд░реНрд╖рдЯреЛрдкреА
ЁЯОУ => ЁЯОУ, рдЙрддреНрд╕рд╡ рдордирд╛рдЙрдиреБ, рдХрдкрдбрд╛, рдЫрддреНрд░реЗ рдЯреЛрдкреА, рдЯреЛрдкреА, рджреАрдХреНрд╖рд╛рдиреНрдд рдЯреЛрдкреА, рд╢реИрдХреНрд╖рд┐рдХ рдпреЛрдЧреНрдпрддрд╛ рд╣рд╛рд╕рд┐рд▓ рдЧрд░реНрдиреБ
ЁЯзв => ЁЯзв, рдмреЗрд╕рдмрд▓ рдЯреЛрдкреА, рдмреЗрд╕рдмрд▓рдХреЛ рдЯреЛрдкреА
тЫС => тЫС, рдЕрдиреБрд╣рд╛рд░, рдХреНрд░рд╕, рдЯреЛрдкреА, рд╕рд╛рдзрди, рд╕реЗрддреЛ рдХреНрд░рд╕ рднрдПрдХреЛ рд╣реЗрд▓рдореЗрдЯ, рд╣реЗрд▓рдореЗрдЯ
ЁЯУ┐ => ЁЯУ┐, рдХрдкрдбрд╛, рдзрд░реНрдо, рдкреНрд░рд╛рд░реНрдердирд╛, рдорд╛рд▓рд╛, рдорд╛рд▓рд╛рдХреЛ рджрд╛рдирд╛, рд╣рд╛рд░
ЁЯТД => ЁЯТД, рдореЗрдХрдЕрдк, рд▓рд┐рдкрд╕реНрдЯрд┐рдХ, рд╢реНрд░реГрдЩреНрдШрд╛рд░ рд╕рд╛рдордЧреНрд░реА
ЁЯТН => ЁЯТН, рдФрдВрдареА, рд╣рд┐рд░рд╛
ЁЯТО => ЁЯТО, рдЧрд╣рдирд╛, рдкрдереНрдерд░, рд╣рд┐рд░рд╛
ЁЯР╡ => ЁЯР╡, рдЕрдиреБрд╣рд╛рд░, рдмрд╛рдБрджрд░, рдмрд╛рдБрджрд░рдХреЛ рдЕрдиреБрд╣рд╛рд░
ЁЯРТ => ЁЯРТ, рдмрд╛рдБрджрд░
ЁЯжН => ЁЯжН, рдЧреЛрд░рд┐рд▓реНрд▓рд╛, рдкрд╢реБ
ЁЯР╢ => ЁЯР╢, рдЕрдиреБрд╣рд╛рд░, рдХреБрдХреБрд░, рдХреБрдХреБрд░рдХреЛ рдЕрдиреБрд╣рд╛рд░, рдкрд╛рд▓реНрддреБ
ЁЯРХ => ЁЯРХ, рдХреБрдХреБрд░, рдкрд╛рд▓реНрддреБ
ЁЯРй => ЁЯРй, рдХреБрдХреБрд░, рдкреВрдбрд▓
ЁЯР║ => ЁЯР║, рдЕрдиреБрд╣рд╛рд░, рд╡реНрд╡рд╛рдБрд╕реЛ, рд╡реНрд╡рд╛рдБрд╕реЛрдХреЛ рдЕрдиреБрд╣рд╛рд░
ЁЯжК => ЁЯжК, рдЕрдиреБрд╣рд╛рд░, рдзреВрд░реНрдд рдЕрдиреБрд╣рд╛рд░, рдкрд╢реБ, рд╕реНрдпрд╛рд▓
ЁЯР▒ => ЁЯР▒, рдЕрдиреБрд╣рд╛рд░, рдкрд╛рд▓реНрддреБ, рдмрд┐рд░рд╛рд▓реЛ, рдмрд┐рд░рд╛рд▓реЛрдХреЛ рдЕрдиреБрд╣рд╛рд░
ЁЯРИ => ЁЯРИ, рдкрд╛рд▓реНрддреБ, рдмрд┐рд░рд╛рд▓реЛ
ЁЯжБ => ЁЯжБ, рдЕрдиреБрд╣рд╛рд░, рд░рд╛рд╢рд┐, рд╕рд┐рдВрд╣, рд╕рд┐рдВрд╣рдХреЛ рдЕрдиреБрд╣рд╛рд░
ЁЯРп => ЁЯРп, рдЕрдиреБрд╣рд╛рд░, рдмрд╛рдШ, рдмрд╛рдШрдХреЛ рдЕрдиреБрд╣рд╛рд░
ЁЯРЕ => ЁЯРЕ, рдмрд╛рдШ, рдмрд╛рдБрдШ
ЁЯРЖ => ЁЯРЖ, рдЪрд┐рддреБрд╡рд╛
ЁЯР┤ => ЁЯР┤, рдЕрдиреБрд╣рд╛рд░, рдШреЛрдбрд╛, рдШреЛрдбрд╛рдХреЛ рдЕрдиреБрд╣рд╛рд░
ЁЯРО => ЁЯРО, рдШреЛрдбрд╛, рджреМрдбрд┐рдиреЗ, рджреМрдбрд┐рдиреЗрдШреЛрдбрд╛
ЁЯжД => ЁЯжД, рдЕрдиреБрд╣рд╛рд░, рдЧреИрдБрдбрд╛, рдЧреИрдБрдбрд╛рдХреЛ рдЕрдиреБрд╣рд╛рд░
ЁЯжУ => ЁЯжУ, рдзрд░реНрдХрд╛, рдмрдирдШреЛрдбрд╛
ЁЯжМ => ЁЯжМ, рдкрд╢реБ, рдореГрдЧ
ЁЯРо => ЁЯРо, рдЕрдиреБрд╣рд╛рд░, рдЧрд╛рдИ, рдЧрд╛рдИрдХреЛ рдЕрдиреБрд╣рд╛рд░
ЁЯРВ => ЁЯРВ, рдЧреЛрд░реВ, рдЬреЛрдбрд┐рдпрд╛рдХ, рдЯрд╛рдЙрд░рд╕, рд╕рд╛рдБрдвреЗ
ЁЯРГ => ЁЯРГ, рдЕрд░реНрдирд╛, рдкрд╛рдиреА
ЁЯРД => ЁЯРД, рдЧрд╛рдИ
ЁЯР╖ => ЁЯР╖, рдЕрдиреБрд╣рд╛рд░, рд╕реБрдБрдЧреБрд░, рд╕реБрдБрдЧреБрд░рдХреЛ рдЕрдиреБрд╣рд╛рд░
ЁЯРЦ => ЁЯРЦ, рд╕реБрдБрдЧреБрд░, рд╕реБрдБрдЧреБреБрд░
ЁЯРЧ => ЁЯРЧ, рдмрдБрджреЗрд▓, рд╕реБрдБрдЧреБрд░
ЁЯР╜ => ЁЯР╜, рдЕрдиреБрд╣рд╛рд░, рдирд╛рдХ, рд╕реБрдБрдЧреБрд░, рд╕реБрдБрдЧреБрд░рдХреЛ рдирд╛рдХ
ЁЯРП => ЁЯРП, рднреЗрдбрд╛, рдореЗрд╖, рд░рд╛рд╢рд┐
ЁЯРС => ЁЯРС, рднреЗрдбрд╛, рднреЗрдбрд╛рд╛
ЁЯРР => ЁЯРР, рдмрд╛рдЦреНрд░рд╛, рд░рд╛рд╢рд┐
ЁЯРк => ЁЯРк, рдКрдБрдЯ, рдбреНрд░реЛрдореЗрдбрд░реА
ЁЯРл => ЁЯРл, рдКрдБрдЯ, рдЬреБрд░реЛ, рджреБрдИ рдЬреБрд░реЛ рднрдПрдХреЛ рдКрдБрдЯ, рдмреНрдпрд╛рдХреНрдЯреНрд░рд┐рдпрди
ЁЯжТ => ЁЯжТ, рдЬрд┐рд░рд╛рдл, рдЯрд╛рдЯреЛ
ЁЯРШ => ЁЯРШ, рд╣рд╛рддреНрддреА
ЁЯжП => ЁЯжП, рдЧреИрдВрдбрд╛, рдкрд╢реБ
ЁЯРн => ЁЯРн, рдЕрдиреБрд╣рд╛рд░, рдореБрд╕рд╛, рдореБрд╕рд╛рдХреЛ рдЕрдиреБрд╣рд╛рд░
ЁЯРБ => ЁЯРБ, рдЫреБрдЪреБрдиреНрджреНрд░рд╛
ЁЯРА => ЁЯРА, рдореБрд╕рд╛
ЁЯР╣ => ЁЯР╣, рдЕрдиреБрд╣рд╛рд░, рдкрд╛рд▓реНрддреБ, рд╣реНрдпрд╛рдореНрд╕реНрдЯрд░, рд╣реНрдпрд╛рдореНрд╕реНрдЯрд░ рдЕрдиреБрд╣рд╛рд░
ЁЯР░ => ЁЯР░, рдЕрдиреБрд╣рд╛рд░, рдЦрд░рд╛рдпреЛ, рдЦрд░рд╛рдпреЛрдХреЛ рдЕрдиреБрд╣рд╛рд░, рдкрд╛рд▓реНрддреБ
ЁЯРЗ => ЁЯРЗ, рдЦрд░рд╛рдпреЛ, рдкрд╛рд▓реНрддреБ
ЁЯР┐ => ЁЯР┐, рдЪреАрдкрдордХ, рдЪреАрдкрдордВрдХ
ЁЯжФ => ЁЯжФ, рдХрд╛рдБрдбрд╛ рднрдПрдХреЛ, рджреБрдореНрд╕реА
ЁЯжЗ => ЁЯжЗ, рдЪрдореЗрд░реЛ, рдкрд╢реБ, рднреВрдд
ЁЯР╗ => ЁЯР╗, рдЕрдиреБрд╣рд╛рд░, рднрд╛рд▓реБ, рднрд╛рд▓реБрдХреЛ рдЕрдиреБрд╣рд╛рд░
ЁЯРи => ЁЯРи, рдХреЛрд╡рд▓рд╛, рднрд╛рд▓реБ
ЁЯР╝ => ЁЯР╝, рдЕрдиреБрд╣рд╛рд░, рдкрд╛рдгреНрдбрд╛, рдкрд╛рдгреНрдбрд╛рдХреЛ рдЕрдиреБрд╣рд╛рд░
ЁЯР╛ => ЁЯР╛, рдЦреБрдЯреНрдЯрд╛рдХрд╛ рдбреЛрдмрд╣рд░реВ, рдбреЛрдм, рдк
ЁЯжГ => ЁЯжГ, рдЯрд░реНрдХреА
ЁЯРФ => ЁЯРФ, рдХреБрдЦреБрд░рд╛
ЁЯРУ => ЁЯРУ, рднрд╛рд▓реЗ
ЁЯРг => ЁЯРг, рдХреЛрд░рд▓рд┐рджреИ рдЧрд░реЗрдХреЛ, рдХреЛрд░рд▓рд┐рджреИ рдЧрд░реЗрдХреЛ рдЪрд▓реНрд▓рд╛, рдЪрд▓реНрд▓рд╛, рдмрдЪреНрдЪрд╛
ЁЯРд => ЁЯРд, рдХреБрдЦреБрд░рд╛рдХреЛ рдЪрд▓реНрд▓рд╛, рдЪрд▓реНрд▓рд╛, рдмрдЪреНрдЪрд╛
ЁЯРе => ЁЯРе, рдЕрдЧрд╛рдбрд┐-рдЕрдиреБрд╣рд╛рд░ рджреЗрдЦрд┐рдПрдХреЛ рдХреБрдЦреБрд░рд╛рдХреЛ рдЪрд▓реНрд▓рд╛, рдЪрд▓реНрд▓рд╛, рдмрдЪреНрдЪрд╛
ЁЯРж => ЁЯРж, рдкрдВрдХреНрд╖реА
ЁЯРз => ЁЯРз, рдкреЗрдиреНрдЧреБрдЗрди
ЁЯХК => ЁЯХК, рдЙрдбреНрдиреЗ, рдЪрд░рд╛, рдвреБрдХреНрдХреБрд░
ЁЯжЕ => ЁЯжЕ, рдЪрд░рд╛, рдЪрд┐рд▓
ЁЯжЖ => ЁЯжЖ, рдЪрд░рд╛, рд╣рд╛рдБрд╕
ЁЯжЙ => ЁЯжЙ, рдЙрд▓реНрд▓реБ, рдЪрд░рд╛, рдмреБрджреНрджрд┐рдорд╛рди
ЁЯР╕ => ЁЯР╕, рдЕрдиреБрд╣рд╛рд░, рднреНрдпрд╛рдЧреБрддреЛ, рднреНрдпрд╛рдЧреБрддреЛрдХреЛ рдЕрдиреБрд╣рд╛рд░
ЁЯРК => ЁЯРК, рдЧреЛрд╣реА
ЁЯРв => ЁЯРв, рдХрдЫреБрд╡рд╛
ЁЯжО => ЁЯжО, рдШрд┐рд╕реНрд░рд┐рдиреЗ рдЬрдирд╛рд╡рд░, рдЫреЗрдкрд╛рд░реЛ
ЁЯРН => ЁЯРН, рд░рд╛рд╢рд┐, рд╕рд╛рдБрдк
ЁЯР▓ => ЁЯР▓, рдЕрдиреБрд╣рд╛рд░, рдбреНрд░рдпрд╛рдЧрди, рдбреНрд░рдпрд╛рдЧрдирдХреЛ рдЕрдиреБрд╣рд╛рд░, рдкрд░реАрдХреЛ рдХрдерд╛
ЁЯРЙ => ЁЯРЙ, рдбреНрд░рдпрд╛рдЧрди, рдкрд░реАрдХреЛ рдХрдерд╛
ЁЯжХ => ЁЯжХ, рдбрд┐рдкреНрд▓реЛрдбреЛрдХрд╕, рдмреНрд░рд╛рдЪрд┐рдпреЛрд╕рд░рд╕, рдмреНрд░реЛрдиреНрдЯреЛрд╕рд░рд╕, рд╕реМрдВрд░реЛрдкрдб
ЁЯжЦ => ЁЯжЦ, рдЯрд╛рдЗрд░рд╛рдиреЛрд╕рд░рд╕ рд░реЗрдХреНрд╕, рдЯрд┐-рд░реЗрдХреНрд╕
ЁЯР│ => ЁЯР│, рдЕрдиреБрд╣рд╛рд░, рд╕реНрдкрд╛рдЙрдЯрд┐рдЩреН, рд╕реНрдкрд╛рдЙрдЯрд┐рдЩреН рд╣реНрд╡реЗрд▓, рд╣реНрд╡реЗрд▓
ЁЯРЛ => ЁЯРЛ, рд╣реНрд╡реЗрд▓
ЁЯРм => ЁЯРм, рдбрд▓реНрдлрд┐рди, рдлреНрд▓рд┐рдкреНрдкрд░
ЁЯРЯ => ЁЯРЯ, рдорд╛рдЫрд╛, рд░рд╛рд╢рд┐
ЁЯРа => ЁЯРа, рдЙрд╖реНрдгрдкреНрд░рджреЗрд╢реАрдп, рдЙрд╖реНрдгрдкреНрд░рджреЗрд╢реАрдп рдорд╛рдЫрд╛, рдорд╛рдЫрд╛
ЁЯРб => ЁЯРб, рдмреНрд▓реЛ рдорд╛рдЫрд╛, рдорд╛рдЫрд╛
ЁЯжИ => ЁЯжИ, рдорд╛рдЫрд╛, рд╢рд╛рд░реНрдХ, рд╢рд╛рд░реНрдХ рдорд╛рдЫрд╛
ЁЯРЩ => ЁЯРЩ, рдЕрдХреНрдЯреЛрдкрд╕
ЁЯРЪ => ЁЯРЪ, рд╕реЗрд▓, рд╕реНрдкрд╛рдЗрд░рд▓ рд╕реЗрд▓, рд╕реНрдкрд┐рд░рд▓
ЁЯжА => ЁЯжА, рдХреНрдпрд╛рдиреНрд╕рд░, рдЧрдВрдЧрдЯрд╛, рд░рд╛рд╢рд┐
ЁЯжР => ЁЯжР, рдЦрд╛рдирд╛, рд╢реЗрд▓рдорд╛рдЫрд╛, рд╢реНрд░рд┐рдореНрдк, рд╕рд╛рдиреЛ
ЁЯжС => ЁЯжС, рдЦрд╛рдирд╛, рдореЛрд▓рд╕реНрдХ, рд╕реНрдХреНрд╡рд┐рдб
ЁЯРМ => ЁЯРМ, рдЪрд┐рдкреНрд▓реЗрдХреАрд░рд╛, рд╕реНрдиреЗрд▓
ЁЯжЛ => ЁЯжЛ, рдХрд┐рд░рд╛, рдкреБрддрд▓реА, рд░рд╛рдореНрд░реЛ
ЁЯРЫ => ЁЯРЫ, рдЙрдбреБрд╕, рдХреАрд░рд╛
ЁЯРЬ => ЁЯРЬ, рдХрдорд┐рд▓рд╛, рдХреАрд░рд╛
ЁЯРЭ => ЁЯРЭ, рдХрдорд┐рд▓рд╛, рдорд╛рд╣реБрд░реА
ЁЯРЮ => ЁЯРЮ, рдХрдорд┐рд▓рд╛, рд▓реЗрдбреА рдмрд┐рдЯрд▓
ЁЯжЧ => ЁЯжЧ, рдлрдЯреНрдпрд╛рдЩреНрдЧреНрд░рд╛
ЁЯХ╖ => ЁЯХ╖, рдХрдорд┐рд▓рд╛, рдорд╛рдХреБрд░рд╛
ЁЯХ╕ => ЁЯХ╕, рдЬрд╛рд▓реЛ, рдорд╛рдХреБрд░рд╛, рдорд╛рдХреБрд░рд╛рдХреЛ рдЬрд╛рд▓реЛ
ЁЯжВ => ЁЯжВ, рдмрд┐рдЪреНрдЫреА, рд░рд╛рд╢рд┐
ЁЯТР => ЁЯТР, рдлреВрд▓, рдмрд┐рд░реВрд╡рд╛, рдмреБрдХреЗ, рдордиреЛрд░рдиреНрдЬрди
ЁЯМ╕ => ЁЯМ╕, рдЪреЗрд░реА, рдЪреЗрд░реА рдлреБрд▓реНрдиреЗ, рдлреБрд▓реНрдиреЗ, рдлреВрд▓, рдмрд┐рд░реВрд╡рд╛
ЁЯТо => ЁЯТо, рдлреБрд▓, рд╕реЗрддреЛ рдлреБрд▓
ЁЯП╡ => ЁЯП╡, рдерд╛рд▓реА, рдмрд┐рд░реВрд╡рд╛
ЁЯМ╣ => ЁЯМ╣, рдЧреБрд▓рд╛рдл, рдлреВрд▓, рдмрд┐рд░реВрд╡рд╛
ЁЯеА => ЁЯеА, рдЖрдЗрд▓рд┐рдПрдХреЛ, рдУрдЗрд▓рд┐рдПрдХреЛ рдлреВрд▓, рдлреВрд▓
ЁЯМ║ => ЁЯМ║, рдлреВрд▓, рдмрд┐рд░реВрд╡рд╛, рд╣рд╛рдЗрдмрд┐рд╕реНрдХрд╕
ЁЯМ╗ => ЁЯМ╗, рдлреВрд▓, рдмрд┐рд░реВрд╡рд╛, рд╕реВрд░реНрдп, рд╕реВрд░реНрдпрдореБрдЦреА
ЁЯМ╝ => ЁЯМ╝, рдлреБрд▓реНрдиреЗ, рдлреВрд▓, рдмрд┐рд░реВрд╡рд╛
ЁЯМ╖ => ЁЯМ╖, рдЯреБрд▓рд┐рдк, рдлреВрд▓, рдмрд┐рд░реВрд╡рд╛
ЁЯМ▒ => ЁЯМ▒, рдЕрдВрдХреБрд░, рдмрд┐рд░реВрд╡рд╛, рднрд░реНрдЦрд░рдХреЛ
ЁЯМ▓ => ЁЯМ▓, рдмрд┐рд░реВрд╡рд╛, рд░реВрдЦ, рд╕рджрд╛рдмрд╣рд╛рд░
ЁЯМ│ => ЁЯМ│, рдкрддрдЭрдв рд░реВрдЦ, рдкрд░реНрдгрдкрд╛рддреА рд░реВрдЦ
ЁЯМ┤ => ЁЯМ┤, рдЦрдЬреБрд░, рдЦрдЬреБрд░рдХреЛ рд░реВрдЦ, рдмрд┐рд░реВрд╡рд╛, рд░реВрдЦ
ЁЯМ╡ => ЁЯМ╡, рдмрд┐рд░реВрд╡рд╛, рд╕рд┐рдЙрдБрдбреА
ЁЯМ╛ => ЁЯМ╛, рдХрд╛рди, рдЪрд╛рдорд▓, рдЪрд╛рдорд▓рдХреЛ рд╕рд┐рдл, рдмрд┐рд░реВрд╡рд╛
ЁЯМ┐ => ЁЯМ┐, рдЬрдбреАрдмреБрдЯреА, рдкрд╛рдд, рдмрд┐рд░реВрд╡рд╛
тШШ => тШШ, рдмрд┐рд░реВрд╡рд╛, рд╕рд╛рдорд░рдХ
ЁЯНА => ЁЯНА, 4, рдХреНрд▓реЛрднрд░, рдХреНрд▓реЛрднрд░рдХреЛ рдЪрд╛рд░рд╡рдЯрд╛ рдкрд╛рдд, рдЪрд╛рд░, рдкрд╛рдд, рдмрд┐рд░реВрд╡рд╛
ЁЯНБ => ЁЯНБ, рдЭрд░реЗрдХреЛ, рдкрд╛рдд, рдмрд┐рд░реВрд╡рд╛, рдореЗрдкрд▓, рдореЗрдкрд▓рдХреЛ рдкрд╛рдд
ЁЯНВ => ЁЯНВ, рдЭрд░реЗрдХреЛ, рдЭрд░реЗрдХреЛ рдкрд╛рдд, рдкрд╛рдд, рдмрд┐рд░реВрд╡рд╛
ЁЯНГ => ЁЯНГ, рдкрд╛рдд, рдлрд░рдлрд░рд╛рдПрдХреЛ, рдлреНрд▓рдЯрд░, рдмрд┐рд░реВрд╡рд╛, рд╣рд╛рд╡рд╛, рд╣рд╛рд╡рд╛рдорд╛ рдлрд░рдлрд░рд╛рдЗрд╣рд░реЗрдХреЛ рдкрд╛рдд
ЁЯНЗ => ЁЯНЗ, рдЕрдЩреНрдЧреБрд░, рдлрд▓рдлреВрд▓, рдмрд┐рд░реВрд╡рд╛
ЁЯНИ => ЁЯНИ, рддрд░рдмреВрдЬ, рдлрд▓рдлреВрд▓
ЁЯНЙ => ЁЯНЙ, рдЦрд░рдмреБрдЬрд╛, рдлрд▓рдлреВрд▓
ЁЯНК => ЁЯНК, рдЯреНрдпрд╛рдиреНрдЬрд░рд┐рди, рдлрд▓рдлреВрд▓, рдмрд┐рд░реВрд╡рд╛, рд╕реБрдиреНрдирддрд▓рд╛
ЁЯНЛ => ЁЯНЛ, рдХрд╛рдЧрддреА, рдлрд▓рдлреВрд▓, рдмрд┐рд░реВрд╡рд╛
ЁЯНМ => ЁЯНМ, рдХреЗрд░рд╛, рдлрд▓рдлреВрд▓, рдмрд┐рд░реВрд╡рд╛
ЁЯНН => ЁЯНН, рдХрдЯрд░, рдлрд▓рдлреВрд▓
ЁЯНО => ЁЯНО, рдлрд▓рдлреВрд▓, рдмрд┐рд░реВрд╡рд╛, рд░рд╛рддреЛ, рд░рд╛рддреЛ рд╕реНрдпрд╛рдЙ, рд╕реНрдпрд╛рдЙ
ЁЯНП => ЁЯНП, рдлрд▓рдлреВрд▓, рдмрд┐рд░реВрд╡рд╛, рд╕реНрдпрд╛рдЙ, рд╣рд░рд┐рдпреЛ, рд╣рд░рд┐рдпреЛ рд╕реНрдпрд╛рдЙ
ЁЯНР => ЁЯНР, рдирд╛рд╕рдкрд╛рддреА, рдлрд▓рдлреВрд▓
ЁЯНС => ЁЯНС, рдлрд▓рдлреВрд▓, рдмрдЦрдбрд╛, рдмрд┐рд░реВрд╡рд╛
ЁЯНТ => ЁЯНТ, рдЪреЗрд░реА, рдлрд▓рдлреВрд▓, рдмрд┐рд░реВрд╡рд╛
ЁЯНУ => ЁЯНУ, рдлрд▓рдлреВрд▓, рдмрд┐рд░реВрд╡рд╛, рдмреЗрд░реА, рд╕реНрдЯреНрд░рдмреЗрд░реА
ЁЯеЭ => ЁЯеЭ, рдХрд┐рд╡реА, рдХрд┐рд╡реА рдлрд▓, рдЦрд╛рдирд╛, рдлрд▓
ЁЯНЕ => ЁЯНЕ, рдЧреЛрд▓рднреЗрдВрдбрд╛, рдмрд┐рд░реВрд╡рд╛, рд╕рд╛рдЧрдкрд╛рдд
ЁЯее => ЁЯее, рдирд░рд┐рд╡рд▓, рдкрд╛рд▓реНрдо, рдкрд┐рдирд╛ рдХреЛрд▓рдбрд╛
ЁЯеС => ЁЯеС, рдЕрднреЛрдХрд╛рдбреЛ, рдЦрд╛рдирд╛, рдлрд▓
ЁЯНЖ => ЁЯНЖ, рдмрд┐рд░реВрд╡рд╛, рднреНрдпрд╛рдиреНрдЯрд╛, рд╕рд╛рдЧрдкрд╛рдд
ЁЯеФ => ЁЯеФ, рдЖрд▓реБ, рдЦрд╛рдирд╛, рддрд░рдХрд╛рд░реА
ЁЯеХ => ЁЯеХ, рдЦрд╛рдирд╛, рдЧрд╛рдЬрд░, рддрд░рдХрд╛рд░реА
ЁЯМ╜ => ЁЯМ╜, рдХрд╛рди, рдмрд┐рд░реВрд╡рд╛, рдордХреИ, рдордХреИрдХреЛ рдкрд╛рдд
ЁЯМ╢ => ЁЯМ╢, рдХрд╛рд▓реЛ, рдкрд┐рд░реЛ рдЦреБрд░реНрд╕рд╛рдиреА, рдмрд┐рд░реВрд╡рд╛, рдорд░рд┐рдЪ
ЁЯеТ => ЁЯеТ, рдЕрдЪрд╛рд░, рдХрд╛рдХреНрд░реЛ, рдЦрд╛рдирд╛, рддрд░рдХрд╛рд░реА
ЁЯеж => ЁЯеж, рдмреНрд░реЛрдХрд╛рдЙрд▓реА, рд╕рдореБрджреНрд░реА рдмрдиреНрджрд╛
ЁЯНД => ЁЯНД, рдЪреНрдпрд╛рдЙ, рдмрд┐рд░реВрд╡рд╛
ЁЯеЬ => ЁЯеЬ, рдУрдЦрд░, рдЦрд╛рдирд╛, рддрд░рдХрд╛рд░реА, рдмрджрд╛рдо
ЁЯМ░ => ЁЯМ░, рдУрдЦрд░, рдмрд┐рд░реВрд╡рд╛
ЁЯНЮ => ЁЯНЮ, рд░реЛрдЯреА, рд░реЛрдЯреАрдХреЛ рдЯреБрдХреНрд░рд╛
ЁЯеР => ЁЯеР, рдХреНрд░реЗрд╕реЗрдиреНрдЯ рд░реЛрд▓, рдХреНрд░реЛрдЗрд╕реНрд╕рдиреНрдЯ, рдЦрд╛рдирд╛, рдлреНрд░рд╛рдиреНрд╕реЗрд▓реА, рд░реЛрдЯреА
ЁЯеЦ => ЁЯеЦ, рдЦрд╛рдирд╛, рдлреНрд░рд╛рдиреНрд╕реЗрд▓реА, рдмреНрдпрд╛рдЧреЗрдЯ, рдмреНрдпрд╛рдЧреЗрдЯ рд░реЛрдЯреА, рд░реЛрдЯреА
ЁЯеи => ЁЯеи, рдкреНрд░реЗрддреНрдЬреЗрд▓, рдмрдЯрд╛рд░рд┐рдПрдХреЛ
ЁЯеЮ => ЁЯеЮ, рдХреНрд░реЗрдкреЗ, рдЦрд╛рдирд╛, рддрд╛рддреЛ рдХреЗрдХ, рдкреНрдпрд╛рдирдХреЗрдХ
ЁЯзА => ЁЯзА, рдкрдирд┐рд░, рдкрдирд┐рд░ рдкрд┐рд╕реНрдиреЗ
ЁЯНЦ => ЁЯНЦ, рдорд╛рд╕реБ, рд╣рдбреНрдбрд┐рдХреЛ рдорд╛рд╕реБ, рд╣рдбреНрдбреА
ЁЯНЧ => ЁЯНЧ, рдХреБрдЦреБрд░рд╛, рдХреБрдЦреБрд░рд╛рдХреЛ рдлрд┐рд▓рд╛, рдЦреБрдЯреНрдЯрд╛, рдкреЛрд▓реНрдЯреНрд░реА, рд╣рдбреНрдбреА
ЁЯей => ЁЯей, рдмрдЩреНрдЧреБрд░рдХреЛ рдорд╛рд╕реБрдХреЛ рдЯреБрдХреНрд░рд╛, рднреЗрдбрд╛рдХреЛ рдорд╛рд╕реБрдХреЛ рдЯреБрдХреНрд░рд╛, рдорд╛рд╕реБрдХреЛ рдЯреБрдХреНрд░рд╛, рдорд╛рд╕реБрдХреЛ рд╕реЗрдХреБрд╡рд╛
ЁЯеУ => ЁЯеУ, рдЦрд╛рдирд╛, рдмреЗрдХрди, рдорд╛рд╕реБ
ЁЯНФ => ЁЯНФ, рдмрд░реНрдЧрд░, рд╣реНрдпрд╛рдордмрд░реНрдЧрд░
ЁЯНЯ => ЁЯНЯ, рдлреНрд░рд╛рдЗрд╕, рдлреНрд░реЗрдиреНрдЪ, рдлреНрд░реЗрдиреНрдЪ рдлреНрд░рд╛рдЗрдЬ
ЁЯНХ => ЁЯНХ, рдкрд┐рдЬреНрдЬрд╛, рд╕реНрд▓рд╛рдЗрд╕
ЁЯМн => ЁЯМн, рдлреНрд░реНрдпрд╛рдЩреНрдХрдлреБрд░реНрдЯрд░, рд╕рд╕реЗрд╕, рд╣рдб рдбрдЧ, рд╣рдбрдбрдЧ
ЁЯек => ЁЯек, рдкрд╛рдЙрд░реЛрдЯреА, рд╕реНрдпрд╛рдиреНрдбрд╡рд┐рдЪ
ЁЯМо => ЁЯМо, рдЯрд╛рдХреЛ, рдореЗрдХреНрд╕рд┐рдХрди
ЁЯМп => ЁЯМп, рдмрд░реНрд░рд┐рдЯреЛ, рдореЗрдХреНрд╕рд┐рдХрди
ЁЯеЩ => ЁЯеЩ, рдХрдмрд╛рдм, рдЦрд╛рдирд╛, рдЧрд╛рдЗрд░реЛ, рдлрд▓рд╛рдлреЗрдЗ, рдлреНрд▓реНрдпрд╛рдЯрдмреНрд░реЗрдб, рд╕реНрдЯрдлреНрдб, рд╕реНрдЯрдлреНрдб рдлреНрд▓реНрдпрд╛рдЯрдмреНрд░реЗрдб
ЁЯеЪ => ЁЯеЪ, рдЕрдгреНрдбрд╛, рдЦрд╛рдирд╛
ЁЯН│ => ЁЯН│, рдЕрдгреНрдбрд╛, рдЦрд╛рдирд╛ рдмрдирд╛рдЙрдБрджреИ, рдкреНрдпрд╛рди, рдлреНрд░рд╛рдИ рдЧрд░реНрдиреЗ
ЁЯеШ => ЁЯеШ, рдХрд░рд╛рдИ, рдХрд╛рд╕реНрд╕реЗрд░реЛрд▓, рдЦрд╛рдирд╛, рдкрд╛рдпрд▓рд╛, рд╣реЛрдЪреЛ, рд╣реЛрдЪреЛ рдХрд░рд╛рдИрдХреЛ рдЦрд╛рдирд╛
ЁЯН▓ => ЁЯН▓, рдЦрд╛рдирд╛ рдЦрд╛рдиреЗ, рдЦрд╛рдирд╛ рд░рд╛рдЦрд┐рдПрдХреЛ рднрд╛рдБрдбреЛ, рднрд╛рдБрдбреЛ
ЁЯег => ЁЯег, рдЪрдореНрдЪрд╛рд╕рд╣рд┐рддрдХреЛ рдмрдЯреБрдХрд╛, рдмрд┐рд╣рд╛рдирдХреЛ рдЦрд╛рдЬрд╛
ЁЯеЧ => ЁЯеЧ, рдЦрд╛рдирд╛, рд╕рд▓рд╛рдж, рд╣рд░рд┐рдпреЛ, рд╣рд░рд┐рдпреЛ рд╕рд▓рд╛рдж
ЁЯН┐ => ЁЯН┐, рдкрдкрдХрд░реНрди
ЁЯел => ЁЯел, рдЯрд┐рдирдХреЛ рдмрдЯреНрдЯрд╛, рдЯрд┐рдирдХреЛ рдмрдЯреНрдЯрд╛рдорд╛ рд░рд╛рдЦрд┐рдПрдХреЛ рдЦрд╛рдирд╛
ЁЯН▒ => ЁЯН▒, рдмрдХреНрд╕, рдмреЗрдиреНрдЯреЛ, рдмреЗрдиреНрдЯреЛ рдмрдХреНрд╕
ЁЯНШ => ЁЯНШ, рдХреНрд░реНрдпрд╛рдХрд░, рд░рд╛рдЗрд╕, рд░рд╛рдЗрд╕ рдХреНрд░реНрдпрд╛рдХрд░
ЁЯНЩ => ЁЯНЩ, рдЬрд╛рдкрд╛рдирд┐рдЬ, рдмрд▓, рд░рд╛рдЗрд╕, рд░рд╛рдЗрд╕ рдмрд▓
ЁЯНЪ => ЁЯНЪ, рдЦрд╛рдирд╛, рдкрдХрд╛рдПрдХреЛ, рдкрдХрд╛рдПрдХреЛ рдЦрд╛рдирд╛
ЁЯНЫ => ЁЯНЫ, рддрд░рдХрд╛рд░реА, рднрд╛рдд, рднрд╛рдд рд░ рддрд░рдХрд╛рд░реА
ЁЯНЬ => ЁЯНЬ, рдХрдЪреМрдВрд░рд╛, рддрд╛рддреЛ, рддрд╛рддреЛ рдЦрд╛рдирд╛рдХреЛ рдХрдЪреМрд░рд╛, рдереБрдХреНрдкрд╛, рд░рд╛рдореЗрди
ЁЯНЭ => ЁЯНЭ, рдкрд╛рд╕реНрддрд╛, рд╕реНрдкрд╛рдШреЗрдЯреНрдЯреА
ЁЯНа => ЁЯНа, рд░реЛрд╕реНрдЯ рдЧрд░рд┐рдПрдХреЛ рдореАрдареЛ рдЖрд▓реБ, рд░реЛрд╕реНрдЯ рдЧрд░рд┐рдПрдХреЛ рд╕рдЦрд░рдЦрдгреНрдб
ЁЯНв => ЁЯНв, рдУрдбреЗрди, рдХрдмрд╛рдм, рд╕рдореБрджреНрд░реА рдЦрд╛рдирд╛, рд╕реНрдХреНрд╡рд┐рд░, рд╕реНрдЯрд┐рдХ
ЁЯНг => ЁЯНг, рд╕реБрд╢реА
ЁЯНд => ЁЯНд, рдЯреЗрдореНрдкреБрд░рд╛, рдкреНрд░рд╛рдЙрди, рдлреНрд░рд╛рдЗ рдЧрд░реЗрдХреЛ, рдлреНрд░рд╛рдЗ рдЧрд░реЗрдХреЛ рд╕реНрд░рд┐рдореНрдк, рд╕реНрд░рд┐рдореНрдк
ЁЯНе => ЁЯНе, рдХреЗрдХ, рдкреЗрд╕реНрдЯреНрд░реА, рдорд╛рдЫрд╛, рд╕реНрд░реНрд╡рд┐рд▓, рд╕реНрд░реНрд╡рд┐рд▓ рд╕рд╣рд┐рддрдХреЛ рдлрд┐рд╕ рдХреЗрд╕
ЁЯНб => ЁЯНб, рдЬрд╛рдкрд╛рдирд┐рдЬ, рдбреНрдпрд╛рдЩреНрдЧреЛ, рдорд┐рдард╛рдИ, рдорд┐рдареЛ, рд╕реНрдХреЗрд╡реЗрдпрд░, рд╕реНрдЯрд┐рдХ
ЁЯеЯ => ЁЯеЯ, рдПрдореНрдкрд╛рдирд╛рдбрд╛, рдЧреНрдпреЛрдЬрд╛, рдЬрд┐рдпрд╛рдУрдЬреА, рдкрдЯрд╕реНрдЯрд┐рдХрд░, рдкрд┐рдПрд░реЛрдЧреА, рдмрд╛рдл рд╡рд╛ рддрд╛рддреЛ рдкрд╛рдиреАрдорд╛ рдЙрдорд╛рд▓реЗрд░ рдмрдирд╛рдЗрдПрдХреЛ рдкреАрдареЛрдХреЛ рдбрд▓реНрд▓реЛ рдЦрд╛рдиреЗрдХреБрд░рд╛
ЁЯеа => ЁЯеа, рдкреНрд░реЛрдлреЗрд╕реА, рдлрд░реНрдЪреБрди рдХреБрдХреА
ЁЯеб => ЁЯеб, рдУрдЗрд╕реНрдЯрд░ рдкреЗрд▓, рдмрдЯреНрдЯрд╛рдХреЛ рдЦрд╛рдиреЗрдХреБрд░рд╛
ЁЯНж => ЁЯНж, рдЖрдЗрд╕рдХреНрд░рд┐рдо, рдЖрдИрд╕, рдХреНрд░рд┐рдо, рдорд┐рдард╛рдИ, рдорд┐рдареЛ, рд╕рдлреНрдЯ, рд╕рдлреНрдЯ рдЖрдЗрд╕рдХреНрд░рд┐рдо
ЁЯНз => ЁЯНз, рдЖрдИрд╕, рддрдпрд╛рд░ рдкрд╛рд░рд┐рдПрдХреЛ рдЖрдЗрд╕ рдХреНрд░рд┐рдо, рдорд┐рдард╛рдИ, рдорд┐рдареЛ, рдореЛрдбрд┐рдПрдХреЛ
ЁЯНи => ЁЯНи, рдЖрдЗрд╕, рдЖрдЗрд╕ рдХреНрд░рд┐рдо, рдХреНрд░рд┐рдо, рдорд┐рдард╛рдИ, рдорд┐рдареЛ
ЁЯНй => ЁЯНй, рдбреЛрдирдЯ, рдорд┐рдард╛рдИ, рдорд┐рдареЛ
ЁЯНк => ЁЯНк, рдХреБрдХреА, рдорд┐рдард╛рдИ
ЁЯОВ => ЁЯОВ, рдХреЗрдХ, рдЬрдиреНрдо рджрд┐рди, рдЬрдиреНрдо рджрд┐рдирдХреЛ рдХреЗрдХ, рдкреЗрд╕реНрдЯреНрд░реА, рдорд┐рдард╛рдИ, рдорд┐рдареЛ, рд╕рдорд╛рд░реЛрд╣
ЁЯН░ => ЁЯН░, рдХрдЪреМрдбреА, рдХреЗрдХ, рдкреЗрд╕реНрдЯреНрд░реА, рдорд┐рдард╛рдИ, рдорд┐рдареЛ, рд╕реНрд▓рд╛рдЗрд╕рд▓
ЁЯез => ЁЯез, рдкреЗрд╕реНрдЯреНрд░реА, рдлрд┐рд▓рд┐рдЩ, рд╕рдореЛрд╕рд╛
ЁЯНл => ЁЯНл, рдЪрдХрд▓реЗрдЯ, рдЪрдХрд▓реЗрдЯ рдмрд╛рд░, рдмрд╛рд░, рдорд┐рдард╛рдИ, рдорд┐рдареЛ
ЁЯНм => ЁЯНм, рдХреНрдпрд╛рдгреНрдбреА, рдорд┐рдард╛рдИ, рдорд┐рдареЛ
ЁЯНн => ЁЯНн, рдХреНрдпрд╛рдиреНрдбреА, рдорд┐рдард╛рдИ, рдорд┐рдареЛ, рд▓рд╛рд▓рд┐рдкрдк
ЁЯНо => ЁЯНо, рдХрд╕реНрдЯрд░реНрдб, рдкрдбрд┐рдЩреН, рдорд┐рдард╛рдИ, рдорд┐рдареЛ
ЁЯНп => ЁЯНп, рднрд╛рдБрдбреЛ, рдорд╣, рдорд╣рдХреЛ рднрд╛рдБрдбреЛ, рдорд┐рдареЛ
ЁЯН╝ => ЁЯН╝, рджреВрдз, рдкрд┐рдЙрдиреЗ, рдмрдЪреНрдЪрд╛, рдмрдЪреНрдЪрд╛рдХреЛ рдмреЛрддрд▓, рдмреЛрддрд▓
ЁЯеЫ => ЁЯеЫ, рдЧрд┐рд▓рд╛рд╕, рджреВрдз, рджреВрдзрдХреЛ рдЧрд┐рд▓рд╛рд╕, рдкреЗрдп
тШХ => тШХ, рдХрдлреА, рдЪрд┐рдпрд╛, рддрд╛рддреЗрдХреЛ, рддрд╛рддреЛ, рддрд╛рддреЛ рдкреЗрдп рдкрджрд╛рд░реНрде, рдкрд┐рдЙрдиреЗ, рдмреЗрднрд░реЗрдЬ
ЁЯН╡ => ЁЯН╡, рдХрдк, рдЪрд┐рдпрд╛, рдЪрд┐рдпрд╛рдХрдк, рдирд╕рдореНрд╣рд╛рд▓рд┐рдиреЗ рдЪрд┐рдпрд╛рдХреЛ рдХрдк, рдкрд┐рдЙрдиреЗ, рдмреЗрднрд░реЗрдЬ
ЁЯН╢ => ЁЯН╢, рдХрдк, рдкрд┐рдЙрдиреЗ, рдмрд╛рд░, рдмреЗрднрд░реЗрдЬ, рдмреЛрддрд▓, рд╕реЗрдХ
ЁЯН╛ => ЁЯН╛, рдХрд░реНрдХ, рдкрдкрд┐рдЩреН, рдкрдкрд┐рдЩреН рдХрд░реНрдХрдХреЛ рд╕рд╛рде рдмреЛрддрд▓, рдкрд┐рдЙрдиреЗ, рдмрд╛рд░, рдмреЛрддрд▓
ЁЯН╖ => ЁЯН╖, рдЧрд┐рд▓рд╛рд╕, рдкрд┐рдЙрдиреЗ, рдмрд╛рд░, рдмреЗрднрд░реЗрдЬ, рд╡рд╛рдЗрди, рд╡рд╛рдЗрди рдЧрд┐рд▓рд╛рд╕
ЁЯН╕ => ЁЯН╕, рдХрдХрдЯреЗрд▓, рдХрдХрдЯреЗрд▓ рдЧрд┐рд▓рд╛рд╕, рдЧрд┐рд▓рд╛рд╕, рдкрд┐рдЙрдиреЗ, рдмрд╛рд░
ЁЯН╣ => ЁЯН╣, рдЙрд╖реНрдгрдкреНрд░рджреЗрд╢реАрдп, рдЙрд╖реНрдгрдкреНрд░рджреЗрд╢реАрдп рдкреЗрдп рдкрджреНрджрд╛рд░реНрде, рдкрд┐рдЙрдиреЗ, рдмрд╛рд░
ЁЯН║ => ЁЯН║, рдкрд┐рдЙрдиреЗ, рдмрд╛рд░, рдмрд┐рдпрд░, рдмрд┐рдпрд░рдХреЛ рдордЧ, рдордЧ
ЁЯН╗ => ЁЯН╗, рдмрдЬреНрдиреЗ, рдмрдЬреНрдиреЗ рдмрд┐рдпрд░рдХреЛ рдордЧрд╣рд░реВ, рдмрд╛рд░, рдмрд┐рдпрд░, рдордЧ
ЁЯеВ => ЁЯеВ, рдЙрддреНрд╕рд╡ рдордирд╛рдЙрдиреЗ, рдХреНрд▓рд┐рдЩреНрдХ, рдХреНрд▓рд┐рдЩреНрдХ рднрдПрдХрд╛ рдЧрд┐рд▓рд╛рд╕рд╣рд░реВ, рдЧрд┐рд▓рд╛рд╕, рдкреЗрдп
ЁЯеГ => ЁЯеГ, рдЧрд┐рд▓рд╛рд╕, рдЯрдореНрдмрд▓рд░, рдЯрдореНрдмрд▓рд░ рдЧрд┐рд▓рд╛рд╕, рдорджрд┐рд░рд╛, рд╢рдЯ, рд╣реНрд╡рд┐рд╕реНрдХреА
ЁЯед => ЁЯед, рдХрд╛рдЧрдЬ рд╡рд╛ рдкреНрд▓рд╛рд╕реНрдЯрд┐рдХрдХреЛ рдкрд╛рддрд▓реЛ рдирд▓реАрд╕рд╣рд┐рддрдХреЛ рдХрдк, рдЬреБрд╕, рд╕реЛрдбрд╛
ЁЯев => ЁЯев, рдЪрдкрд╕реНрдЯрд┐рдХ, рд╣реНрдпрд╛рд╕реА
ЁЯН╜ => ЁЯН╜, рдХрд╛рдБрдЯрд╛, рдЦрд╛рдирд╛ рдмрдирд╛рдЙрдиреЗ, рдЪрдХреНрдХреБ, рдерд╛рд▓рд╕рдБрдЧ рдЪрдХреНрдХреБ рд░ рдХрд╛рдБрдЯрд╛, рдкреНрд▓реЗрдЯ
ЁЯН┤ => ЁЯН┤, рдХрд╛рдБрдЯрд╛, рдЦрд╛рдирд╛ рдмрдирд╛рдЙрдиреЗ, рдЪрдХреНрдХреБ, рдЪрдХреНрдХреБ рд░ рдХрд╛рдБрдЯрд╛
ЁЯеД => ЁЯеД, рдЪрдореНрдЪрд╛, рдЯреЗрд╡рд▓рд╡реЗрдпрд░
ЁЯФк => ЁЯФк, рдЙрдкрдХрд░рдг, рдЪрдХреНрдХреБ, рдкрдХрд╛рдЙрдиреЗ рдХрд╛рд░реНрдп, рднрд╛рдиреНрд╕реЗ рдЪрдХреНрдХреБ, рд╣рддрд┐рдпрд╛рд░, рд╣реЛрдЪреЛ
ЁЯП║ => ЁЯП║, рдЖрдореНрдлреЛрд░рд╛, рдЙрдкрдХрд░рдг, рдПрдХреНрд╡рд╛рд░рд┐рдЕрд╕, рдЬрдЧ, рдЬреЛрдбрд┐рдпрд╛рдХ, рдкрдХрд╛рдЙрдиреЗ рдХрд╛рд░реНрдп, рдкреЗрдп, рд╣рддрд┐рдпрд╛рд░
ЁЯМН => ЁЯМН, рдЕрдлреНрд░рд┐рдХрд╛, рдкреГрдереНрд╡реА, рдпреВрд░реЛрдк, рдпреВрд░реЛрдк-рдЕрдлреНрд░реАрдХрд╛ рджреЗрдЦрд╛рдЗрдПрдХреЛ рд╡рд┐рд╢реНрд╡рдХреЛ рдорд╛рдирдЪрд┐рддреНрд░, рд╡рд┐рд╢реНрд╡, рд╕рдВрд╕рд╛рд░
ЁЯМО => ЁЯМО, рдЕрдореЗрд░рд┐рдХрд╛, рдЕрдореЗрд░рд┐рдХрд╛ рджреЗрдЦрд╛рдЙрдиреЗ рд╡рд┐рд╢реНрд╡рдХреЛ рдорд╛рдирдЪрд┐рддреНрд░, рдкреГрдереНрд╡реА, рд╡рд┐рд╢реНрд╡, рд╕рдВрд╕рд╛рд░
ЁЯМП => ЁЯМП, рдЕрд╕реНрдЯреНрд░реЗрд▓рд┐рдпрд╛, рдПрд╕рд┐рдпрд╛, рдПрд╕рд┐рдпрд╛-рдЕрд╕реНрдЯреНрд░реЗрд▓рд┐рдпрд╛ рджреЗрдЦрд╛рдЙрдиреЗ рд╡рд┐рд╢реНрд╡рдХреЛ рдорд╛рдирдЪрд┐рддреНрд░, рдкреГрдереНрд╡реА, рд╡рд┐рд╢реНрд╡, рд╕рдВрд╕рд╛рд░
ЁЯМР => ЁЯМР, рдкреГрдереНрд╡реА, рднреВ-рдордзреНрдп рд░реЗрдЦрд╛ рд╕рд╣рд┐рддрдХреЛ рд╡рд┐рд╢реНрд╡, рднреВрдордзреНрдп рд░реЗрдЦрд╛, рд╡рд┐рд╢реНрд╡
ЁЯЧ║ => ЁЯЧ║, рдирдХреНрд╕рд╛, рд╡рд┐рд╢реНрд╡, рд╡рд┐рд╢реНрд╡рдХреЛ рдирдХреНрд╕рд╛
ЁЯЧ╛ => ЁЯЧ╛, рдЬрд╛рдкрд╛рди, рдЬрд╛рдкрд╛рдирдХреЛ рдирдХреНрд╕рд╛, рдирдХреНрд╕рд╛
ЁЯПФ => ЁЯПФ, рдЪрд┐рд╕реЛ, рдкрд░реНрд╡рдд, рд╣рд┐рдЙрдБ, рд╣рд┐рдЙрдБрд▓реЗ-рдврд╛рдХреЗрдХреЛ рдкрд░реНрд╡рдд
тЫ░ => тЫ░, рд╣рд┐рдорд╛рд▓
ЁЯМЛ => ЁЯМЛ, рдЬреНрд╡рд╛рд▓рд╛рдореБрдЦреА, рдирд┐рд╕реНрдХрдиреЗ рдХрд╛рд░реНрдп, рдореМрдВрд╕рдо, рд╣рд┐рдорд╛рд▓
ЁЯЧ╗ => ЁЯЧ╗, рдлреБрдЬреА, рдлреБрдЬреА рд╣рд┐рдорд╛рд▓, рд╣рд┐рдорд╛рд▓
ЁЯПХ => ЁЯПХ, рдХреНрдпрд╛рдореНрдкрд┐рдЩ
ЁЯПЦ => ЁЯПЦ, рдЫрд╛рддрд╛, рдЫрд╛рддрд╛ рд░рд╛рдЦрд┐рдПрдХреЛ рд╕рдореБрджреНрд░реА рдХрд┐рдирд╛рд░рд╛, рд╕рдореБрджреНрд░реА рдХрд┐рдирд╛рд░рд╛
ЁЯПЬ => ЁЯПЬ, рдорд░реВрднреВрдорд┐
ЁЯПЭ => ЁЯПЭ, рдЯрд╛рдкреВ, рдорд░реВрднреВрдорд┐, рдорд░реВрднреВрдорд┐ рдЯрд╛рдкреВ
ЁЯПЮ => ЁЯПЮ, рдкрд╛рд░реНрдХ, рд░рд╛рд╖реНрдЯреНрд░рд┐рдп рдирд┐рдХреБрдЮреНрдЬ
ЁЯПЯ => ЁЯПЯ, рд░рдЩреНрдЧрд╢рд╛рд▓рд╛
ЁЯПЫ => ЁЯПЫ, рдирд┐рд░реНрдорд╛рдг, рд╢рд╛рд╕реНрддреНрд░реАрдп, рд╢рд╛рд╕реНрддреНрд░реАрдп рднрд╡рди
ЁЯПЧ => ЁЯПЧ, рдирд┐рд░реНрдорд╛рдг, рдирд┐рд░реНрдорд╛рдг рд╕рдВрд░рдЪрдирд╛, рд╕рдВрд░рдЪрдирд╛
ЁЯПШ => ЁЯПШ, рдШрд░, рдШрд░ рдирд┐рд░реНрдорд╛рдгрд╣рд░реВ, рдирд┐рд░реНрдорд╛рдгрд╣рд░реВ
ЁЯПЩ => ЁЯПЩ, рдирд┐рд░реНрдорд╛рдг, рд╕рд╣рд░, рд╕рд┐рдЯрд┐рд╕реНрдХреЗрдк
ЁЯПЪ => ЁЯПЪ, рдШрд░, рдбреЗрд░рд┐рд▓рд┐рдХреНрдЯ, рдбреЗрд░рд┐рд▓рд┐рдХреНрдЯ рдШрд░ рдирд┐рд░реНрдорд╛рдг, рднрд╡рди
ЁЯПа => ЁЯПа, рдЧреГрд╣, рдШрд░, рдШрд░ рдирд┐рд░реНрдорд╛рдг, рдирд┐рд░реНрдорд╛рдг
ЁЯПб => ЁЯПб, рдЧреГрд╣, рдШрд░, рдирд┐рд░реНрдорд╛рдг, рдмрдЧреИрдБрдЪрд╛, рдмрдЧреИрдБрдЪрд╛рд╕рд╣рд┐рддрдХреЛ рдШрд░
ЁЯПв => ЁЯПв, рдХрд╛рд░реНрдпрд╛рд▓рдп рднрд╡рди, рдирд┐рд░реНрдорд╛рдг
ЁЯПг => ЁЯПг, рдЬрд╛рдкрд╛рдирд┐рдЬ рд╣реБрд▓рд╛рдХ, рдЬрд╛рдкрд╛рдирд┐рд╕, рдирд┐рд░реНрдорд╛рдг, рд╣реБрд▓рд╛рдХ
ЁЯПд => ЁЯПд, рдирд┐рд░реНрдорд╛рдг, рдпреВрд░реЛрдкрд┐рдпрди, рд╣реБрд▓рд╛рдХ
ЁЯПе => ЁЯПе, рдФрд╖рдзрд┐, рдбрдХреНрдЯрд░, рдирд┐рд░реНрдорд╛рдг, рд╣рд╕реНрдкрд┐рдЯрд▓
ЁЯПж => ЁЯПж, рдирд┐рд░реНрдорд╛рдг, рдмреИрдЩреНрдХ
ЁЯПи => ЁЯПи, рдирд┐рд░реНрдорд╛рдг, рд╣реЛрдЯреЗрд▓
ЁЯПй => ЁЯПй, рдирд┐рд░реНрдорд╛рдг, рд▓рдн, рд▓рдн рд╣реЛрдЯреЗрд▓, рд╣реЛрдЯреЗрд▓
ЁЯПк => ЁЯПк, рдирд┐рд░реНрдорд╛рдг, рд╕реБрд╡рд┐рдзрд╛рдЬрдирдХ, рд╕реБрд╡рд┐рдзрд╛рдЬрдирдХ рд╕реНрдЯреЛрд░, рд╕реНрдЯреЛрд░
ЁЯПл => ЁЯПл, рдирд┐рд░реНрдорд╛рдг, рд╕реНрдХреВрд▓
ЁЯПм => ЁЯПм, рдбрд┐рдкрд╛рд░реНрдЯрдореЗрдиреНрдЯрд▓, рдбрд┐рдкрд╛рд░реНрдЯрдореЗрдиреНрдЯрд▓ рд╕реНрдЯреЛрд░, рдирд┐рд░реНрдорд╛рдг, рд╕реНрдЯреЛрд░
ЁЯПн => ЁЯПн, рдирд┐рд░реНрдорд╛рдг, рдлреНрдпрд╛рдХреНрдЯреНрд░реА
ЁЯПп => ЁЯПп, рдХреНрдпрд╛рд╕реНрдЯрд▓, рдЬрд╛рдкрд╛рдиреА, рдЬрд╛рдкрд╛рдиреА рдХреНрдпрд╛рд╕реНрдЯрд▓, рдирд┐рд░реНрдорд╛рдг
ЁЯП░ => ЁЯП░, рдХреНрдпрд╛рд╕реНрдЯрд▓, рдирд┐рд░реНрдорд╛рдг
ЁЯТТ => ЁЯТТ, рдХреЗрдкрд▓, рдордиреЛрд░рдиреНрдЬрди, рд╡рд┐рд╡рд╛рд╣
ЁЯЧ╝ => ЁЯЧ╝, рдЯрд╛рд╡рд░, рдЯреЛрдХрд┐рдпреЛ, рдЯреЛрдХрд┐рдпреЛрдХреЛ рдЯрд╛рд╡рд░
ЁЯЧ╜ => ЁЯЧ╜, рдкреНрд░рддрд┐рдорд╛, рд╕реНрд╡рддрдиреНрддреНрд░рддрд╛, рд╕реНрд╡рддрдиреНрддреНрд░рддрд╛рдХреЛ рдкреНрд░рддрд┐рдорд╛
тЫк => тЫк, рдХреНрд░рд╕, рдХреНрд░рд┐рд╕реНрдЪрд┐рдпрди, рдЧрд┐рд░реНрдЬрд╛рдШрд░, рдзрд░реНрдо, рдирд┐рд░реНрдорд╛рдг
ЁЯХМ => ЁЯХМ, рдЗрд╕реНрд▓рд╛рдо, рдзрд░реНрдо, рдорд╕реНрдЬрд┐рдж, рдореБрд╕реНрд▓рд┐рдо
ЁЯХН => ЁЯХН, рдЖрд░рд╛рдзрдирд╛рд▓рдп, рдзрд░реНрдо, рдкреБрдЬрдирд┐рдп рд╕реНрдерд▓, рдордиреНрджрд┐рд░
тЫй => тЫй, рдШрд░реНрдо, рддреАрд░реНрде, рд╢рд┐рдиреНрддреЛ, рд╢рд┐рдиреНрддреЛ рдзрд░реНрдордХреЛ рддреАрд░реНрде
ЁЯХЛ => ЁЯХЛ, рдЗрд╕реНрд▓рд╛рдо, рдХрд╛рдмрд╛, рдзрд░реНрдо, рдореБрд╕реНрд▓рд┐рдо
тЫ▓ => тЫ▓, рдЭрд░рдгрд╛
тЫ║ => тЫ║, рдХреНрдпрд╛рдореНрдкрд┐рдЩ, рдЯреЗрдиреНрдЯ
ЁЯМБ => ЁЯМБ, рдзрдорд┐рд▓реЛ, рдореМрд╕рдо, рд╣реБрд╕реНрд╕реБ рд▓рд╛рдЧреЗрдХреЛ
ЁЯМГ => ЁЯМГ, рддрд╛рд░рд╛, рддрд╛рд░рд╛рд╣рд░реВ рдЪрдореНрдХреЗрдХреЛ рд░рд╛рдд, рдореМрд╕рдо, рд░рд╛рдд
ЁЯМД => ЁЯМД, рдкрд░реНрд╡рдд, рдкрд░реНрд╡рддрд╣рд░реВрдорд╛ рд╕реВрд░реНрдпреЛрджрдп, рдмрд┐рд╣рд╛рдиреА, рдореМрд╕рдо, рд╕реВрд░реНрдп, рд╕реВрд░реНрдпреЛрджрдп
ЁЯМЕ => ЁЯМЕ, рдмрд┐рд╣рд╛рдиреА, рдореМрд╕рдо, рд╕реВрд░реНрдп, рд╕реВрд░реНрдпреЛрджрдп
ЁЯМЖ => ЁЯМЖ, рдЧреЛрдзреВрд▓реА рд╕рдордпрдХреЛ рд╕рд┐рдЯрд┐рд╕реНрдХреЗрдк, рд╕рд┐рдЯрд┐рд╕реНрдХреЗрдкрдХреЛ рдЧреЛрдзреВрд▓реА рд╕рдордп
ЁЯМЗ => ЁЯМЗ, рдбрд╕реНрдХ, рдирд┐рд░реНрдорд╛рдг, рдореМрд╕рдо, рд╕реВрд░реНрдп, рд╕реВрд░реНрдпрд╛рд╕реНрдд
ЁЯМЙ => ЁЯМЙ, рджреБрд▓рд╣реА, рдореМрд╕рдо, рд░рд╛рдд, рд░рд╛рддрдХреЛ рд╕рдордпрдорд╛ рдкреВрд▓
тЩи => тЩи, рддрд╛рддреЗрдХреЛ, рддрд╛рддреЛ, рддрд╛рддреЛ рд╕реНрдкреНрд░рд┐рдЩреН, рддрд╛рддреЛрд╕реНрдкреНрд░рд┐рдЩреН, рд╕реНрдкреНрд░рд┐рдЩреН
ЁЯММ => ЁЯММ, рдЖрдХрд╛рд╢рдЧрдВрдЧрд╛, рдореМрд╕рдо
ЁЯОа => ЁЯОа, рдХрд░рд╛рдЙрдЬреЗрд▓, рдХрд╛рд░рд╛рдЙрдЬреЗрд▓ рдШреЛрдбрд╛, рдШреЛрдбрд╛
ЁЯОб => ЁЯОб, рдЪрдХреНрд░, рдлреЗрд░реНрд░рд┐рд╕, рдлреЗрд░реНрд░рд┐рд╕ рдЪрдХреНрд░, рдордиреЛрд░рдЮреНрдЬрди рдкрд╛рд░реНрдХ
ЁЯОв => ЁЯОв, рдХреЛрд╕реНрдЯрд░, рдордиреЛрд░рдЮреНрдЬрди рдкрд╛рд░реНрдХ, рд░реЛрд▓рд░ рдХреЛрд╕реНрдЯрд░, рд░реЛрд▓реНрд▓рд░
ЁЯТИ => ЁЯТИ, рдХрдкрд╛рд▓ рдХрдЯрд╛рдЗ, рдЦрдореНрдмрд╛, рд╣рдЬрд╛рдо, рд╣рдЬрд╛рдордХреЛ рдЦрдореНрдмрд╛
ЁЯОк => ЁЯОк, рдкрд╛рд▓, рд╕рд░реНрдХрд╕, рд╕рд░реНрдХрд╕рдХреЛ рдкрд╛рд▓
ЁЯОн => ЁЯОн, рдХрд▓рд╛, рдХрд▓рд╛ рдкреНрд░рджрд░реНрд╢рди рдЧрд░реНрджреИ, рдирд╛рдЪрдШрд░, рдирд╛рдЯрдХ рдкреНрд░рд╣рд╕рди рдШрд░, рдкреНрд░рджрд░реНрд╢рди рдЧрд░реНрджреИ, рдорд╛рд╕реНрдХ
ЁЯЦ╝ => ЁЯЦ╝, рдХрд▓рд╛, рдЪрд┐рддреНрд░, рдЫрд╛рдЙрдиреА, рддрд╕реНрдмрд┐рд░, рдлреНрд░реЗрдо, рдлреНрд░реЗрдордХрд╛ рд╕рд╛рде рдЪрд┐рддреНрд░
ЁЯОи => ЁЯОи, рдХрд▓рд╛, рдХрд▓рд╛рдХрд╛рд░рдХреЛ рдкреНрдпрд╛рд▓реЗрдЯ, рдЪрд┐рддреНрд░, рдЫрд╛рдЙрдиреА, рдкреНрдпрд╛рд▓реЗрдЯ
ЁЯО░ => ЁЯО░, рдЦреЗрд▓, рд╕реНрд▓рдЯ, рд╕реНрд▓реНрдЯ рдпрдиреНрддреНрд░
ЁЯЪВ => ЁЯЪВ, рдЗрдЮреНрдЬрд┐рди, рдЧрд╛рдбреА, рд░реЗрд▓, рд░реЗрд▓рдорд╛рд░реНрдЧ, рд▓реЛрдХреЛрдореЛрдЯрд┐рдн, рд╡рд╛рдл
ЁЯЪГ => ЁЯЪГ, рд░реЗрдХрд╡реЗ рдХрд╛рд░, рд░реЗрд▓рд╡реЗ рдХрд╛рд░
ЁЯЪД => ЁЯЪД, рдЙрдЪреНрдЪ-рдЧрддрд┐рдХреЛ рд░реЗрд▓, рдЧрддрд┐, рдЧрд╛рдбреА, рд░реЗрд▓, рд░реЗрд▓рдорд╛рд░реНрдЧ, рд╢рд┐рдВрдХрд╛рдиреНрд╕реЗрди
ЁЯЪЕ => ЁЯЪЕ, рдЧрддрд┐, рдЧрд╛рдбреА, рдЧреЛрд▓реА, рдЪреБрдЪреНрдЪреЛ рдЕрдЧреНрд░рднрд╛рдЧ рднрдПрдХреЛ рдЙрдЪреНрдЪ-рдЧрддрд┐рдХреЛ рд░реЗрд▓, рд░реЗрд▓, рд░реЗрд▓рдорд╛рд░реНрдЧ, рд╢рд┐рдВрдХрд╛рдиреНрд╕реЗрди
ЁЯЪЖ => ЁЯЪЖ, рдЧрд╛рдбреА, рд░реЗрд▓, рд░реЗрд▓рдорд╛рд░реНрдЧ
ЁЯЪЗ => ЁЯЪЗ, рдЧрд╛рдбреА, рдореЗрдЯреНрд░реЛ, рд╕рд╡рд╡реЗ
ЁЯЪИ => ЁЯЪИ, рдЧрд╛рдбреА, рд░реЗрд▓рд╡реЗ, рд╣рд▓реНрдХрд╛ рд░реЗрд▓
ЁЯЪЙ => ЁЯЪЙ, рдЧрд╛рдбреА, рдЯреНрд░реЗрди, рд░реЗрд▓рд╡реЗ, рд╕реНрдЯреЗрд╢рди
ЁЯЪК => ЁЯЪК, рдЧрд╛рдбреА, рдЯреНрд░рд▓рд┐рдмрд╕, рдЯреНрд░рд╛рдо
ЁЯЪЭ => ЁЯЪЭ, рдЧрд╛рдбреА, рдореЛрдиреЛрд░реЗрд▓
ЁЯЪЮ => ЁЯЪЮ, рдХрд╛рд░, рдЧрд╛рдбреА, рдкрд░реНрд╡рддреАрдп, рдкрд░реНрд╡рддреАрдп рд░реЗрд▓рд╡реЗ, рд░реЗрд▓рд╡реЗ
ЁЯЪЛ => ЁЯЪЛ, рдХрд╛рд░, рдЧрд╛рдбреА, рдЯреНрд░рд▓рд┐рдмрд╕, рдЯреНрд░рд╛рдо, рдЯреНрд░рд╛рдо рдХрд╛рд░
ЁЯЪМ => ЁЯЪМ, рдЧрд╛рдбреА, рдмрд╕
ЁЯЪН => ЁЯЪН, рдЖрдЙрдБрджреИ рдЧрд░реЗрдХреЛ, рдЖрдЙрдБрджреИ рдЧрд░реЗрдХреЛ рдмрд╕, рдЧрд╛рдбреА, рдмрд╕
ЁЯЪО => ЁЯЪО, рдЧрд╛рдбреА, рдЯреНрд░рд▓рд┐, рдЯреНрд░рд▓рд┐рдмрд╕, рдЯреНрд░рд╛рдо, рдмрд╕
ЁЯЪР => ЁЯЪР, рдЧрд╛рдбреА, рдмрд╕, рдорд┐рдирд┐рдмрд╕
ЁЯЪС => ЁЯЪС, рдПрдореНрдмреБрд▓реЗрдиреНрд╕, рдЧрд╛рдбреА
ЁЯЪТ => ЁЯЪТ, рдЖрдЧреЛ, рдЗрдиреНрдЬрд┐рди, рдЧрд╛рдбреА, рдЯреНрд░рдХ, рдлрд╛рдпрд░ рдЗрдиреНрдЬрд┐рди
ЁЯЪУ => ЁЯЪУ, рдХрд╛рд░, рдЧрд╛рдбреА, рдкреБрд▓рд┐рд╕, рдкреБрд▓рд┐рд╕ рдХрд╛рд░, рдкреЗрдЯреНрд░реЛрд▓
ЁЯЪФ => ЁЯЪФ, рдЖрдЙрдБрджреИ рдЧрд░реЗрдХреЛ, рдЖрдЙрдБрджреИ рдЧрд░реЗрдХреЛ рдкреБрд▓рд┐рд╕ рдХрд╛рд░, рдХрд╛рд░, рдЧрд╛рдбреА, рдкреБрд▓рд┐рд╕
ЁЯЪХ => ЁЯЪХ, рдЧрд╛рдбреА, рдЯреНрдпрд╛рдХреНрд╕реА
ЁЯЪЦ => ЁЯЪЦ, рдЖрдЗрд░рд╣реЗрдХреЛ, рдЖрдЙрдБрджреИ рдЧрд░реЗрдХреЛ рдЯреНрдпрд╛рдХреНрд╕реА, рдЯреНрдпрд╛рдХреНрд╕реА
ЁЯЪЧ => ЁЯЪЧ, рдЕрдЯреЛрдореЛрдмрд╛рдЗрд▓, рдХрд╛рд░, рдЧрд╛рдбреА
ЁЯЪШ => ЁЯЪШ, рдЕрдЯреЛрдореЛрдмрд╛рдЗрд▓, рдЖрдЗрд░рд╣реЗрдХреЛ, рдЖрдЙрдБрджреИ рдЧрд░реЗрдХреЛ рдЕрдЯреЛрдореЛрдмрд╛рдЗрд▓, рдХрд╛рд░, рдЧрд╛рдбреА
ЁЯЪЩ => ЁЯЪЩ, рдЧрд╛рдбреА, рдШреБрдордлрд┐рд░рдХреЛ рд▓рд╛рдЧрд┐ рд╕рд╡рд╛рд░реА, рдкреБрдирдГ рдмрдирд╛рдЙрдиреЗ, рдкреБрдирдГрдмрдирд╛рдЙрдиреЗ рдЧрд╛рдбреА
ЁЯЪЪ => ЁЯЪЪ, рдЧрд╛рдбреА, рдЯреНрд░рдХ, рдбрд┐рд▓рд┐рд╡рд░реА, рдвреБрд╡рд╛рдиреАрдХрд╛ рд▓рд╛рдЧрд┐ рдЯреНрд░рдХ
ЁЯЪЫ => ЁЯЪЫ, рдЕрд░реНрдз, рдЧрд╛рдбреА, рдЯреНрд░рдХ, рд▓рд░реА
ЁЯЪЬ => ЁЯЪЬ, рдЧрд╛рдбреА, рдЯреНрд░рдпрд╛рдХреНрдЯрд░
ЁЯЪ▓ => ЁЯЪ▓, рдЧрд╛рдбреА, рдмрд╛рдЗрдХ, рд╕рд╛рдЗрдХрд▓
ЁЯЫ┤ => ЁЯЫ┤, рдХрд┐рдХ, рдХрд┐рдХ рд╕реНрдХреБрдЯрд░, рд╕реНрдХреБрдЯрд░
ЁЯЫ╡ => ЁЯЫ╡, рдореЛрдЯрд░, рдореЛрдЯрд░ рд╕реНрдХреБрдЯрд░, рд╕реНрдХреБрдЯрд░
ЁЯЪП => ЁЯЪП, рдмрд╕, рдмрд╕ рдмрд┐рд╕реМрдВрдиреА, рдмрд╕рд░реЛрдХреНрдиреЗ, рд░реЛрдХреНрди
ЁЯЫг => ЁЯЫг, рдореЛрдЯрд░рдХреЛ рдмрд╛рдЯреЛ, рд░рд╛рдЬрдорд╛рд░реНрдЧ, рд╕рдбрдХ
ЁЯЫд => ЁЯЫд, рдЯреНрд░реЗрди, рд░реЗрд▓рд╡реЗ, рд░реЗрд▓рд╡реЗ рдЯреНрд░рдпрд╛рдХ
тЫ╜ => тЫ╜, рдЗрдиреНрдзрди, рдЗрдиреНрдзрдирдХреЛ рдкрдореНрдк, рдЗрдиреНрдзрдирдкрдореНрдк, рдЧреНрдпрд╛рдБрд╕, рдкрдореНрдк, рд╕реНрдЯреЗрд╢рди
ЁЯЪи => ЁЯЪи, рдХрд╛рд░, рдЧрд╛рдбреА, рдШреБрдорд┐рд░рд╣реЗрдХреЛ, рдкреНрд░рд╣рд░реА, рдкреНрд░рд╣рд░реАрдХреЛ рдЧрд╛рдбреАрдХреЛ рдмрддреНрддреА, рдмреЗрдХрди, рд╣рд▓реНрдХрд╛
ЁЯЪе => ЁЯЪе, рдЯреНрд░рд╛рдлрд┐рдХ, рддреЗрд░реНрд╕реЛ рдЯреНрд░рд╛рдлрд┐рдХ рд▓рд╛рдЗрдЯ, рдкреНрд░рдХрд╛рд╢, рд╕рдВрдХреЗрдд
ЁЯЪж => ЁЯЪж, рдЯреНрд░рд╛рдлрд┐рдХ, рдард╛рдбреЛ рдЯреНрд░рд╛рдлрд┐рдХ рд▓рд╛рдЗрдЯ, рдкреНрд░рдХрд╛рд╢, рд╕рдВрдХреЗрдд
ЁЯЪз => ЁЯЪз, рдЕрд╡рд░реЛрдз, рдирд┐рд░реНрдорд╛рдг
ЁЯЫС => ЁЯЫС, рдЕрд╖реНрдарднреБрдЬ, рд░реЛрдХреНрдиреЗ, рд░реЛрдХреНрдиреЗ рд╕рдВрдХреЗрдд, рд╕рдВрдХреЗрдд
тЪУ => тЪУ, рдПрдЩреНрдХрд░, рдЬрд╣рд╛рдб, рд╕рд╛рдзрди
тЫ╡ => тЫ╡, рдЦреЛрд▓рд╛, рдЧрд╛рдбреА, рдбреБрдЩреНрдЧрд╛, рдпрд╛рдЪреНрдЯ, рд░реЗрд╕реЛрд░реНрдЯ, рд╕реЗрд▓рдмреЛрдЯ
ЁЯЫ╢ => ЁЯЫ╢, рдХреНрдпрд╛рдиреЛ, рдбреБрдЩреНрдЧрд╛
ЁЯЪд => ЁЯЪд, рдЧрд╛рдбреА, рдбреБрдЩреНрдЧрд╛, рд╕реНрдкрд┐рдбрдмреЛрдЯ
ЁЯЫ│ => ЁЯЫ│, рдЧрд╛рдбреА, рдЬрд╣рд╛рдЬ, рдпрд╛рддреНрд░реА, рдпрд╛рддреНрд░реА рдЬрд╣рд╛рдЬ
тЫ┤ => тЫ┤, рдбреБрдЩреНрдЧрд╛, рдлреЗрд░реА
ЁЯЫе => ЁЯЫе, рдЧрд╛рдбреА, рдбреБрдЩреНрдЧрд╛, рдореЛрдЯрд░ рдбреБрдЩреНрдЧрд╛, рдореЛрдЯрд░рдмреЛрдЯ
ЁЯЪв => ЁЯЪв, рдЧрд╛рдбреА, рдкрд╛рдиреА рдЬрд╣рд╛рдЬ
тЬИ => тЬИ, рдЧрд╛рдбреА, рдмрд┐рдорд╛рди
ЁЯЫй => ЁЯЫй, рдЧрд╛рдбреА, рд╕рд╛рдиреЛ рдмрд┐рдорд╛рди, рд╣рд╡рд╛рдЗрдЬрд╣рд╛рдЬ
ЁЯЫл => ЁЯЫл, рдЧрд╛рдбреА, рдЪреЗрдХ-рдЗрди, рдкреНрд░рд╕реНрдерд╛рди, рдкреНрд░рд╕реНрдерд╛рдирд╣рд░реВ, рд╣рд╡рд╛рдЗрдЬрд╣рд╛рдЬ, рд╣рд╡рд╛рдЗрдЬрд╣рд╛рдЬрдХреЛ рдкреНрд░рд╕реНрдерд╛рди
ЁЯЫм => ЁЯЫм, рдЕрд╡рддрд░рдг рдЧрд░реНрджреИ, рдЖрдЙрдБрджреИ, рдЖрдЧрдорди, рдЧрд╛рдбреА, рд╣рд╡рд╛рдЗрдЬрд╣рд╛рдЬ, рд╣рд╡рд╛рдЗрдЬрд╣рд╛рдЬрдХреЛ рдЖрдЧрдорди
ЁЯТ║ => ЁЯТ║, рдХреБрд░реНрд╕реА, рдмрд╕реНрдиреЗ рд╕рд┐рдЯ
ЁЯЪБ => ЁЯЪБ, рдЧрд╛рдбреА, рд╣реЗрд▓рд┐рдХрдкреНрдЯрд░
ЁЯЪЯ => ЁЯЪЯ, рдЧрд╛рдбреА, рдирд┐рд▓рдореНрдмрди, рд░реЗрд▓рд╡реЗ, рд╕рд╕реНрдкреЗрдиреНрд╕рди рд░реЗрд▓рд╡реЗ
ЁЯЪа => ЁЯЪа, рдХреЗрдмрд▓, рдЧрд╛рдбреА, рдЧреЛрдиреНрдбреЛрд▓рд╛, рдкрд░реНрд╡рддреАрдп, рдкрд░реНрд╡рддреАрдп рдХреЗрдмрд▓рд╡реЗ
ЁЯЪб => ЁЯЪб, рдПрд░рд┐рдпрд▓, рдПрд░рд┐рдпрд▓ рдЯреНрд░рд╛рдорд╡реЗ, рдХрд╛рд░, рдХреЗрдмрд▓, рдЧрд╛рдбреА, рдЧреЛрдиреНрдбреЛрд▓рд╛, рдЯреНрд░рд╛рдорд╡реЗ, рд░реЛрдкрд╡реЗ
ЁЯЫ░ => ЁЯЫ░, рдЧрд╛рдбреА, рдард╛рдЙрдБрдБ, рд╕реНрдпрд╛рдЯреЗрд▓рд╛рдЗрдЯ
ЁЯЪА => ЁЯЪА, рдЧрд╛рдбреА, рдард╛рдЙрдБ, рд░рдХреЗрдЯ
ЁЯЫ╕ => ЁЯЫ╕, рдЙрдбреНрдиреЗ рдерд╛рд▓реА рдЖрдХрд╛рд░рдХреЛ рдпрд╛рди, рдпреБрдПрдлрдУ
ЁЯЫО => ЁЯЫО, рдмреЗрд▓, рдмреЗрд▓рд╣рдк, рдмреЗрд▓рд╣рдк рдШрдиреНрдЯреА, рд╣реЛрдЯреЗрд▓
ЁЯЪк => ЁЯЪк, рдвреЛрдХрд╛
ЁЯЫП => ЁЯЫП, рдЦрд╛рдЯ, рд╕реБрддреНрдиреЗ, рд╣реЛрдЯреЗрд▓
ЁЯЫЛ => ЁЯЫЛ, рдХрдЙрдЪ, рдХрдЙрдЪ рд░ рдмрддреНрддреА, рдмрддреНрддреА, рд╣реЛрдЯреЗрд▓
ЁЯЪ╜ => ЁЯЪ╜, рдЪрд░реНрдкреА
ЁЯЪ┐ => ЁЯЪ┐, рдиреБрд╣рд╛рдЙрдиреЗ, рдкрд╛рдиреА
ЁЯЫБ => ЁЯЫБ, рдмрд╛рде, рдмрд╛рдердЯрдм
тМЫ => тМЫ, рдЯрд╛рдЗрдорд░, рд░реЗрдд, рд░реЗрддрдХреЛ рдШрдбреА
тП│ => тП│, рдЯрд╛рдЗрдорд░, рдмрд╛рд▓реБрд╡рд╛рдХреЛ рдкреНрд░рд╡рд╛рд╣, рдмрд╛рд▓реБрд╡рд╛рдХреЛ рдкреНрд░рд╡рд╛рд╣рд╕рд╣рд┐рдд рд░реЗрддрдХреЛ рдШрдбреА, рд░реЗрдд
тМЪ => тМЪ, рдШрдбреА
тП░ => тП░, рдЕрд░реНрд▓рд╛рдо, рдЕрд░реНрд▓рд╛рдо рдШрдбреА, рдШрдбреА
тП▒ => тП▒, рдШрдбреА, рд╕реНрдЯрдкрд╡рд╛рдЪ
тП▓ => тП▓, рдШрдбреА, рдЯрд╛рдЗрдорд░, рдЯрд╛рдЗрдорд░ рдШрдбреА
ЁЯХ░ => ЁЯХ░, рдШрдбреА, рдореНрдпрд╛рдирдЯреЗрд▓рдкрд┐рд╕рдХреЛ рдШрдбреА
ЁЯХЫ => ЁЯХЫ, режреж, резреи, резреи:режреж, рдмрд╛рд╣реНрд░ рдмрдЬреЗ
ЁЯХз => ЁЯХз, резреи, резреи:рейреж, рейреж, рдмрд╛рд╣реНрд░-рддреАрд╕
ЁЯХР => ЁЯХР, режреж, рез, рез:режреж, рдПрдХ рдмрдЬреЗ
ЁЯХЬ => ЁЯХЬ, рез, рез:рейреж, рейреж, рдПрдХ, рдПрдХ-рддреАрд╕, рддреАрд╕
ЁЯХС => ЁЯХС, режреж, реи, реи:режреж, рджреБрдИ рдмрдЬреЗ
ЁЯХЭ => ЁЯХЭ, реи, реи:рейреж, рейреж, рджреБрдИ-рддреАрд╕
ЁЯХТ => ЁЯХТ, режреж, рей:рей:рейреж, рддреАрди рдмрдЬреЗ
ЁЯХЮ => ЁЯХЮ, рей, рей:рейреж, рейреж, рддреАрди-рддреАрд╕
ЁЯХУ => ЁЯХУ, режреж, рек, рек:режреж, рдЪрд╛рд░ рдмрдЬреЗ
ЁЯХЯ => ЁЯХЯ, рейреж, рек, рек:рейреж, рдЪрд╛рд░-рддреАрд╕
ЁЯХФ => ЁЯХФ, режреж, рел, рел:режреж, рдкрд╛рдБрдЪ рдмрдЬреЗ
ЁЯХа => ЁЯХа, рейреж, рел, рел:рейреж, рдкрд╛рдБрдЪ-рддреАрд╕
ЁЯХХ => ЁЯХХ, режреж, рем, рдЫ рдмрдЬреЗ
ЁЯХб => ЁЯХб, рейреж, рем, рем:рейреж, рдЫ-рддреАрд╕
ЁЯХЦ => ЁЯХЦ, режреж, рен, рен:режреж, рд╕рд╛рдд рдмрдЬреЗ
ЁЯХв => ЁЯХв, рейреж, рен, рен:рейреж, рд╕рд╛рдд-рддреАрд╕
ЁЯХЧ => ЁЯХЧ, режреж, рео, рео:режреж, рдЖрда рдмрдЬреЗ
ЁЯХг => ЁЯХг, рейреж, рео, рео:рейреж, рдЖрда-рддреАрд╕
ЁЯХШ => ЁЯХШ, режреж, реп, реп:режреж, рдиреМ рдмрдЬреЗ
ЁЯХд => ЁЯХд, рейреж, реп, реп:рейреж, рдиреМ-рддреАрд╕
ЁЯХЩ => ЁЯХЩ, режреж, резреж, резреж:режреж, рджрд╢ рдмрдЬреЗ
ЁЯХе => ЁЯХе, резреж, резреж:рейреж, рейреж, рджрд╢-рддреАрд╕
ЁЯХЪ => ЁЯХЪ, режреж, резрез, резрез:режреж, рдПрдШрд╛рд░ рдмрдЬреЗ
ЁЯХж => ЁЯХж, резрез:резрез:рейреж:рейреж, рдПрдзрд╛рд░-рддреАрд╕
ЁЯМС => ЁЯМС, рдЕрдБрдзреНрдпрд╛рд░реЛ, рдЖрдХрд╛рд╢рдЧрдВрдЧрд╛, рдФрдВрд╕реА, рдЪрдиреНрджреНрд░рдорд╛, рдореМрд╕рдо
ЁЯМТ => ЁЯМТ, рдХреНрд░реЗрд╕реЗрдиреНрдЯ, рдЪрдиреНрджреНрд░рдорд╛, рдард╛рдЙрдБ, рдмрдвреНрджреЛ, рдмрдвреНрджреЛ рдЪрдиреНрджреНрд░рдорд╛, рдореМрдВрд╕рдо
ЁЯМУ => ЁЯМУ, рдПрдХ рдЪреМрдВрдерд╛рдЗ, рдЪрдиреНрджреНрд░рдорд╛, рдард╛рдЙрдБ, рдкрд╣рд┐рд▓реЛ рдкрдХреНрд╖реАрдп рдЪрдиреНрджреНрд░рдорд╛, рдореМрдВрд╕рдо
ЁЯМФ => ЁЯМФ, рдЧрд┐рдмрд╕, рдЪрдиреНрджреНрд░рдорд╛, рдард╛рдЙрдБ, рдмрдвреНрджреЛ, рдмрдвреНрджреЛ рдЧрд┐рдмрд╕ рдЪрдиреНрджреНрд░рдорд╛, рдореМрдВрд╕рдо
ЁЯМХ => ЁЯМХ, рдЖрдХрд╛рд╢рдЧрдВрдЧрд╛, рдкреВрд░рд╛, рдкреВрд░реНрдгрд┐рдорд╛, рдореМрд╕рдо
ЁЯМЦ => ЁЯМЦ, рдЧрд┐рдмрд╕, рдШрдЯреНрджреЛ, рдШрдЯреНрджреЛ рдЧрд┐рдмрд╕ рдЪрдиреНрджреНрд░рдорд╛, рдЪрдиреНрджреНрд░реНрдорд╛, рдард╛рдЙрдБ, рдореМрдВрд╕рдо
ЁЯМЧ => ЁЯМЧ, рдЕрдиреНрддрд┐рдо рдкрдХреНрд╖реАрдп рдЪрдиреНрджреНрд░рдорд╛, рдПрдХ рдЪреМрдВрдерд╛рдЗ, рдЪрдиреНрджреНрд░рдорд╛, рдард╛рдЙрдБ, рдореМрдВрд╕рдо
ЁЯМШ => ЁЯМШ, рдХреНрд░реЗреЗрд╕реЗрдиреНрдЯ, рдШрдЯреНрджреЛ, рдШрдЯреНрджреЛ рдХреНрд░реЗрд╕реЗрдиреНрдЯ рдЪрдиреНрджреНрд░рдорд╛, рдЪрдиреНрджреНрд░рдорд╛, рдард╛рдЙрдБ, рдореМрдВрд╕рдо
ЁЯМЩ => ЁЯМЩ, рдХреНрд░реЗрд╕реЗрдиреНрдЯ рдЪрдиреНрджреНрд░рдорд╛, рдХреНрд░реЗрд╕реЗреЗрдиреНрдЯ, рдЪрдиреНрджреНрд░рдорд╛, рдард╛рдЙрдБ, рдореМрдВрд╕рдо
ЁЯМЪ => ЁЯМЪ, рдФрдВрд╕реАрдХреЛ рдЪрдиреНрджреНрд░рдорд╛рдХреЛ рд╕реНрд╡рд░реВрдк, рдЪрдиреНрджреНрд░рдорд╛рдХреЛ рд╕реНрд╡рд░реВрдк
ЁЯМЫ => ЁЯМЫ, рдЕрдиреБрд╣рд╛рд░, рдЕрдиреБрд╣рд╛рд░рдХреЛ рдЖрдХреГрддрд┐ рднрдПрдХреЛ рдкрд╣рд┐рд▓реЛ рдкрдХреНрд╖реАрдп рдЪрдиреНрджреНрд░рдорд╛, рдПрдХ рдЪреМрдВрдерд╛рдЗ, рдЪрдиреНрджреНрд░рдорд╛, рдард╛рдЙрдБ, рдореМрдВрд╕рдо
ЁЯМЬ => ЁЯМЬ, рдЕрдиреБрд╣рд╛рд░, рдЕрдиреБрд╣рд╛рд░рдХреЛ рдЖрдХреГреГрддрд┐ рднрдПрдХреЛ рдЕрдиреНрддрд┐рдо рдкрдХреНрд╖реАрдп рдЪрдиреНрджреНрд░рдорд╛, рдПрдХ рдЪреМрдВрдерд╛рдЗ, рдЪрдиреНрджреНрд░рдорд╛, рдард╛рдЙрдБ, рдореМрдВрд╕рдо
ЁЯМб => ЁЯМб, рдерд░реНрдореЛрдорд┐рдЯрд░, рдореМрд╕рдо
тША => тША, рдЖрдХрд╛рд╢рдЧрдВрдЧрд╛рд▓, рдЙрдЬреНрдпрд╛рд▓реЛ, рдХрд┐рд░рдг, рддреЗрдЬрд┐рд▓реЛ, рдореМрд╕рдо, рд╕реВрд░реНрдп
ЁЯМЭ => ЁЯМЭ, рдЕрдиреБрд╣рд╛рд░, рдЖрдХрд╛рд╢рдЧрдВрдЧрд╛рд▓, рдЙрдЬреНрдпрд╛рд▓реЛ, рдкреВрд░реНрдг рдЪрдиреНрджреНрд░, рдореМрд╕рдо, рд╕реВрд░реНрдп, рд╕реНрд╡рд░реВрдкрд╕рд╣рд┐рддрдХреЛ рдкреВрд░реНрдгрд┐рдорд╛
ЁЯМЮ => ЁЯМЮ, рдЕрдиреБрд╣рд╛рд░, рдЖрдХрд╛рд╢рдЧрдВрдЧрд╛рд▓, рдЙрдЬреНрдпрд╛рд▓реЛ, рдореМрд╕рдо, рд╕реВрд░реНрдп, рд╕реНрд╡рд░реВрдкрд╕рд╣рд┐рддрдХреЛ рд╕реВрд░реНрдп
тнР => тнР, рддрд╛рд░рд╛, рд╕реЗрддреЛ рдордзреНрдпрдо рддрд╛рд░рд╛
ЁЯМЯ => ЁЯМЯ, рдЙрдЬреНрдпрд╛рд▓реЛ, рдЧреНрд▓рд┐рдЯрд░рд┐рдЩреН, рдЪрдореНрдХрд┐рд░рд╣реЗрдХреЛ рддрд╛рд░рд╛, рдЪрдореНрдХреЗрдХреЛ, рдЪрдореНрдорд┐рдХрд░рд╣реЗрдХреЛ, рддрд╛рд░рд╛
ЁЯМа => ЁЯМа, рдЖрдХрд╛рд╢рдЧрдВрдЧрд╛, рдЭрд░рд┐рд░рд╣реЗрдХреЛ, рддрд╛рд░рд╛, рдкреБрдЪреНрдЫреНрд░реЗ рддрд╛рд░рд╛, рд╢реВрдЯрд┐рдЩреНрдЧ
тШБ => тШБ, рдмрд╛рджрд▓, рдореМрд╕рдо
тЫЕ => тЫЕ, рдмрд╛рджрд▓, рдмрд╛рджрд▓рдкрдЫрд╛рдбрд┐рдХреЛ рд╕реВрд░реНрдп, рдореМрд╕рдо, рд╕реВрд░реНрдп
тЫИ => тЫИ, рдЧрд░реНрдЬрд┐рдиреЗ, рдмрд╛рджрд▓, рдмрд┐рдЬреБрд▓реА рдЪрдореНрдХрд┐рд░рд╣реЗрдХреЛ рд░ рд╡рд░реНрд╖рд╛рд╕рд╣рд┐рддрдХреЛ рдмрд╛рджрд▓, рдореМрд╕рдо, рд╡рд░реНрд╖рд╛
ЁЯМд => ЁЯМд, рдмрд╛рджрд▓, рдореМрд╕рдо, рд╕рд╛рдиреЛ рдмрд╛рджрд▓рдкрдЫрд╛рдбрд┐рдХреЛ рд╕реВрд░реНрдп, рд╕реВрд░реНрдп
ЁЯМе => ЁЯМе, рдареВрд▓реЛ рдмрд╛рджрд▓рдкрдЫрд╛рдбрд┐рдХреЛ рд╕реВрд░реНрдп, рдмрд╛рджрд▓, рдореМрд╕рдо, рд╕реВрд░реНрдп
ЁЯМж => ЁЯМж, рдШрд╛рдо, рдмрд╛рджрд▓, рдмрд╛рджрд▓ рдкрд╛рдиреАрдХреЛ рд╕рд╛рдердорд╛ рдШрд╛рдо, рдореМрдВрд╕рдо, рд╡рд░реНрд╖рд╛
ЁЯМз => ЁЯМз, рдмрд╛рджрд▓, рдмрд╛рджрд▓рд╕рд╣рд┐рддрдХреЛ рд╡рд░реНрд╖рд╛, рдореМрдВрд╕рдо, рд╡рд░реНрд╖рд╛
ЁЯМи => ЁЯМи, рдЪрд┐рд╕реЛ, рдмрд╛рджрд▓, рдореМрд╕рдо, рд╣рд┐рдЙрдБ, рд╣рд┐рдЙрдБрд╕рд╣рд┐рддрдХреЛ рдмрд╛рджрд▓
ЁЯМй => ЁЯМй, рдмрд╛рджрд▓, рдмрд┐рдЬреБрд▓реА рдЪрдореНрдХрд┐рдБрджрд╛рдХреЛ рдмрд╛рджрд▓, рдмрд┐рдЬреБрд▓реА рдЪрдореНрдХрд┐рд░рд╣реЗрдХреЛ, рдореМрд╕рдо
ЁЯМк => ЁЯМк, рдЪрдХреНрд░рд╡рд╛рдд, рдмрд╛рджрд▓, рднрд╡рдиреНрдбрд░, рдореМрд╕рдо
ЁЯМл => ЁЯМл, рдХреБрд╣рд┐рд░реЛрд▓реЗ рдврд╛рдХреЗрдХреЛ, рдмрд╛рджрд▓, рдореМрд╕рдо
ЁЯМм => ЁЯМм, рдЕрдиреБрд╣рд╛рд░, рдкреНрд░рд╡рд╛рд╣, рдмрд╛рджрд▓, рдореМрд╕рдо, рд╕реБрд╕реНрддрд╛рдЗрд░рд╣реЗрдХреЛ рдЕрдиреБрд╣рд╛рд░, рд╣рд╛рд╡рд╛
ЁЯМА => ЁЯМА, рдЯреНрд╡рд┐рд╕реНрдЯрд░, рдореМрдВрд╕рдо, рд░рд┐рдВрдЧрдЯрд╛, рд╣реБрдгреНрдбрд░реА
ЁЯМИ => ЁЯМИ, рдЗрдиреНрджреНрд░реЗрдгреА, рд╡рд░реНрд╖рд╛
ЁЯМВ => ЁЯМВ, рдХрдкрдбрд╛, рдЫрд╛рддрд╛, рдмрдиреНрдж рдЧрд░реЗрдХреЛ рдЫрд╛рддрд╛, рдореМрд╕рдо, рд╡рд░реНрд╖рд╛
тШВ => тШВ, рдХрдкрдбрд╛, рдЫрд╛рддрд╛, рдореМрд╕рдо, рд╡рд░реНрд╖рд╛
тШФ => тШФ, рдХрдкрдбрд╛, рдЫрд╛рддрд╛, рдереЛрдкрд╛, рдкрд╛рдиреАрдХреЛ рдереЛрдкрд╛рд╕рд╣рд┐рддрдХреЛ рдЫрд╛рддрд╛, рдореМрд╕рдо, рд╡рд░реНрд╖рд╛
тЫ▒ => тЫ▒, рднреБрдИрдБрдорд╛ рдЧрд╛рдбрд┐рдПрдХреЛ рдЫрд╛рддрд╛, рд╕рддрд╣рдХреЛ рдЫрд╛рддрд╛
тЪб => тЪб, рдЖрдХрд╛рд╢ рдЪрд░реНрдХрдиреЗ рдХрд╛рд░реНрдп, рдЙрдЪреНрдЪреНрдЪ рднреЛрд▓реНрдЯреЗрдЬ, рдЦрддрд░рд╛, рдЬрд╛рдк, рднреЛрд▓реНрдЯреЗрдЬ, рд╡рд┐рдзреБрдд, рд╡рд┐рдзреБрддреАрдп
тЭД => тЭД, рд╕реНрдиреЛрдлреНрд▓реЗрдХ, рд╣рд┐рдордкрд╛рддрдХреЛ рдПрдХ рдЦрдгреНрдб
тШГ => тШГ, рдЪрд┐рд╕реЛ, рдореМрд╕рдо, рд╣рд┐рдЙрдБ, рд╣рд┐рдордорд╛рдирд╡
тЫД => тЫД, рдЪрд┐рд╕реЛ, рдореМрд╕рдо, рд╣рд┐рдЙрдБ, рд╣рд┐рдЙрдБрд╕рд╣рд┐рддрдХреЛ рд╣рд┐рдордорд╛рдирд╡, рд╣рд┐рдордорд╛рдирд╡
тШД => тШД, рдЖрдХрд╛рд╢рдЧрдВрдЧрд╛, рдзреВрдореНрд░рдХреЗрддреБ
ЁЯФе => ЁЯФе, рдЖрдЧреЛ, рдЬреНрд╡рд╛рд▓рд╛, рд╕рд╛рдзрди
ЁЯТз => ЁЯТз, рдЪрд┐рд╕реЛ, рдереЛрдкрд╛, рдкрд╕рд┐рдирд╛, рдореМрд╕рдо, рд╣рдБрд╕рд╛рдЙрдиреЗ
ЁЯМК => ЁЯМК, рддрд░рдВрдЧ, рдкрд╛рдиреА, рдкрд╛рдиреАрдХреЛ рддрд░рдВрдЧ, рдореМрд╕рдо, рд╕рдореБрджреНрд░
ЁЯОГ => ЁЯОГ, рдЬреНрдпрд╛рдХ, рдЬреНрдпрд╛рдХ-рдУ-рд▓рд╛рд▓рдЯрд┐рди, рд▓рд╛рд▓рдЯрд┐рди, рд╕рдорд╛рд░реЛрд╣, рд╣рд▓реЛрд╡рди
ЁЯОД => ЁЯОД, рдХреНрд░рд┐рд╕рдорд╕, рдХреНрд░рд┐рд╕рдорд╕ рд░реВрдЦ, рд░реВрдЦ, рд╕рдорд╛рд░реЛрд╣
ЁЯОЖ => ЁЯОЖ, рдЖрддрд┐рд╢рдмрд╛рдЬреА, рд╕рдорд╛рд░реЛрд╣
ЁЯОЗ => ЁЯОЗ, рдЖрддрд┐рд╢рдмрд╛рдЬреА, рдЪрдордХ, рд╕рдорд╛рд░реЛрд╣, рд╣реАрд░рд╛
тЬи => тЬи, рдЪрдордХ, рддрд╛рд░рд╛
ЁЯОИ => ЁЯОИ, рдмреЗрд▓реБрди, рд╕рдорд╛рд░реЛрд╣
ЁЯОЙ => ЁЯОЙ, рдЯрд╛рдбрд╛, рдкрдкрд░, рдкрд╛рд░реНрдЯреА, рдкрд╛рд░реНрдЯреА рдкрдкрд░, рд╕рдорд╛рд░реЛрд╣
ЁЯОК => ЁЯОК, рдХрдирдлреЗрдЯреА, рдХрдирдлреЗрдЯреА рдмрд▓, рдмрд▓, рд╕рдорд╛рд░реЛрд╣
ЁЯОЛ => ЁЯОЛ, рдЬрд╛рдкрд╛рдирд┐рдЬ рд░реВрдЦ, рддрдирд╛рдмрдЯрд╛ рд░реВрдЦ, рдмреНрдпрд╛рдирд░, рд╕рдорд╛рд░реЛрд╣
ЁЯОН => ЁЯОН, рдЬрд╛рдкрд╛рдирд┐рдЬ, рдкрд╛рдЗрди рд╕рдЬрд╛рд╡рдЯ, рдкрд┐рди, рдмрдореНрдмреЛ, рдмрд▓, рд╕рдорд╛рд░реЛрд╣
ЁЯОО => ЁЯОО, рдЪрд╛рдб, рдЬрд╛рдкрд╛рдирд┐рдЬ, рдЬрд╛рдкрд╛рдирд┐рдЬ рдкреБрддрд▓реА, рдкреБрддрд▓рд┐, рд╕рдорд╛рд░реЛрд╣
ЁЯОП => ЁЯОП, рдХрд╛рд░реНрдк, рдХрд╛рд░реНрдк рдкреНрд░рдХрд╛рд╢рдХреЛ рдХрд┐рд░рдг, рд╕рдорд╛рд░реЛрд╣, рд╕реНрдЯреНрд░рд┐рдорд░
ЁЯОР => ЁЯОР, рдШрдгреНрдЯреА, рд╡рд┐рдиреНрдб, рд╡рд┐рдиреНрдб рдЪрд╛рдЗрдо, рд╕рдорд╛рд░реЛрд╣, рд╕рд┐рдиреЗрдорд╛
ЁЯОС => ЁЯОС, рдЙрддреНрд╕рд╡, рдЪрдиреНрджреНрд░рдорд╛, рдЪрдиреНрджреНрд░рдорд╛рдХреЛ рд╕рдорд╛рд░реЛрд╣, рд╕рдорд╛рд░реЛрд╣
ЁЯОА => ЁЯОА, рд░рд┐рдмрди, рд╕рдорд╛рд░реЛрд╣
ЁЯОБ => ЁЯОБ, рдЙрдкрд╕реНрдерд┐рдд рд╕рдореЗрдЯрд┐рдПрдХреЛ, рдЙрдкрд╣рд╛рд░, рдмрдХреНрд╕, рд╕рдорд╛рд░реЛрд╣
ЁЯОЧ => ЁЯОЧ, рд░рд┐рдмрди, рд░рд┐рдорд╛рдЗрдиреНрдбрд░ рд░рд┐рдмрди, рд╕рдорд╛рд░реЛрд╣, рд╕рдореНрдЭрд╛рдЙрдиреА
ЁЯОЯ => ЁЯОЯ, рдЯрд┐рдХреЗрдЯрд╣рд░реВ, рднрд░реНрдирд╛, рднрд░реНрдирд╛ рдЯрд┐рдХреЗрдЯрд╣рд░реВ
ЁЯОл => ЁЯОл, рдЯрд┐рдХреЗрдЯ, рднрд░реНрдирд╛
ЁЯОЦ => ЁЯОЦ, рдкрджрдХ, рд╕рдорд╛рд░реЛрд╣, рд╕реИрдиреНрдп, рд╕реИрдиреНрдп рдкрджрдХ
ЁЯПЖ => ЁЯПЖ, рдЙрдкрд╣рд╛рд░, рдЯреНрд░рдлреА
ЁЯПЕ => ЁЯПЕ, рдЦреЗрд▓рдХреБрдж рдкрджрдХ, рдкрджрдХ
ЁЯеЗ => ЁЯеЗ, рдкрджрдХ, рдкрд╣рд┐рд▓реЛ, рд╕реНрд╡рд░реНрдг, рд╕реНрд╡рд░реНрдг рдкрджрдХ
ЁЯеИ => ЁЯеИ, рджреЛрд╕реНрд░реЛ, рдкрджрдХ, рд░рдЬрдд, рд░рдЬрдд рдкрджрдХ
ЁЯеЙ => ЁЯеЙ, рдХрд╛рд╕реНрдп, рдХрд╛рд╕реНрдп рдкрджрдХ, рддреЗрд╕реНрд░реЛ, рдкрджрдХ
тЪ╜ => тЪ╜, рдмрд▓, рд╕рдХрд░ рдмрд▓, рд╕реБрдХрд░
тЪ╛ => тЪ╛, рдмрд▓, рдмреЗрд╕рдмрд▓
ЁЯПА => ЁЯПА, рдмрд▓, рдмрд╛рд╕реНрдХреЗрдЯрдмрд▓, рд╣реБрдк
ЁЯПР => ЁЯПР, рдЦреЗрд▓, рдмрд▓, рднрд▓рд┐рдмрд▓
ЁЯПИ => ЁЯПИ, рдЕрдореЗрд░рд┐рдХрди, рдЕрдореЗрд░рд┐рдХрди рдлреБрдЯрдмрд▓, рдлреБрдЯрдмрд▓, рдмрд▓
ЁЯПЙ => ЁЯПЙ, рдлреБрдЯрдмрд▓, рдмрд▓, рд░рдЧреНрдмреА, рд░рдЧреНрдмреА рдлреБрдмрд▓
ЁЯО╛ => ЁЯО╛, рдЯреЗрдирд┐рд╕, рдмрд▓, рд░реНрдпрд╛рдХреЗрдЯ
ЁЯО▒ => ЁЯО▒, рео, рео рдмрд▓, рдЖрда, рдЦреЗрд▓, рдмрд▓, рдмрд┐рд▓рд┐рдпрд░реНрдбреНрд╕
ЁЯО│ => ЁЯО│, рдЦреЗрд▓, рдмрд▓, рдмрд▓рд┐рдЩреНрдЧ
ЁЯПП => ЁЯПП, рдХреНрд░рд┐рдХреЗрдЯ, рдЦреЗрд▓, рдмрд▓, рдмреНрдпрд╛рдЯ
ЁЯПС => ЁЯПС, рдХреНрд╖реЗрддреНрд░, рдЦреЗрд▓, рдлрд┐рд▓реНрдб рд╣рдХреА, рдмрд▓, рд╕реНрдЯрд┐рдХ, рд╣рдХрд┐
ЁЯПТ => ЁЯПТ, рдЖрдИрд╕, рдЖрдИрд╕ рд╣рдХреА рд╕реНрдЯрд┐рдХ рд░ рдкрдХ, рдЦреЗрд▓, рдкрдХ, рд╕реНрдЯрд┐рдХ, рд╣рдХрд┐
ЁЯПУ => ЁЯПУ, рдЦреЗрд▓, рдЯреЗрдмрд▓ рдЯреЗрдирд┐рд╕, рдкрд┐рдЩреНрдЧ рдкрдЩреНрдЧ, рдкреНрдпрд╛рдбрд▓, рдмрд▓, рдмреНрдпрд╛рдЯ
ЁЯП╕ => ЁЯП╕, рдЦреЗрд▓, рдмрд░реНрдЧреНрдбреА, рдмреНрдпрд╛рдбрдорд┐рдиреНрдЯрди, рд░реНрдпрд╛рдХреЗрдЯ, рд╢рдЯрд▓рдХрдХ
ЁЯеК => ЁЯеК, рдЦреЗрд▓, рдЧреНрд▓реЛрдн, рдмрдХреНрд╕рд┐рдЩ, рдмрдХреНрд╕рд┐рдЩ рдЧреНрд▓реЛрдн
ЁЯеЛ => ЁЯеЛ, рдХрд░рд╛рддреЗ, рдЦреЗрд▓, рдЬреБрдбреЛ, рддрд╛рдЗрдХреНрд╡рд╛рдиреНрдбреЛ, рдорд╛рд░реНрд╕рд▓ рдЖрд░реНрдЯ, рдорд╛рд░реНрд╕рд▓ рдЖрд░реНрдЯ рдпреБрдирд┐рдлрд░реНрдо, рдпреБрдирд┐рдлрд░реНрдо
ЁЯеЕ => ЁЯеЕ, рдЦреЗрд▓, рдЧреЛрд▓, рдЧреЛрд▓ рдЬрд╛рд▓реА, рдЬрд╛рд▓реА
ЁЯОп => ЁЯОп, рдбрд╛рдЗрд░реЗрдХреНрдЯ рд╣рд┐рдЯ, рдбрд╛рдпрд░реЗрдХреНрдЯ рд╣рд┐рдЯ
тЫ│ => тЫ│, рдЧреЛрд▓реНрдл, рдЭрдгреНрдбрд╛рдорд╛ рдкреНрд╡рд╛рд▓, рдкреНрд╡рд╛рд▓
тЫ╕ => тЫ╕, рдЖрдИрд╕, рдЖрдИрд╕ рд╕реНрдХреЗрдЯ, рд╕реНрдХреЗрдЯ
ЁЯОг => ЁЯОг, рдкреЛрд▓, рдорд╛рдЫрд╛, рдорд╛рдЫрд╛рдХреЛ рдмрд▓реНрдЫреАрдХреЛ рдкреЛрд▓
ЁЯО╜ => ЁЯО╜, рджреМрдбрд┐рдиреЗ, рд░рдирд┐рдЩ рд╕рд░реНрдЯ, рд╕рд░реНрдЯ, рд╕реНрдпрд╛рд╕
ЁЯО┐ => ЁЯО┐, рд╕реНрдХреА, рд╣рд┐рдЙрдБ
ЁЯЫ╖ => ЁЯЫ╖, рдмрд░рдл-рдЧрд╛рдбреА, рдмрд░реНрдлрдЧрд╛рдбреА
ЁЯеМ => ЁЯеМ, рдХрд░реНрд▓рд┐рдЩ рд╕реНрдЯреЛрди, рдЦреЗрд▓, рдЪрдЯреНрдЯрд╛рди
ЁЯОо => ЁЯОо, рдЦреЗрд▓, рдирд┐рдпрдиреНрддреНрд░рдХ, рднрд┐рдбрд┐рдпреЛ рдЧреЗрдо
ЁЯХ╣ => ЁЯХ╣, рдЦреЗрд▓, рдЬреЛрд╕реНрдЯрд┐рдХ, рднрд┐рдбреАрдпреЛ рдЧреЗрдо
ЁЯО▓ => ЁЯО▓, рдЦреЗрд▓, рдЧреЗрдо рдбрд╛рдЗ, рдкрд╛рд╕рд╛рд╣рд░реВ, рдорд░реНрдиреЗ
тЩа => тЩа, рдХрд╛рд░реНрдб, рдХреБрджрд╛рд▓ рд╕реВрдЯ, рдЦреЗрд▓, рд╕реВрдЯ, рд╕реНрдкреЗрдб
тЩе => тЩе, рдХрд╛рд░реНрдб, рдЦреЗрд▓, рдореБрдЯреБ, рдореБрдЯреБрд╣рд░реВ, рд╕реВрдЯ, рд╣рд░реНрдЯ рд╕реВрдЯ
тЩж => тЩж, рдХрд╛рд░реНрдб, рдЦреЗрд▓, рдбрд╛рдпрдордиреНрдб рд╕реВрдЯ, рд╕реВрдЯ, рд╣рд┐рд░рд╛, рд╣рд┐рд░рд╛рд╣рд░реВ
тЩг => тЩг, рдХрд╛рд░реНрдб, рдХреНрд▓рдм, рдХреНрд▓рдм рд╕реВрдЯ, рдХреНрд▓рдмрд╣рд░, рдЦреЗрд▓, рд╕реВрдЯ
ЁЯГП => ЁЯГП, рдХрд╛рд░реНрдб, рдЦреЗрд▓, рдЦреЗрд▓реНрджреИ, рдЬреЛрдХрд░
ЁЯАД => ЁЯАД, рдЦреЗрд▓, рдорд╣рдЬрдЩреНрдЧ, рдорд╣рдЬрдЩреНрдЧ рд░рд╛рддреЛ рдбреНрд░рд╛рдЧрди, рд░рд╛рддреЛ
ЁЯО┤ => ЁЯО┤, рдХрд╛рд░реНрдб, рдЦреЗрд▓, рдЦреЗрд▓рд┐рд░рд╣реЗрдХреЛ, рдЬрд╛рдкрд╛рдиреА, рдлреВрд▓, рдлреНрд▓рд╛рд╡рд░ рдкреНрд▓реЗрдпрд┐рдЩ рдХрд╛рд░реНрдб
ЁЯФЗ => ЁЯФЗ, рдЪреБрдк, рдмрдиреНрдж рд╕реНрдкрд┐рдХрд░, рднреЛрд▓реНрдпреБрдо, рдореНрдпреБрдЯ, рд╢рд╛рдиреНрдд, рд╕реНрдкрд┐рдХрд░
ЁЯФИ => ЁЯФИ, рднреЛрд▓реНрдпреБрдо, рд╕реНрдкрд┐рдХрд░
ЁЯФЙ => ЁЯФЙ, рдареВрд▓реЛ, рддрд░рдВрдЧ, рднреЛрд▓реНрдпреВрдо, рд╕реНрдкрд┐рдХрд░, рд╕реНрдкрд┐рдХрд░ рдЦреБрд▓рд╛
ЁЯФК => ЁЯФК, 3, рдареВрд▓реЛ, рдареВрд▓реЛ рдЖрд╡рд╛рдЬрдорд╛ рд╕реНрдкрд┐рдХрд░, рддреАрди, рдмрдвреА, рднреЛрд▓реНрдпреВрдо, рд╕реНрдкрд┐рдХрд░
ЁЯУв => ЁЯУв, рдареВрд▓реЛ, рд▓рд╛рдЙрдбрд╕реНрдкрд┐рдХрд░, рд╕рд╛рд░реНрдмрдЬрдирд┐рдХ рдареЗрдЧрд╛рдирд╛
ЁЯУг => ЁЯУг, рдЙрддреНрд╕рд╛рд╣рд╡рд░реНрдзрдХ, рдореЗрдЧрд╛рдлреЛрди
ЁЯУп => ЁЯУп, рдкреЛрд╕реНрдЯ, рдкреЛрд╕реНрдЯрд▓, рдкреЛрд╕реНрдЯрд▓ рд╕рд┐рдЩ, рд╕рд┐рдЩреН
ЁЯФФ => ЁЯФФ, рдШрдиреНрдЯреА
ЁЯФХ => ЁЯФХ, рдШрдгреНрдЯреА, рдЪреБрдк, рдЪреБрдкрдЪрд╛рдк, рдЫреИрди, рдирд┐рд╖реЗрдзрд┐рдд, рд░реЛрдХрд┐рдПрдХреЛ, рд╢рд╛рдиреНрдд, рд╕реНрд▓реНрдпрд╛рд╕рд╕рд╣рд┐рддрдХреЛ рдШрдгреНрдЯреА, рд╣реЛрдЗрди
ЁЯО╝ => ЁЯО╝, рд╕рд╛рдВрдЧреАрддрд┐рдХ, рд╕рд╛рдВрдЧреАрддрд┐рдХ рд╕реНрдХреЛрд░, рд╕реНрдХреЛрд░
ЁЯО╡ => ЁЯО╡, рдиреЛрдЯ, рд╕рд╛рдВрдЧреАрддрд┐рдХ, рд╕рд╛рдВрдЧреАрддрд┐рдХ рдиреЛрдЯ
ЁЯО╢ => ЁЯО╢, рдиреЛрдЯ, рдиреЛрдЯрд╣рд░реВ, рд╕рдВрдЧреАрддрдХреЛ рдиреЛрдЯ, рд╕рд╛рдВрдЧреАрддрд┐рдХ
ЁЯОЩ => ЁЯОЩ, рдорд╛рдЗрдХреНрд░реЛрдлреЛрди, рд╕рдВрдЧреАрдд, рд╕реНрдЯреБрдбрд┐рдпреЛ, рд╕реНрдЯреБрдбрд┐рдпреЛ рдорд╛рдЗрдХреНрд░реЛрдлреЛрди
ЁЯОЪ => ЁЯОЪ, рд╕рдВрдЧреАрдд, рд╕реНрддрд░, рд╕реНрддрд░ рд╕реНрд▓рд╛рдЗрдбрд░, рд╕реНрд▓рд╛рдЗрдбрд░
ЁЯОЫ => ЁЯОЫ, рдирдмрд╣рд░реВ, рдирд┐рдпрдиреНрддреНрд░рдг, рдирд┐рдпрдиреНрддреНрд░рдг рдирдмрд╣рд░реВ, рд╕рдВрдЧреАрдд
ЁЯОд => ЁЯОд, рдХрд╛рд░рд╛рд╡реЛрдХреЗ, рдорд╛рдЗрдХреНрд░реЛрдлреЛрди
ЁЯОз => ЁЯОз, рдЗрдпрд░рдмрдб, рд╣реЗрдбрдлреЛрди
ЁЯУ╗ => ЁЯУ╗, рднрд┐рдбреЛрдпреЛ, рд░реЗрдбрд┐рдпреЛ
ЁЯО╖ => ЁЯО╖, рдЙрдкрдХрд░рдг, рд╕рдВрдЧреАрдд, рд╕рд╛рдХреНрд╕реЛрдлреЛрди, рд╕реЗрдХреНрд╕реЛрдлреЛрди
ЁЯО╕ => ЁЯО╕, рдЙрдкрдХрд░рдг, рдЧрд┐рддрд╛рд░, рд╕рдВрдЧреАрдд
ЁЯО╣ => ЁЯО╣, рдЙрдкрдХрд░рдг, рдХреЛрдмреЛрд░реНрдб, рдкрд┐рдпрд╛рдиреЛ, рд╕рдВрдЧреАрдд, рд╕рд╛рдВрдЧреАрддрд┐рдХ рдХрд┐рдмреЛрд░реНрдб
ЁЯО║ => ЁЯО║, рдЙрдкрдХрд░рдг, рдЯреНрд░рдордкреЗрдЯ, рд╕рдВрдЧреАрдд
ЁЯО╗ => ЁЯО╗, рдЙрдкрдХрд░рдг, рднрд╛рдпреЛрд▓рд┐рди, рд╕рдВрдЧреАрдд
ЁЯеБ => ЁЯеБ, рдбреНрд░рдо, рдбреНрд░рдорд╕реНрдЯрд┐рдХ, рд╕рдВрдЧреАрдд
ЁЯУ▒ => ЁЯУ▒, рдХрд▓, рдЯреЗрд▓рд┐рдлреЛрди, рдлреЛрди, рдореЛрдмрд╛рдЗрд▓, рдореЛрдмрд╛рдЗрд▓ рдлреЛрди
ЁЯУ▓ => ЁЯУ▓, рдХрд▓, рдЯреЗрд▓рд┐рдлреЛрди, рдкреНрд░рд╛рдкреНрдд, рдлреЛрди, рдореЛрдмрд╛рдЗрд▓, рд╡рд╛рдг, рд╡рд╛рдгрд╕рд╣рд┐рддрдХреЛ рдореЛрдмрд╛рдЗрд▓ рдлреЛрди, рд╕реЗрд▓
тШО => тШО, рдЯреЗрд▓рд┐рдлреЛрди, рдлреЛрди
ЁЯУЮ => ЁЯУЮ, рдЯреЗрд▓рд┐рдлреЛрди, рдЯреЗрд▓рд┐рдлреЛрди рд░рд┐рд╕рд┐рднрд░, рдлреЛрди, рд░рд┐рд╕рд┐рднрд░
ЁЯУЯ => ЁЯУЯ, рдкреЗрдЬрд░
ЁЯУа => ЁЯУа, рдлреНрдпрд╛рдХреНрд╕, рдлреНрдпрд╛рдХреНрд╕ рдореЗрд╕рд┐рди
ЁЯФЛ => ЁЯФЛ, рдмреНрдпрд╛рдЯреНрд░реА
ЁЯФМ => ЁЯФМ, рдкреНрд▓рдЧ, рдмрд┐рдзреБрдд, рдмрд┐рдзреБрддреАрдп, рдмрд┐рдзреБрддреАрдп рдкреНрд▓рдЧ
ЁЯТ╗ => ЁЯТ╗, рдХрдореНрдкреНрдпреБрдЯрд░, рдкрд┐рд╕реА, рд▓реНрдпрд╛рдкрдЯрдк рдХрдореНрдкреНрдпреБрдЯрд░, рд╡реНрдпрдХреНрддрд┐рдЧрдд
ЁЯЦе => ЁЯЦе, рдХрдореНрдкреНрдпреБрдЯрд░, рдбреЗрд╕реНрдХрдЯрдк, рдбреЗрд╕реНрдХрдЯрдк рдХрдореНрдкреНрдпреБрдЯрд░
ЁЯЦи => ЁЯЦи, рдХрдореНрдкреНрдпреБрдЯрд░, рдкреНрд░рд┐рдиреНрдЯрд░
тМи => тМи, рдХрдореНрдкреНрдпреБрдЯрд░, рдХрд┐рдмреЛрд░реНрдб
ЁЯЦ▒ => ЁЯЦ▒, рей, рдХрдореНрдкреНрдпреБрдЯрд░, рдХрдореНрдкреНрдпреБрдЯрд░ рдорд╛рдЙрд╕, рддреАрди, рдмрдЯрди, рдорд╛рдЙрд╕
ЁЯЦ▓ => ЁЯЦ▓, рдХрдореНрдкреНрдпреБрдЯрд░, рдЯреНрд░рдпрд╛рдХрдмрд▓
ЁЯТ╜ => ЁЯТ╜, рдЕрдкреНрдЯрд┐рдХрд▓, рдХрдореНрдкреНрдпреБрдЯрд░, рдбрд┐рд╕реНрдХ, рд╕рд╛рдиреЛрдбрд┐рд╕реНрдХ
ЁЯТ╛ => ЁЯТ╛, рдХрдореНрдкреНрдпреБрдЯрд░, рдбрд┐рд╕реНрдХ, рдлреНрд▓рдкрд┐, рдлреНрд▓рдкрд┐ рдбрд┐рд╕реНрдХ
ЁЯТ┐ => ЁЯТ┐, рдЕрдкреНрдЯрд┐рдХрд▓ рдбрд┐рд╕реНрдХ, рдХрдореНрдкреНрдпреБрдЯрд░, рдбрд┐рднреАрдбреА, рдбрд┐рд╕реНрдХ рдЕрдкреНрдЯрд┐рдХрд▓, рдирд┐рд▓реЛ-рдХрд┐рд░рдг, рд╕рд┐рдбреА
ЁЯУА => ЁЯУА, рдЕрдкреНрдЯрд┐рдХрд▓, рдХрдореНрдкреНрдпреБрдЯрд░, рдбрд┐рднрд┐рдбрд┐, рдбрд┐рд╕реНрдХ, рдмреНрд▓реБ-рд░реЗ, рд╕рд┐рдбреА
ЁЯОе => ЁЯОе, рдХреНрдпрд╛рдореЗрд░рд╛, рдЪрд▓рдЪрд┐рддреНрд░, рдореБрднреА рдХреНрдпрд╛рдореЗрд░рд╛, рд╕рд┐рдиреЗрдорд╛
ЁЯОЮ => ЁЯОЮ, рдЪрд▓рдЪрд┐рддреНрд░, рдлрд┐рд▓реНрдо, рдлрд┐рд▓реНрдордХреЛ рдлреНрд░реЗрдорд╣рд░реВ, рдлреНрд░реЗрдорд╣рд░реВ, рд╕рд┐рдиреЗрдорд╛
ЁЯУ╜ => ЁЯУ╜, рдЪрд▓рдЪрд┐рддреНрд░, рдкреНрд░реЛрдЬреЗрдХреНрдЯрд░, рдлрд┐рд▓реНрдо, рдлрд┐рд▓реНрдо рдкреНрд░реЛрдЬреЗрдХреНрдЯрд░, рднрд┐рдбрд┐рдпреЛ, рд╕рд┐рдиреЗрдорд╛
ЁЯОм => ЁЯОм, рдХреНрд▓реНрдпрд╛рдкреНрдкрд░, рдХреНрд▓реНрдпрд╛рдкреНрдкрд░ рдмреЛрд░реНрдб, рдЪрд▓рдЪрд┐рддреНрд░
ЁЯУ║ => ЁЯУ║, рдЯрд┐рднреА, рдЯреЗрд▓рд┐рднрд┐рдЬрди, рднрд┐рдбреАрдпреЛ
ЁЯУ╖ => ЁЯУ╖, рдХреНрдпрд╛рдореЗрд░рд╛, рднрд┐рдбреАрдпреЛ
ЁЯУ╕ => ЁЯУ╕, рдХреНрдпрд╛рдореЗрд░рд╛, рдлреНрд▓реНрдпрд╛рд╢, рдлреНрд▓реНрдпрд╛рд╢рд╕рд╣рд┐рддрдХреЛ рдХреНрдпрд╛рдореЗрд░рд╛, рднрд┐рдбреАрдпреЛ
ЁЯУ╣ => ЁЯУ╣, рдХреНрдпрд╛рдореЗрд░рд╛, рднрд┐рдбрд┐рдпреЛ, рднрд┐рдбрд┐рдпреЛ рдХреНрдпрд╛рдореЗрд░рд╛
ЁЯУ╝ => ЁЯУ╝, рдЯреЗрдк, рднрд┐рдПрдЪрдПрд╕, рднрд┐рдбрд┐рдпреЛ, рднрд┐рдбрд┐рдпреЛ рдХреНрдпрд╛рд╕реЗрдЯ
ЁЯФН => ЁЯФН, рдЦреЛрдЬреНрдиреЗ, рдЧреНрд▓рд╛рд╕, рдмрд╛рдпрд╛рдБ-рджреЗрдЦрд╛рдЙрдиреЗ рдореНрдпрд╛рдЧреНрдирд┐рдлрд╛рдЗрдЩ рдЧреНрд▓рд╛рд╕, рдореНрдпрд╛рдЧреНрдирд┐рдлрд╛рдЗрдЩ, рд╕рд╛рдзрди
ЁЯФО => ЁЯФО, рдЦреЛрдЬреНрдиреЗ, рдЧреНрд▓рд╛рд╕, рджрд╛рдпрд╛рдБ-рджреЗрдЦрд╛рдЙрдиреЗ рдореНрдпрд╛рдЧреНрдирд┐рдлрд╛рдЗрдЩ рдЧреНрд▓рд╛рд╕, рдореНрдпрд╛рдЧреНрдирд┐рдлрд╛рдЗрдЩ, рд╕рд╛рдзрди
ЁЯФм => ЁЯФм, рд╕рд╛рдзрди, рд╕реБрдХреНрд╖реНрдорджрд░реНрд╢рдХ рдпрдиреНрддреНрд░
ЁЯФн => ЁЯФн, рдЯреЗрд▓рд┐рд╕реНрдХреЛрдк, рд╕рд╛рдзрди
ЁЯУб => ЁЯУб, рдПрдиреНрдЯреЗрдирд╛, рдбрд┐рд╕реН, рд╕реНрдпрд╛рдЯрд▓рд╛рдЗрдЯ, рд╕реНрдпрд╛рдЯрд▓рд╛рдЗрдЯ рдПрдиреНрдЯреЗрдирд╛
ЁЯХп => ЁЯХп, рдмрддреНрддреА, рдореИрди рдмрддреНрддреА
ЁЯТб => ЁЯТб, рдмрддреНрддрд┐, рдмрддреНрддрд┐рдХреЛ рдЪрд┐рдо, рдмрддреНрддреА, рд░рдорд╛рдЗрд▓реЛ, рд╡рд┐рдЪрд╛рд░, рд╡рд┐рджреНрдпреБрддрд┐рдп
ЁЯФж => ЁЯФж, рдЯрд░реНрдЪ, рдлреНрд▓реНрдпрд╛рд╢ рд▓рд╛рдЗрдЯ, рдмрддреНрддреА, рд╡рд┐рджреНрдпреБрддрд┐рдп, рд╕рд╛рдзрди
ЁЯПо => ЁЯПо, рдЬрд╛рдкрд╛рдирд┐рдЬ, рдкрдЯреНрдЯреА, рдмрддреНрддреА, рд░рд╛рддреЛ, рд░рд╛рддреЛ рдкрд╛рдирд╛рдХреЛ рд▓рд╛рд▓рдЯрд┐рди, рд▓рд╛рдирдЯрд┐рди
ЁЯУФ => ЁЯУФ, рдХрднрд░, рдиреЛрдЯрдмреБрдХ, рдкреБрд╕реНрддрдХ, рд╕рдЬрд┐рдПрдХреЛ, рд╕рдЬрд┐рдПрдХреЛ рдХрднрд░рд╕рд╣рд┐рддрдХреЛ рдиреЛрдЯрдмреБрдХ
ЁЯУХ => ЁЯУХ, рдкреБрд╕реНрддрдХ, рдмрдиреНрдж рдЧрд░реЗрдХреЛ, рдмрдиреНрдж рдЧрд░реЗрдХреЛ рдкреБрд╕реНрддрдХ
ЁЯУЦ => ЁЯУЦ, рдЦреБрд▓рд╛, рдЦреБрд▓рд╛ рдкреБрд╕реНрддрдХ, рдкреБрд╕реНрддрдХ
ЁЯУЧ => ЁЯУЧ, рдкреБрд╕реНрддрдХ, рд╣рд░рд┐рдпреЛ, рд╣рд░рд┐рдпреЛ рдкреБрд╕реНрддрдХ
ЁЯУШ => ЁЯУШ, рдиреАрд▓реЛ, рдиреАрд▓реЛ рдкреБрд╕реНрддрдХ, рдкреБрд╕реНрддрдХ
ЁЯУЩ => ЁЯУЩ, рдкреБрд╕реНрддрдХ, рд╕реБрдиреНрддрд▓рд╛, рд╕реБрдиреНрддрд▓рд╛ рдкреБрд╕реНрддрдХ
ЁЯУЪ => ЁЯУЪ, рдкреБрд╕реНрддрдХ, рдкреБрд╕реНрддрдХрд╣рд░реВ
ЁЯУУ => ЁЯУУ, рдиреЛрдЯрдмреБрдХ
ЁЯУТ => ЁЯУТ, рдиреЛрдЯрдмреБрдХ, рд▓реЗрдЬрд░
ЁЯУГ => ЁЯУГ, рдХрд░реНрд▓, рдХрд░реНрд▓рд╕рд╣рд┐рддрдХреЛ рдкреГрд╖реНрда, рдХрд╛рдЧрдЬрд╛рдд, рдкреГрд╖реНрда
ЁЯУЬ => ЁЯУЬ, рдкрд╛рдирд╛, рд╕реНрдХреНрд░реЛрд▓
ЁЯУД => ЁЯУД, рдХрд╛рдЧрдЬрд╛рдд, рдкрд╛рдирд╛, рдорд╛рдерд┐ рдлрд░реНрдХреЗрдХреЛ рдкрд╛рдирд╛
ЁЯУ░ => ЁЯУ░, рдкрддреНрд░, рд╕рдорд╛рдЪрд╛рд░, рд╕рдорд╛рдЪрд╛рд░рдкрддреНрд░
ЁЯЧЮ => ЁЯЧЮ, рдкрддреНрд░, рдорд╛рдерд┐-рд░реЛрд▓ рднрдПрдХреЛ рд╕рдорд╛рдЪрд╛рд░рдкрддреНрд░, рд░реЛрд▓ рдЧрд░рд┐рдПрдХреЛ, рд╕рдорд╛рдЪрд╛рд░, рд╕рдорд╛рдЪрд╛рд░рдкрддреНрд░
ЁЯУС => ЁЯУС, рдЪрд┐рдиреНрд╣, рдЯреНрдпрд╛рдмрд╣рд░реВ, рдмреБрдХрдорд╛рд░реНрдХ, рдмреБрдХрдорд╛рд░реНрдХ рдЯреНрдпрд╛рдмрд╣рд░реВ, рдорд╛рд░реНрдХрд░
ЁЯФЦ => ЁЯФЦ, рдЪрд┐рдиреНрд╣, рдмреБрдХрдорд╛рд░реНрдХ
ЁЯП╖ => ЁЯП╖, рд▓реЗрдмрд▓
ЁЯТ░ => ЁЯТ░, рдЭреЛрд▓рд╛, рдбрд▓рд░, рдкреИрд╕рд╛, рдкреИрд╕рд╛рдХреЛ рдЭреЛрд▓рд╛, рдкреИрд╕рд╛рдХреЛрдЭреЛрд▓рд╛
ЁЯТ┤ => ЁЯТ┤, рдиреЛрдЯ, рдкреИрд╕рд╛, рдмрд┐рд▓, рдмреИрдЩреНрдХ, рдмреИрдЩреНрдХрдиреЛрдЯ, рдореБрджреНрд░рд╛, рдпрд╛рди, рдпреЗрди рдмреИрдЩреНрдХрдиреЛрдЯ
ЁЯТ╡ => ЁЯТ╡, рдбрд▓рд░, рдбрд▓рд░ рдмреИрдЩреНрдХрдиреЛрдЯ, рдиреЛрдЯ, рдкреИрд╕рд╛, рдмрд┐рд▓, рдмреИрдЩреНрдХ, рдмреИрдЩреНрдХрдиреЛрдЯ, рдореБрджреНрд░рд╛
ЁЯТ╢ => ЁЯТ╢, рдкреИрд╕рд╛ рдиреЛрдЯ, рдмрд┐рд▓, рдмреИрдЩреНрдХ, рдмреИрдЩреНрдХрдиреЛрдЯ, рдореБрджреНрд░рд╛, рдпреВрд░реЛ, рдпреВрд░реЛ рдмреИрдЩреНрдХрдиреЛрдЯ
ЁЯТ╖ => ЁЯТ╖, рдиреЛрдЯ, рдкрд╛рдЙрдгреНрдб, рдкрд╛рдЙрдгреНрдб рдмреИрдЩреНрдХрдиреЛрдЯ, рдкреИрд╕рд╛, рдмрд┐рд▓, рдмреИрдЩреНрдХ, рдмреИрдЩреНрдХрдиреЛрдЯ, рдореБрджреНрд░рд╛
ЁЯТ╕ => ЁЯТ╕, рдЙрдбреНрдиреЗ, рдбрд▓рд░, рдиреЛрдЯ, рдкрдЦреЗрдЯрд╛, рдкрдЦреЗрдЯрд╛рд╕рд╣рд┐рддрдХреЛ рдкреИрд╕рд╛, рдкреИрд╕рд╛, рдмрд┐рд▓, рдмреИрдЩреНрдХ, рдмреИрдЩреНрдХрдиреЛрдЯ
ЁЯТ│ => ЁЯТ│, рдХрд╛рд░реНрдб, рдХреНрд░реЗрдбрд┐рдЯ, рдХреНрд░реЗрдбрд┐рдЯ рдХрд╛рд░реНрдб, рдкреИрд╕рд╛, рдмреИрдЩреНрдХ
ЁЯТ╣ => ЁЯТ╣, рдпреЗрди рдмрдврд┐рд░рд╣реЗрдХреЛ рдЪрд╛рд░реНрдЯ, рдпреЗрдирд╕рдБрдЧреИ рдмрдврд┐рд░рд╣реЗрдХреЛ рдЪрд╛рд░реНрдЯ
ЁЯТ▒ => ЁЯТ▒, рдкреИрд╕рд╛, рдмрд┐рдирд┐рдордп, рдмреИрдЩреНрдХ, рдореБрджреНрд░рд╛, рдореБрджреНрд░рд╛ рдмрд┐рдирд┐рдордп
ЁЯТ▓ => ЁЯТ▓, рдбрд▓рд░, рдкреИрд╕рд╛, рднрд╛рд░реА рдбрд▓рд░рдХреЛ рдЪрд┐рдиреНрд╣, рдореБрджреНрд░рд╛
тЬЙ => тЬЙ, рдЗрдореЗрд▓, рдЗрдореЗреЗрд▓, рдЦрд╛рдо
ЁЯУз => ЁЯУз, рдЗ-рдореЗрд▓, рдЗрдореЗрд▓, рдЪрд┐рдареНрдареА, рдореЗрд▓
ЁЯУи => ЁЯУи, рдЖрдЗрд░рд╣реЗрдХреЛ, рдЖрдЙрдиреЗ рдЦрд╛рдо, рдЗрдореЗрд▓, рдЦрд╛рдо, рдЪрд┐рдареНрдареА, рдкреНрд░рд╛рдкреНрдд, рдореЗрд▓
ЁЯУй => ЁЯУй, рдЗрдореЗрд▓, рдЦрд╛рдо, рдЪрд┐рдареНрдареА, рддрд▓, рдкрдард╛рдПрдХреЛ, рдмрд╛рд╣рд┐рд░ рдЧрдЗрд░рд╣реЗрдХреЛ, рдореЗрд▓, рд╡рд╛рдг, рд╡рд╛рдг рд╕рд╣рд┐рддрдХреЛ рдЦрд╛рдо
ЁЯУд => ЁЯУд, рдЖрдЙрдЯрдмрдХреНрд╕, рдЧрдПрдХрд╛ рдЯреНрд░реЗ, рдЪрд┐рдареНрдареА, рдЯреНрд░реЗ, рдкрдард╛рдПрдХреЛ, рдмрдХреНрд╕, рдореЗрд▓
ЁЯУе => ЁЯУе, рдЗрдирдмрдХреНрд╕ рдЯреНрд░реЗ, рдЗрдирдмрд╛рдХрд╕, рдЪрд┐рдареА, рдЯреНрд░реЗ, рдкрддреНрд░, рдкреНрд░рд╛рдкреНрдд рдЧрд░реНрдиреБ, рдмрд╛рдХрд╕
ЁЯУж => ЁЯУж, рдкрд╛рд░реНрд╕рд▓, рдкреНрдпрд╛рдХреЗрдЬ, рдмрдХреНрд╕
ЁЯУл => ЁЯУл, рдЙрдареЗрдХреЛ рдЭрдиреНрдбрд╛рд╕рд╣рд┐рддрдХреЛ рдмрдиреНрдж рднрдПрдХреЛ рдореЗрд▓рдмрдХреНрд╕, рдЦреБрд▓рд╛, рдкреЛрд╕реНрдЯрдмрдХреНрд╕, рдмрдиреНрдж рднрдПрдХреЛ, рдореЗрд▓, рдореЗрд▓рдмрдХреНрд╕
ЁЯУк => ЁЯУк, рддрд▓рдХреЛ рдЭрдиреНрдбрд╛рд╕рд╣рд┐рддрдХреЛ рдмрдиреНрдж рднрдПрдХреЛ рдореЗрд▓рдмрдХреНрд╕, рддрд▓реНрд▓реЛ рдЕрдХреНрд╖рд░рдХреЛ, рдкреЛрд╕реНрдЯрдмрдХреНрд╕, рдмрдиреНрдж рднрдПрдХреЛ, рдореЗрд▓, рдореЗрд▓рдмрдХреНрд╕
ЁЯУм => ЁЯУм, рдЙрдареЗрдХреЛ рдЭрдиреНрдбрд╛рд╕рд╣рд┐рддрдХреЛ рдЦреБрд▓рд╛ рдореЗрд▓рдмрдХреНрд╕, рдЦреБрд▓рд╛, рдкреЛрд╕реНрдЯрдмрдХреНрд╕, рдореЗрд▓, рдореЗрд▓рдмрдХреНрд╕
ЁЯУн => ЁЯУн, рдЦреБрд▓рд╛, рддрд▓рдХреЛ рдЭрдиреНрдбрд╛рд╕рд╣рд┐рддрдХреЛ рдЦреБрд▓рд╛ рдореЗрд▓рдмрдХреНрд╕, рддрд▓реНрд▓реЛ рдЕрдХреНрд╖рд░рдХреЛ, рдкреЛрд╕реНрдЯрдмрдХреНрд╕, рдореЗрд▓, рдореЗрд▓рдмрдХреНрд╕
ЁЯУо => ЁЯУо, рдкреЛрд╕реНрдЯрдмрдХреНрд╕, рдореЗрд▓, рдореЗрд▓рдмрдХреНрд╕
ЁЯЧ│ => ЁЯЧ│, рдмрдХреНрд╕, рдорддрджрд╛рди, рдорддрджрд╛рдирдХреЛрд╕рд╛рде рдорддрджрд╛рди рдмрд╛рдХрд╕
тЬП => тЬП, рд╢рд┐рд╢рд╛ рдХрд▓рдо
тЬТ => тЬТ, рдХрд▓рдо, рдХрд╛рд▓реЛ рдирд┐рдм, рдирд┐рдм
ЁЯЦЛ => ЁЯЦЛ, рдХрд▓рдо, рдлрд╛рдЙрдиреНрдЯреЗрди, рдлрд╛рдЙрдиреНрдЯреЗрди рдХрд▓рдо
ЁЯЦК => ЁЯЦК, рдХрд▓рдо, рдмрд▓рдкреЛрдЗрдиреНрдЯ
ЁЯЦМ => ЁЯЦМ, рдкреЗрдиреНрдЯрдмреНрд░рд╕, рдкреЗрдиреНрдЯрд┐рдЩреН
ЁЯЦН => ЁЯЦН, рдХреНрд░реЗрдпреЛрди, рдХреНрд░реНрдпреЛрди
ЁЯУЭ => ЁЯУЭ, рдкреЗрдиреНрд╕рд┐рд▓, рдореЗрдореЛ
ЁЯТ╝ => ЁЯТ╝, рдмреНрд░рд┐рдлрдХреЗрд╕
ЁЯУБ => ЁЯУБ, рдлрд╛рдЗрд▓, рдлрд╛рдЗрд▓ рдлреЛрд▓реНрдбрд░, рдлреЛрд▓реНрдбрд░
ЁЯУВ => ЁЯУВ, рдЦреБрд▓рд╛ рдлрд╛рдЗрд▓рдХреЛ рдлреЛрд▓реНрдбрд░, рдЦреЛрд▓реНрди, рдлрд╛рдЗрд▓, рдлреЛрд▓реНрдбрд░
ЁЯЧВ => ЁЯЧВ, рдХрд╛рд░реНрдб, рдХрд╛рд░реНрдб рд╕реВрдЪрдХ рдбреНрд░рд╛рдЗрднрд░рд╣рд░реВ, рдбреНрд░рд╛рдЗрднрд░рд╣рд░реВ, рд╕реВрдЪрдХ
ЁЯУЕ => ЁЯУЕ, рдкрд╛рддреНрд░реЛ, рдорд┐рддрд┐
ЁЯУЖ => ЁЯУЖ, рдЯрд┐рдпрд░-рдЕрдл-рдкрд╛рддреНрд░реЛ, рдкрд╛рддреНрд░реЛ
ЁЯЧТ => ЁЯЧТ, рдиреЛрдЯ, рдкреНрдпрд╛рдб, рд╕реНрдкрд╛рдЗрд░рд▓, рд╕реНрдкрд╛рдЗрд░рд▓ рдиреЛрдЯрдкреНрдпрд╛рдб
ЁЯЧУ => ЁЯЧУ, рдкрд╛рддреНрд░реЛ, рдкреНрдпрд╛рдб, рд╕реНрдкрд╛рдЗрд░рд▓, рд╕реНрдкрд╛рдЗрд░рд▓ рдкрд╛рддреНрд░реЛ
ЁЯУЗ => ЁЯУЗ, рдХрд╛рд░реНрдб, рдХрд╛рд░реНрдб рд╕реВрдЪрдХ, рд░реЛрд▓реЛрдбреЗрдХреНрд╕, рд╕реВрдЪрдХ
ЁЯУИ => ЁЯУИ, рдЧреНрд░рд╛рдл, рдЪрд╛рд░реНрдЯ, рдЯреНрд░реЗрдиреНрдЯ, рдмрдвреНрджреЛ рдЪрд╛рд░реНрдЯ, рдорд╛рдерд┐, рд╡рд┐рдХрд╛рд╕
ЁЯУЙ => ЁЯУЙ, рдШрдЯреНрджреЛ рдЪрд╛рд░реНрдЯ, рдЪрд╛рд░реНрдЯ рдШрдЯреНрджреЛ
ЁЯУК => ЁЯУК, рдЧреНрд░рд╛рдл, рдЪрд╛рд░реНрдЯ, рдмрд╛рд░, рдмрд╛рд░ рдЪрд╛рд░реНрдЯ
ЁЯУЛ => ЁЯУЛ, рдХреНрд▓рд┐рдкрдмреЛрд░реНрдб
ЁЯУМ => ЁЯУМ, рдкрдЬрдкрд┐рди, рдкреБрд╕рдкрд┐рди
ЁЯУН => ЁЯУН, рдШреБрдорд╛рдЙрд░реЛ рдкреБрд╕рдкрд┐рди, рдкрдЬрдкрд┐рди, рдкрд┐рди
ЁЯУО => ЁЯУО, рдкреЗрдкрд░рдХреНрд▓рд┐рдк
ЁЯЦЗ => ЁЯЦЗ, рдкреЗрдкрд░рдХреНрд▓рд┐рдкрд╣рд░реВ, рд▓рд┐рдЩреНрдХ, рд▓рд┐рдЩреНрдХ рдЧрд░рд┐рдПрдХреЛ рдкреЗрдкрд░рдХреНрд▓рд┐рдкрд╣рд░реВ
ЁЯУП => ЁЯУП, рд╕рд┐рдзрд╛ рдХрд┐рдирд╛рд░рд╛, рд╕рд┐рдзрд╛ рд╕реНрдХреЗрд▓, рд╕реНрдХреЗрд▓
ЁЯУР => ЁЯУР, рддреНрд░рд┐рдХреЛрдг, рддреНрд░рд┐рдХреЛрдгрд┐рдп рд╕реНрдХреЗрд▓, рд╕реЗрдЯ, рд╕реНрдХреЗрд▓
тЬВ => тЬВ, рдХреИрдБрдЪреА, рд╕рд╛рдзрди
ЁЯЧГ => ЁЯЧГ, рдХрд╛рд░реНрдб, рдХрд╛рд░реНрдб рдлрд╛рдЗрд▓ рдмрд╛рдХрд╕, рдлрд╛рдЗрд▓, рдмрдХреНрд╕
ЁЯЧД => ЁЯЧД, рдХреНрдпрд╛рдмрд┐рдиреЗрдЯ, рдлрд╛рдЗрд▓, рдлрд╛рдЗрд▓ рдХреНрдпрд╛рдмрд┐рдиреЗрдЯ
ЁЯЧС => ЁЯЧС, рдлреЛрд╣реЛрд░ рдлрд╛рд▓реНрдиреЗ рдбрд╛рд▓реЛ
ЁЯФТ => ЁЯФТ, рдмрдиреНрдж рдЧрд░реЗрдХреЛ, рд▓рдХ
ЁЯФУ => ЁЯФУ, рдЦреБрд▓рд╛, рдЦреБрд▓рд╛ рд▓рдХ, рддрд╛рд▓реНрдЪрд╛, рддрд╛рд▓реНрдЪрд╛ рдЦреЛрд▓реНрди
ЁЯФП => ЁЯФП, рдХрд▓рдорд╕рд╣рд┐рддрдХреЛ рд▓рдХ, рдкреЗрди рд╕рд╣рд┐рддрдХреЛ рд▓рдХ
ЁЯФР => ЁЯФР, рдмрдиреНрдж, рдмрдиреНрдж рддрд╛рд▓рд╛ рд░ рдЪрд╛рдмреА, рд▓рдХ, рд╕рд╛рдБрдЪреЛ, рд╕реБрд░рдХреНрд╖рд┐рдд
ЁЯФС => ЁЯФС, рддрд╛рд▓реНрдЪрд╛, рдкрд╛рд╕рд╡рд░реНрдб, рд╕рд╛рдБрдЪреЛ
ЁЯЧЭ => ЁЯЧЭ, рддрд╛рд▓реНрдЪрд╛, рдкреБрд░рд╛рдиреЛ, рдкреБрд░рд╛рдиреЛ рд╕рд╛рдБрдЪреЛ, рд╕рдВрдХреЗрдд, рд╕рд╛рдБрдЪреЛ
ЁЯФи => ЁЯФи, рдШрди, рд╕рд╛рдзрди
тЫП => тЫП, рдЙрдард╛рдЙрдиреЗ, рд╕рд╛рдзрди
тЪТ => тЪТ, рдЙрдард╛рдЙрдиреЗ, рдШрди, рдШрди рд░ рдЙрдард╛рдЙрдиреЗ, рд╕рд╛рдзрди
ЁЯЫа => ЁЯЫа, рдШрди, рдШрди рд░ рд░рд┐рдиреНрдЪ, рд░рд┐рдиреНрдЪ, рд╕рд╛рдзрди
ЁЯЧб => ЁЯЧб, рдЪрдХреНрдХреБ, рдбреНрдпрд╛рдЧрд░, рд╣рддрд┐рдпрд╛рд░
тЪФ => тЪФ, рдХреНрд░рд╕, рдХреНрд░рд╕ рддрд░рд╡рд╛рд░, рддрд░рд╡рд╛рд░, рд╣рддрд┐рдпрд╛рд░
ЁЯФл => ЁЯФл, рдкрд┐рд╕реНрддреЛрд▓, рдмрдиреНрджреБрдХ, рд░рд┐рднрд▓реНрдмрд░, рд╕рд╛рдзрди, рд╣рддрд┐рдпрд╛рд░
ЁЯП╣ => ЁЯП╣, рддреАрд░, рдзрдиреБрд╖ рдмрд╛рдг, рдзрдиреБрд╖ рд╣рд╛рдиреНрдиреЗ
ЁЯЫб => ЁЯЫб, рдврд╛рд▓, рд╣рддрд┐рдпрд╛рд░
ЁЯФз => ЁЯФз, рд░рд┐рдиреНрдЪ, рд╕рд╛рдзрди
ЁЯФй => ЁЯФй, рдирдЯ, рдирдЯ рд░ рдмреЛрд▓реНрдЯ, рдмреЛрд▓реНрдЯ, рд╕рд╛рдзрди
тЪЩ => тЪЩ, рдЧрд┐рдпрд░, рд╕рд╛рдзрди
ЁЯЧЬ => ЁЯЧЬ, рднрд╛рдЗрд╕, рд╕рдВрдХреБрдЪрди, рд╕рд╛рдзрди
тЪЧ => тЪЧ, рдРрд▓реЗрдореНрдмрд┐рдХ, рдХреЗрдореЗрд╕реНрдЯреНрд░рд┐, рд╕рд╛рдзрди
тЪЦ => тЪЦ, рддреБрд▓рд╛, рддреМрд▓, рдиреНрдпрд╛рдп, рд░рд╛рд╢рд┐, рд╕рдиреНрддреБрд▓рди, рд╕рдиреНрддреБрд▓рди рд╕реНрдХреЗрд▓, рд╕рд╛рдзрди, рд╕реНрдХреЗрд▓
ЁЯФЧ => ЁЯФЧ, рд▓рд┐рдВрдХ
тЫУ => тЫУ, рдЪреЗрди
ЁЯТЙ => ЁЯТЙ, рдФрд╖рдзрд┐, рдбрдХреНрдЯрд░, рдмрд┐рдорд╛рд░реА, рд╕рдЯ, рд╕рд╛рдзрди, рд╕реБрдИ, рд╕реВрдИ
ЁЯТК => ЁЯТК, рдФрд╖рдзрд┐, рдФрдВрд╖рдзреАрдХреЛ рдЧреЛрд▓реА, рдбрд╛реНрдХреНрдЯрд░, рдмрд┐рд░рд╛рдореА
ЁЯЪм => ЁЯЪм, рдзреБрдореНрд░рдкрд╛рди
тЪ░ => тЪ░, рдХрдлрд┐рди, рдореГрддреНрдпреБ
тЪ▒ => тЪ▒, рдЕрд░реНрди, рдорд▓рд╛рдо, рдорд▓рд╛рдо рдЕрд░реНрди, рдореГрддреНрдпреБ
ЁЯЧ┐ => ЁЯЧ┐, рдЕрдиреБрд╣рд╛рд░, рдореВрд░реНрддрд┐, рдореЛрд╡рдИ
ЁЯЫв => ЁЯЫв, рдбреНрд░рдо, рддреЗрд▓, рддреЗрд▓рдХреЛ рдбреНрд░рдо
ЁЯФо => ЁЯФо, рдХреНрд░рд┐рд╕реНрдЯрд▓, рдХреНрд░рд┐рд╕реНрдЯрд▓ рдмрд▓, рдЦреЗрд╕реНрд░рд╛ рдХрд▓реНрдкрдирд╛, рдкрд░реАрдХреЛ рдХрдерд╛, рдмрд▓, рднрд╛рдЧреНрдп, рд╕рд╛рдзрди
ЁЯЫТ => ЁЯЫТ, рдХрд╛рд░реНрдЯ, рдХрд┐рдирдореЗрд▓, рдХрд┐рдирдореЗрд▓ рдЧрд░реНрдиреЗ рдХрд╛рд░реНрдЯ, рдЯреНрд░рд▓реА
ЁЯПз => ЁЯПз, рдЕрдЯреЛрдореЗрдЯреЗрдб, рдПрдЯрд┐рдПрдо, рдПрдЯрд┐рдПрдордХреЛ рд╕рдВрдХреЗрдд, рдЯреЗрд▓рд░, рд░рд┐рдХреНрдд
ЁЯЪо => ЁЯЪо, рдмрд┐рди рд╕рдВрдХреЗрддрдорд╛ рдлреЛрд╣реЛрд░ рд░рд╛рдЦреНрдиреЗ рднрд╛рдБрдбреЛ, рдмрд┐рди рд╕рд╛рдЗрдирдХреЛ рд▓рд┐рдЯрд░
ЁЯЪ░ => ЁЯЪ░, рдкрд╛рдиреА, рдкрд┐рдЙрди рдпреЛрдЧреНрдп рдкрд╛рдиреА, рдкрд┐рдЙрдирдпреЛрдЧреНрдп, рдкрд┐рдЙрдиреЗ
тЩ┐ => тЩ┐, рдкрд╣реБрдБрдЪ, рд╣реНрд╡реАрд▓рдЪреЗрдпрд░
ЁЯЪ╣ => ЁЯЪ╣, рдЖрд░рд╛рдо рдЧрд░реНрдиреЗ рдХреЛрдард╛, рдЖрд░рд╛рдордЧреГрд╣, рдкрд╛рдиреАрдХреЛ рд╢реМрдЪрдШрд░, рдкреБрд░реБрд╖, рдкреБрд░реБрд╖рдХреЛ рдХреЛрдард╛
ЁЯЪ║ => ЁЯЪ║, рдЖрд░рд╛рдордЧреГрд╣, рдкрд╛рдиреАрдХреЛ рд╢реМрдЪрдШрд░, рдорд╣рд┐рд▓рд╛, рдорд╣рд┐рд▓рд╛рдХреЛ рдХреЛрдард╛, рд╡рд┐рд╢реНрд░рд╛рдо рдЧреГрд╣
ЁЯЪ╗ => ЁЯЪ╗, рдЖрд░рд╛рдордЧреГрд╣, рдкрд╛рдиреАрдХреЛ рд╢реМрдЪрдШрд░, рд╢реМрдВрдЪрд╛рд▓рдп
ЁЯЪ╝ => ЁЯЪ╝, рдкрд░рд┐рд╡рд░реНрддрди рдЧрд░рд┐рд░рд╣реЗрдХреЛ, рдмрдЪреНрдЪрд╛, рдмрдЪреНрдЪрд╛рдХреЛ рд╕рдВрдХреЗрдд
ЁЯЪ╛ => ЁЯЪ╛, рдЖрд░рд╛рдордЧреГрд╣, рдкрд╛рдиреА, рдкрд╛рдиреАрдХреЛ рдХреБрд╡рд╛, рдкрд╛рдиреАрдХреЛ рд╢реМрдЪрдШрд░, рд╢реМрдЪрдШрд░, рд╢реМрдЪрд╛рд▓рдп
ЁЯЫВ => ЁЯЫВ, рдЪреЗрдХрдЬрд╛рдБрдЪ, рдкрд╛рд╕рдкреЛрд░реНрдЯ, рдкрд╛рд╕рдкреЛрд░реНрдЯ рдЪреЗрдХрдЬрд╛рдБрдЪ
ЁЯЫГ => ЁЯЫГ, рднрдиреНрд╕рд╛рд░, рд░реАрддрд┐рд░рд┐рд╡рд╛рдЬ
ЁЯЫД => ЁЯЫД, рджрд╛рд╡реА, рдмреНрдпрд╛рдЧреЗрдЬ, рдмреНрдпрд╛рдЧреЗрдЬ рдХреНрд▓реЗрдо
ЁЯЫЕ => ЁЯЫЕ, рдЫрд╛рдбрд┐рдПрдХреЛ рд╕рд╛рдорд╛рди, рдмреНрдпрд╛рдЧреЗрдЬ, рд▓рдХрд░, рд▓рдЧреЗрдЬ
тЪа => тЪа, рдЪреЗрддрд╛рд╡рдиреА
ЁЯЪ╕ => ЁЯЪ╕, рдХреНрд░рд╕ рдЧрд░реНрджреИ, рдЯреНрд░рд╛рдлрд┐рдХ, рдкрджрдпрд╛рддреНрд░реА, рдмрдЪреНрдЪрд╛, рдмрдЪреНрдЪрд╛рд▓реЗ рдмрд╛рдЯреЛ рдХрд╛рдЯреНрджреИ
тЫФ => тЫФ, рдЫреИрди, рдЯреНрд░рд╛рдлрд┐рдХ, рдирд┐рд╖реЗрдзрд┐рдд, рдкреНрд░рд╡реЗрд╢, рдкреНрд░рд╡реЗрд╢ рдЫреИрди, рд░реЛрдХрд┐рдПрдХреЛ, рд╣реЛрдЗрди
ЁЯЪл => ЁЯЪл, рдЫреИрди, рдирд┐рд╖реЗрдзрд┐рдд, рдкреНрд░рд╡реЗрд╢, рд░реЛрдХрд┐рдПрдХреЛ, рд╣реЛрдЗрди
ЁЯЪ│ => ЁЯЪ│, рдЫреИрди, рдирд┐рд╖реЗрдзрд┐рдд, рдмрд╛рдЗрдХ, рд░реЛрдХрд┐рдПрдХреЛ, рд╕рд╡рд╛рд░реА, рд╕рд╛рдЗрдХрд▓, рд╕рд╛рдЗрдХрд▓ рдЪрд▓рд╛рдЙрди рдкрд╛рдЗрдБрджреИрди, рд╣реЛрдЗрди
ЁЯЪн => ЁЯЪн, рдЫреИрди, рдзреБрдореНрд░рдкрд╛рди, рдзреБрдореНрд░рдкрд╛рди рдЧрд░реНрди рдкрд╛рдЗрдБрджреИрди, рдирд┐рд╖реЗрдзрд┐рдд, рд░реЛрдХрд┐рдПрдХреЛ, рд╣реЛрдЗрди
ЁЯЪп => ЁЯЪп, рдЫреИрди, рдирд┐рд╖реЗрдзрд┐рдд, рдлреЛрд╣реЛрд░ рдлрд╛рд▓реНрди рдкрд╛рдЗрдБрджреИрди, рд░реЛрдХрд┐рдПрдХреЛ, рд▓рд┐рдЯрд░, рд╣реЛрдЗрди
ЁЯЪ▒ => ЁЯЪ▒, рдЫреИрди, рдкрд╛рдиреА, рдкрд┐рдЙрди, рдкрд┐рдЙрди-рдЕрдпреЛрдЧреНрдп рдкрд╛рдиреА, рдкреАрдЙрдирдпреЛрдЧреНрдп рдкрджрдпрд╛рддреНрд░реА, рд░реЛрдХрд┐рдПрдХреЛ, рд╣реЛрдЗрди
ЁЯЪ╖ => ЁЯЪ╖, рдЫреИрди, рдирд┐рд╖реЗрдзрд┐рдд, рдкрджрдпрд╛рддреНрд░реА, рдкрджрдпрд╛рддреНрд░реАрд╣рд░реВрдХреЛ рд▓рд╛рдЧрд┐ рд╣реЛрдЗрди, рд░реЛрдХрд┐рдПрдХреЛ, рд╣реЛрдЗрди
ЁЯУ╡ => ЁЯУ╡, рдЫреИрди, рдЯреЗрд▓рд┐рдлреЛрди, рдирд┐рд╢реЗрд╖рд┐рдз, рдлреЛрди, рдореЛрдмрд╛рдЗрд▓, рдореЛрдмрд╛рдЗрд▓ рдлреЛрдирд▓рд╛рдИ рдЕрдиреБрдорддрд┐ рдЫреИрди, рд░реЛрдХрд┐рдПрдХреЛ, рд╕реЗрд▓, рд╣реЛрдЗрди
ЁЯФЮ => ЁЯФЮ, резрео рдЙрдореЗрд░ рдкреНрд░рддрд┐рдмрдиреНрдз, рдЕрдард╛рд░, рдХрдо рдЙрдореЗрд░, рдХреЛрд╣реА рдкрдирд┐ рдЕрдард╛рд░ рднрдиреНрджрд╛ рдХрдо рд╣реБрдиреБрд╣реБрдБрджреИрди, рдЫреИрди, рдирд┐рд╖реЗрдзрд┐рдд, рд░реЛрдХрд┐рдПрдХреЛ, рд╣реЛрдЗрди
тШв => тШв, рдЪрд┐рдиреНрд╣, рд░реЗрдбрд┐рдпреЛрдПрдХреНрдЯрд┐рдн
тШг => тШг, рдЪрд┐рдиреНрд╣, рдмрд╛рдпреЛрд╣рд╛рдЬрд╛рд░реНрдб
тмЖ => тмЖ, рдЙрддреНрддрд░, рдХрд╛рд░реНрдбрд┐рдирд▓, рджрд┐рд╢рд╛, рдорд╛рдерд┐ рд╡рд╛рдг, рд╡рд╛рдг
тЖЧ => тЖЧ, рдЙрддреНрддрд░рджрдХреНрд╖реАрдг, рдХрд╛рд░реНрдбрд┐рдирд▓ рд╡рд┐рдкрд░рд┐рдд, рджрд┐рд╢рд╛, рдорд╛рдерд┐-рджрд╛рдпрд╛рдБ рд╡рд╛рдг, рд╡рд╛рдг
тЮб => тЮб, рдХрд╛рд░реНрдбрд┐рдирд▓, рддреАрд░, рджрд╛рдпрд╛рдБ рддрд░реНрдлрдХреЛ рддреАрд░, рджрд┐рд╢рд╛, рдкреВрд░реНрд╡
тЖШ => тЖШ, рдЗрдиреНрдЯрд░рдХрд╛рд░реНрдбрд┐рдирд▓, рддрд▓ рджрд╛рдпрд╛рдБрддрд░реНрдлрдХреЛ рддреАрд░, рддреАрд░, рджрдХреНрд╖рд┐рдг рдкреВрд░реНрд╡, рджрд┐рд╢рд╛
тмЗ => тмЗ, рдХрд╛рд░реНрдбрд┐рдирд▓, рддрд▓, рддрд▓рддрд░реНрдлрдХреЛ рддреАрд░, рддреАрд░, рджрдХреНрд╖рд┐рдг, рджрд┐рд╢рд╛
тЖЩ => тЖЩ, рдЗрдиреНрдЯрд░рдХрд╛рд░реНрдбрд┐рдирд▓, рддрд▓ рдмрд╛рдпрд╛рдБрддрд░реНрдлрдХреЛ рддреАрд░, рддреАрд░, рджрдХреНрд╖рд┐рдг рдкреВрд░реНрд╡, рджрд┐рд╢рд╛
тмЕ => тмЕ, рдХрд╛рд░реНрдбрд┐рдирд▓, рддреАрд░, рджрд┐рд╢рд╛, рдкрд╢реНрдЪрд┐рдо, рдмрд╛рдпрд╛рдБрддрд░реНрдлрдХреЛ рддреАрд░
тЖЦ => тЖЦ, рдЗрдиреНрдЯрд░рдХрд╛рд░реНрдбрд┐рдирд▓, рдЙрддреНрддрд░ рдкрд╢реНрдЪрд┐рдо, рддреАрд░, рджрд┐рд╢рд╛, рдорд╛рдерд┐ рдмрд╛рдпрд╛рддрд░реНрдлрдХреЛ рддреАрд░
тЖХ => тЖХ, рдорд╛рдерд┐-рддрд▓ рд╡рд╛рдг, рд╡рд╛рдг
тЖФ => тЖФ, рдмрд╛рдпрд╛рдБ-рджрд╛рдпрд╛рдБ рд╡рд╛рдг, рд╡рд╛рдг
тЖй => тЖй, рдмрд╛рдпрд╛рдБ рдореЛрдбреЗрдХреЛ рджрд╛рдпрд╛рдБ рд╡рд╛рдг, рд╡рд╛рдг
тЖк => тЖк, рджрд╛рдпрд╛рдБ рдореЛрдбреЗрдХреЛ рдмрд╛рдпрд╛рдБ рд╡рд╛рдг, рд╡рд╛рдг
тд┤ => тд┤, рдорд╛рдерд┐ рдореЛрдбреЗрдХреЛ рджрд╛рдпрд╛рдБ рд╡рд╛рдг, рд╡рд╛рдг
тд╡ => тд╡, рддрд▓, рддрд▓ рдореЛрдбреЗрдХреЛ рджрд╛рдпрд╛рдБ рд╡рд╛рдг, рд╡рд╛рдг
ЁЯФГ => ЁЯФГ, рдШрдбреАрдХреЛ рджрд┐рд╢рд╛ рддрд┐рд░, рдШрдбреАрдХреЛ рджрд┐рд╢рд╛рддрд┐рд░ рдард╛рдбреЛ рд╡рд╛рдгрд╣рд░реВ, рдкреБрдирдГ рд▓реЛрдб, рд╡рд╛рдг
ЁЯФД => ЁЯФД, рдШрдбреАрдХреЛ рджрд┐рд╢рд╛ рддрд┐рд░, рдШрдбреАрдХреЛ рджрд┐рд╢рд╛ рд╡рд┐рдкрд░реАрдд рддрд┐рд░, рдШрдбреАрдХреЛ рджрд┐рд╢рд╛рд╡рд┐рдкрд░реАрддрддрд┐рд░ рд╡рд╛рдгрд╣рд░реВрдХреЛ рдмрдЯрди, рд╡рд╛рдг, рд╡рд┐рдерд░рд╕рд┐рдиреНрди
ЁЯФЩ => ЁЯФЩ, рдкрдЫрд╛рдбрд┐ рдЬрд╛рдиреЗ, рдкрдЫрд╛рдбрд┐ рд╕рдВрдХреЗрдд рдЧрд░реНрдиреЗ рд╡рд╛рдг, рд╡рд╛рдг
ЁЯФЪ => ЁЯФЪ, рдЕрдиреНрддрд┐рдо, рд╡рд╛рдг, рд╕рдХрд┐рдПрдХреЛ рд╕рдВрдХреЗрдд рдЧрд░реНрдиреЗ рд╡рд╛рдг
ЁЯФЫ => ЁЯФЫ, рдЪрд▓рд┐рд░рд╣реЗрдХреЛ! рд╕рдВрдХреЗрдд рдЧрд░реНрдиреЗ рд╡рд╛рдг, рдЪрд┐рдиреНрд╣, рдорд╛, рд╡рд╛рдг
ЁЯФЬ => ЁЯФЬ, рдЖрдЙрдиреЗ, рдЫрд┐рдЯреНрдЯреИ рдЖрдЙрдиреЗ рд╕рдВрдХреЗрдд рдЧрд░реНрдиреЗ рд╡рд╛рдг, рд╡рд╛рдг
ЁЯФЭ => ЁЯФЭ, рдорд╛рдерд┐, рдорд╛рдерд┐рдХреЛ рд╕рдВрдХреЗрдд рдЧрд░реНрдиреЗ рд╡рд╛рдг, рд╡рд╛рдг, рд╢реАрд░реНрд╖
ЁЯЫР => ЁЯЫР, рдзрд░реНрдо, рдкреВрдЬрд╛ рдЧрд░реНрдиреЗ, рдкреВрдЬрд╛ рдЧрд░реНрдиреЗ рдард╛рдЙрдБ
тЪЫ => тЪЫ, рдирд╛рд╕реНрддрд┐рдХ, рдкрд░рдорд╛рдгреБ, рдкрд░рдорд╛рдгреБрдХреЛ рд╕рдВрдХреЗрдд
ЁЯХЙ => ЁЯХЙ, рдУрдо, рдзрд░реНрдо, рд╣рд┐рдиреНрджреБ
тЬб => тЬб, рдбреЗрднрд┐рдб, рдбреЗрднрд┐рдбрдХреЛ рддрд╛рд░рд╛, рддрд╛рд░рд╛, рдзрд░реНрдо, рдпрд╣реВрджреА
тШ╕ => тШ╕, рдзрд░реНрдо, рдзрд░реНрдордХреЛ рдкрд╛рдЩреНрдЧреНрд░рд╛, рдзрд░реНрдорд╛, рдкрд╛рдЩреНрдЧреНрд░рд╛, рдмреБрджреНрдзрд┐рд╕реНрдЯ
тШп => тШп, рдЯрд╛рд╡рд┐рд╕реНрдЯ, рдЯрд╛рд╡реЛ, рдзрд░реНрдо, рдпрд╛рдЩреНрдЧ, рдпрд┐рди, рдпрд┐рди рдпрд╛рдЩреНрдЧ
тЬЭ => тЬЭ, рдХреНрд░рд╕, рдХреНрд░рд┐рд╕реНрдЪрд┐рдпрди, рдзрд░реНрдо, рд▓реНрдпрд╛рдЯрд┐рди рдХреНрд░рд╕
тШж => тШж, рдЕрд░реНрдердбрдХреНрд╕ рдХреНрд░рд╕, рдХреНрд░рд╕, рдХреНрд░рд┐рд╕реНрдЪрд┐рдпрди, рдзрд░реНрдо
тШк => тШк, рдЗрд╕реНрд▓рд╛рдо, рддрд╛рд░рд╛ рд░ рдЕрд░реНрдзрдЪрдиреНрджреНрд░, рдзрд░реНрдо, рдореБрд╕реНрд▓рд┐рдо
тШо => тШо, рд╢рд╛рдиреНрддрд┐, рд╢рд╛рдиреНрддрд┐рдХреЛ рдкреНрд░рддрд┐рдХ
ЁЯХО => ЁЯХО, рдХреНрдпрд╛рдиреНрдбреЗрд▓рд╕реНрдЯрд┐рдХ, рдХреНрдпрд╛рдиреНрдбреЗрд▓рд╛рдмреНрд░рдо, рдзрд░реНрдо, рдордиреЛрд░рд╛рд╣
ЁЯФп => ЁЯФп, рдбрдЯ рдЧрд░реЗрдХреЛ-рдЫ-рд╡рд┐рдиреНрджреВ рддрд╛рд░рд╛, рддрд╛рд░рд╛, рднрд╛рдЧреНрдп
тЩИ => тЩИ, рдореЗрд╖, рд░рд╛рдо, рд░рд╛рд╢рд┐
тЩЙ => тЩЙ, рдЧреЛрд░реВ, рд░рд╛рд╢рд┐, рд╡реГрд╖
тЩК => тЩК, рдорд┐рдереБрди, рд░рд╛рд╢рд┐, рд╕рдорд╛рди
тЩЛ => тЩЛ, рдХрд░реНрдХрдЯ, рд░рд╛рд╢рд┐
тЩМ => тЩМ, рд░рд╛рд╢рд┐, рд╕рд┐рдВрд╣
тЩН => тЩН, рдХрдиреНрдпрд╛, рдХреБрдорд╛рд░реА, рд░рд╛рд╢рд┐
тЩО => тЩО, рддреБрд▓рд╛, рдиреНрдпрд╛рдп, рд░рд╛рд╢рд┐, рд╕рдиреНрддреБрд▓рди, рд╕реНрдХреЗрд▓
тЩП => тЩП, рд░рд╛рд╢рд┐, рд╡рд┐рдЪреНрдЫреБ, рд╡реГрд╢реНрдЪрд┐рдХ
тЩР => тЩР, рдзрдиреБ, рд░рд╛рд╢рд┐
тЩС => тЩС, рдмрд╛рдЦреНрд░рд╛, рдордХрд░, рд░рд╛рд╢рд┐
тЩТ => тЩТ, рдХреБрдореНрдн, рдзрд╛рд░рдХ, рдкрд╛рдиреА, рд░рд╛рд╢рд┐
тЩУ => тЩУ, рдорд╛рдЫрд╛, рдорд┐рди, рд░рд╛рд╢рд┐
тЫО => тЫО, рдЕрдлрд┐рдХреБрдЕрд╕, рдзрд╛рд░рдХ, рдирд╛рдЧ, рд░рд╛рд╢рд┐, рд╕рд░реНрдк
ЁЯФА => ЁЯФА, рдХреНрд░рд╕ рдЧрд░реЗрдХреЛ, рдЯреНрд░рдпрд╛рдХрд╣рд░реВрдХреЛ рдмрдЯрди рдмрджрд▓реНрди, рд╡рд╛рдг
ЁЯФБ => ЁЯФБ, рдШрдбреАрдХреЛ рджрд┐рд╢рд╛рддрд┐рд░, рджреЛрд╣реЛрд░реНрдпрд╛рдЙрди, рджреЛрд╣реЛрд░реНрдпрд╛рдЙрдиреЗ рдмрдЯрди, рд╡рд╛рдг
ЁЯФВ => ЁЯФВ, рдПрдХ рдкрдЯрдХ, рдПрдХреИрд▓рд╛рдИ рджреЛрд╣реЛрд░реНрдпрд╛рдЙрдиреЗ рдмрдЯрди, рдШрдбреАрдХреЛ рджрд┐рд╢рд╛рддрд┐рд░, рд╡рд╛рдг
тЦ╢ => тЦ╢, рддреНрд░рд┐рдХреЛрдг, рджрд╛рдпрд╛рдБ, рдмрдЬрд╛рдЙрди, рдмрдЬрд╛рдЙрдиреЗ рдмрдЯрди, рд╡рд╛рдг
тПй => тПй, рдЫрд┐рдЯреЛ, рдЫрд┐рдЯреЛ-рдлрд░реНрд╡рд╛рдб рдЧрд░реНрдиреЗ рдмрдЯрди, рджреЛрд╣реЛрд░реЛ, рдлрд░реНрд╡рд╛рдб, рд╡рд╛рдг
тПн => тПн, рдЕрд░реНрдХреЛ рдЯреНрд░рдпрд╛рдХ, рдЕрд░реНрдХреЛ рдЯреНрд░рдпрд╛рдХ рдЧрд░реНрдиреЗ рдмрдЯрди, рдЕрд░реНрдХреЛ рджреГрд╢реНрдп, рддреНрд░рд┐рдХреЛрдг, рд╡рд╛рдг
тПп => тПп, рддреНрд░рд┐рдХреЛрдг, рджрд╛рдпрд╛рдБ, рдмрдЬрд╛рдЙрдиреЗ, рдмрдЬрд╛рдЙрдиреЗ рд╡рд╛ рд░реЛрдХреНрдиреЗ рдмрдЯрди, рд░реЛрдХреНрдиреЗ, рд╡рд╛рдг
тЧА => тЧА, рдЙрд▓реНрдЯреНрдпрд╛рдЙрди, рдЙрд▓реНрдЯреНрдпрд╛рдЙрдиреЗ рдмрдЯрди, рддреНрд░рд┐рдХреЛрдг, рдмрд╛рдпрд╛рдБ, рд╡рд╛рдг
тПк => тПк, рдЫрд┐рдЯреЛ рдЙрд▓реНрдЯреНрдпрд╛рдЙрдиреЗ рдмрдЯрди, рджреЛрд╣реЛрд░реЛ, рджреЛрд╣реЛрд░реНрдпрд╛рдЙрди, рд╡рд╛рдг
тПо => тПо, рдЕрдШрд┐рд▓реНрд▓реЛ рдЯреНрд░рдпрд╛рдХ, рдЕрдШрд┐рд▓реНрд▓реЛ рджреГрд╢реНрдп, рдЕрдиреНрддрд┐рдо рдЯреНрд░рдпрд╛рдХ рдмрдЯрди, рддреНрд░рд┐рдХреЛрдг, рд╡рд╛рдг
ЁЯФ╝ => ЁЯФ╝, рдмрдЯрди, рдорд╛рдерд┐рдХреЛ рдмрдЯрди, рд░рд╛рддреЛ, рд╡рд╛рдг
тПл => тПл, рдЫрд┐рдЯреЛ рдорд╛рдерд┐ рдЬрд╛рдиреЗ рдмрдЯрди, рджреЛрд╣реЛрд░реЛ, рд╡рд╛рдг
ЁЯФ╜ => ЁЯФ╜, рддрд▓, рддрд▓рдХреЛ рдмрдЯрди, рдмрдЯрди, рд░рд╛рддреЛ, рд╡рд╛рдг
тПм => тПм, рдЫрд┐рдЯреЛ рддрд▓ рдЬрд╛рдиреЗ рдмрдЯрди, рддрд▓, рджреЛрд╣реЛрд░реЛ, рд╡рд╛рдг
тП╕ => тП╕, рдард╛рдбреЛ, рджреЛрд╣реЛрд░реЛ, рдкрдЬ рдмрдЯрди, рдкрдЯреНрдЯреА, рд░реЛрдХреНрдиреЗ
тП╣ => тП╣, рд░реЛрдХреНрдиреЗ, рд░реЛрдХреНрдиреЗ рдмрдЯрди, рд╡рд░реНрдЧ
тП║ => тП║, рд░реЗрдХрд░реНрдб, рд░реЗрдХрд░реНрдб рдЧрд░реНрди рдмрдЯрди, рд╕рд░реНрдХрд▓
тПП => тПП, рдмрд╛рд╣рд┐рд░ рдирд┐рд╕реНрдХрдиреЗ, рдмрд╛рд╣рд┐рд░ рдирд┐рд╕реНрдХрдиреЗ рдмрдЯрди
ЁЯОж => ЁЯОж, рдХреНрдпрд╛рдореЗрд░рд╛, рдлрд┐рд▓реНрдо, рд╕рд┐рдиреЗрдорд╛
ЁЯФЕ => ЁЯФЕ, рдХрдо, рдЪрдореНрдХрд┐рд▓реЛ, рдордзреБрд░реЛ, рдордзреБрд░реЛ рдмрдЯрди
ЁЯФЖ => ЁЯФЖ, рдЪрдордХ, рдЪрдореНрдХрд┐рд▓реЛ, рдЪрдореНрдХрд┐рд▓реЛ рдмрдЯрди
ЁЯУ╢ => ЁЯУ╢, рдПрдиреНрдЯреЗрдиреНрдирд╛, рдПрдиреНрдЯреЗрдиреНрдирд╛ рдмрд╛рд░, рдЯреЗрд▓рд┐рдлреЛрди, рдлреЛрди, рдмрд╛рд░, рдореЛрдмрд╛рдЗрд▓, рд╕рд┐рдЧреНрдирд▓, рд╕реЗрд▓
ЁЯУ│ => ЁЯУ│, рдЯреЗрд▓рд┐рдлреЛрди, рдлреЛрди, рднрд╛рдЗрдмреНрд░реЗрд╕рди, рднрд╛рдЗрдмреНрд░реЗрд╕рди рдореЛрдб, рдореЛрдб, рдореЛрдмрд╛рдЗрд▓, рд╕реЗрд▓
ЁЯУ┤ => ЁЯУ┤, рдЯреЗрд▓рд┐рдлреЛрди, рдлреЛрди, рдмрдиреНрдж, рдореЛрдмрд╛рдЗрд▓, рдореЛрдмрд╛рдЗрд▓ рдлреЛрди рдмрдиреНрдж, рд╕реЗрд▓
тЩА => тЩА, рдЫреЛрд░реА рдорд╛рдиреНрдЫреЗ, рдорд╣рд┐рд▓рд╛, рдорд╣рд┐рд▓рд╛ рдЪрд┐рдиреНрд╣
тЩВ => тЩВ, рдЫреЛрд░рд╛ рдорд╛рдиреНрдЫреЗ, рдкреБрд░реВрд╖, рдкреБрд░реВрд╖ рдЪрд┐рдиреНрд╣
тЪХ => тЪХ, рдПрд╕реНрдХреБрд▓рд╛рдкрд┐рдпрд╕, рдФрдВрд╖рдзрд┐, рдЪрд┐рдХрд┐рддреНрд╕реАрдп рдЪрд┐рдиреНрд╣, рд╕реНрдЯрд╛рдл
тЩ╗ => тЩ╗, рд░рд┐рд╕рд╛рдЗрдХрд▓, рд░рд┐рд╕рд╛рдЗрдХрд▓рд┐рдЩреНрдХреЛ рдкреНрд░рддрд┐рдХ
тЪЬ => тЪЬ, рдлреНрд▓рд┐рдЙрд░-рдбреЗ-рд▓рд┐рд╕
ЁЯФ▒ => ЁЯФ▒, рдЙрджреНрдШреЛрд╖рдХ, рдЯреНрд░рд┐рдбреЗрдиреНрдЯ, рдЯреНрд░рд┐рдбреЗрдиреНрдЯ рд░рд╛рдЬрдЪрд┐рдиреНрд╣, рдбреБрдЩреНрдЧрд╛, рдкреНрд░рддрд┐рдХ, рд╕рд╛рдзрди
ЁЯУЫ => ЁЯУЫ, рдирд╛рдо, рдирд╛рдордХреЛ рдмреНрдпрд╛рдбреНрдЬ, рдмреНрдпрд╛рдбреНрдЬ
ЁЯФ░ => ЁЯФ░, рдЪреЗрднрд░реЛрди, рдЬрд╛рдкрд╛рдирд┐рдЬ, рдкрд╣реЗрдБрд▓реЛ, рдкрд╛рдд, рд╕рд╛рдзрди, рд╕реБрд░реБрд╡рд╛рдд рдЧрд░реНрдиреЗ, рд╕реБрд░реБрд╡рд╛рддрдХрд░реНрддрд╛рдХреЛ рд▓рд╛рдЧрд┐ рдЬрд╛рдкрд╛рдирд┐рдЬ рдкреНрд░рддрд┐рдХ
тнХ => тнХ, o, рднрд╛рд░реА рдареВрд▓реЛ рд╡реГрддреНрдд, рд╡реГрддреНрдд
тЬЕ => тЬЕ, рдЪрд┐рдиреНрд╣, рдЬрд╛рдБрдЪ, рд╕реЗрддреЛ рднрд╛рд░реА рдареВрд▓реЛ рдЪрд┐рдиреНрд╣
тШС => тШС, рдЪреЗрдХрдХреЛ рд╕рд╛рде рдорддрджрд╛рди рдмрдХреНрд╕, рдЬрд╛рдБрдЪ, рдмрдХреНрд╕, рдорддрджрд╛рди
тЬФ => тЬФ, рдЪрд┐рдиреНрд╣, рдЬрд╛рдБрдЪ, рднрд╛рд░реА рдЪреЗрдХ рдЪрд┐рдиреНрд╣
тЬЦ => тЬЦ, рдПрдХреНрд╕, рдЧреБрдгрд╛рдЩреНрдХ, рдЧреБрдгрд╛рди, рднрд╛рд░реА рдЧреБрдгрди рдПрдХреНрд╕, рд░рджреНрдж
тЭМ => тЭМ, рдПрдХреНрд╕, рдХреНрд░рд╕ рдЪрд┐рдиреНрд╣, рдЧреБрдгрд╛рдЩреНрдХ, рдЧреБрдгрд╛рди, рдЪрд┐рдиреНрд╣, рд░рджреНрдж
тЭО => тЭО, рдХреНрд░рдо рдЪрд┐рдиреНрд╣ рдмрдЯрди, рдЪрд┐рдиреНрд╣, рд╡рд░реНрдЧ
тЮХ => тЮХ, рдЬреЛрдб, рднрд╛рд░реА рдЬреЛрдб рдЪрд┐рдиреНрд╣, рд╣рд┐рд╕рд╛рдм
тЮЦ => тЮЦ, рдШрдЯрд╛рдЙ, рднрд╛рд░реА рдШрдЯрд╛рдЙ рдЪрд┐рдиреНрд╣, рд╣рд┐рд╕рд╛рдм
тЮЧ => тЮЧ, рднрд╛рдЧ, рднрд╛рд░реА рднрд╛рдЧ рдЪрд┐рдиреНрд╣, рд╣рд┐рд╕рд╛рдм
тЮ░ => тЮ░, рдХрд░реНрд▓реА, рдХрд░реНрд▓реА рд▓реБрдк, рд▓реБрдк
тЮ┐ => тЮ┐, рдХрд░реНрд▓реА, рджреЛрд╣реЛрд░реЛ, рджреЛрд╣реЛрд░реЛ рдХрд░реНрд▓реА рд▓реБрдк, рд▓реБрдк
уА╜ => уА╜, рдЪрд┐рдиреНрд╣, рднрд╛рдЧ, рднрд╛рдЧ рдкреНрд░рддреНрдпрд╛рд╡рд░реНрддрди рдЪрд┐рдиреНрд╣
тЬ│ => тЬ│, рдЖрдард╡рдЯрд╛-рдмреЛрд▓реЗрдХреЛ рддрд╛рд░рд╛рдВрдХрди рдЪрд┐рдиреНрд╣, рддрд╛рд░рд╛рдВрдХрди рдЪрд┐рдиреНрд╣
тЬ┤ => тЬ┤, рдЖрдард╡рдЯрд╛-рд╡рд┐рдиреНрджреВ рднрдПрдХреЛ рддрд╛рд░рд╛, рддрд╛рд░рд╛
тЭЗ => тЭЗ, рдЪрдореНрдХрд┐рдиреЗ
тА╝ => тА╝, рдЪрд┐рдиреНрд╣, рджреЛрд╣реЛрд░реЛ рд╡рд┐рд╕реНрдордпрд╛рдзрд┐рдмреЛрдзрдХ рдЪрд┐рдиреНрд╣, рдмреНрдпрд╛рдЩреНрдмреНрдпрд╛рдЩреН, рд╡рд┐рд░рд╛рдо рдЪрд┐рдиреНрд╣, рд╡рд┐рд╕реНрдордпрд╛рдзрд┐рдмреЛрдзрдХ рдЪрд┐рдиреНрд╣
тБЙ => тБЙ, рдЗрдиреНрдЯреНрд░реЛрдмреНрдпрд╛рдЩреНрдЧ, рдЪрд┐рдиреНрд╣, рдкреНрд░рд╢реНрди, рд╡рд┐рд░рд╛рдо рдЪрд┐рдиреНрд╣, рд╡рд┐рд╕реНрдордпрд╛рдзрд┐рдмреЛрдзрдХ, рд╡рд┐рд╕реНрдордпрд╛рдзрд┐рдмреЛрдзрдХ рдкреНрд░рд╢реНрди рдЪрд┐рдиреНрд╣
тЭУ => тЭУ, рдЪрд┐рдиреНрд╣, рдкреНрд░рд╢реНрди, рдкреНрд░рд╢реНрди рдЪрд┐рдиреНрд╣, рд╡рд┐рд░рд╛рдо рдЪрд┐рдиреНрд╣
тЭФ => тЭФ, рдЪрд┐рдиреНрд╣, рдкреНрд░рд╢реНрди, рдмрд╛рд╣рд┐рд░рд┐ рд░реЗрдЦрд╛, рд╡рд┐рд░рд╛рдо рдЪрд┐рдиреНрд╣, рд╕реЗрддреЛ рдкреНрд░рд╢реНрди рдЪрд┐рдиреНрд╣
тЭХ => тЭХ, рдЪрд┐рдиреНрд╣, рдмрд╛рд╣рд┐рд░рд┐ рд░реЗрдЦрд╛, рд╡рд┐рд░рд╛рдо рдЪрд┐рдиреНрд╣, рд╡рд┐рд╕реНрдордпрд╛рдзрд┐рдмреЛрдзрдХ, рд╕реЗрддреЛ рд╡рд┐рд╕реНрдордпрд╛рдзрд┐рдмреЛрдзрдХ рдЪрд┐рдиреНрд╣
тЭЧ => тЭЧ, рдЪрд┐рдиреНрд╣, рд╡рд┐рд░рд╛рдо рдЪрд┐рдиреНрд╣, рд╡рд┐рд╕реНрдордпрд╛рдзрд┐рдмреЛрдзрдХ, рд╡рд┐рд╕реНрдордпрд╛рдзрд┐рдмреЛрдзрдХ рдЪрд┐рдиреНрд╣
уА░ => уА░, рдЭреБрдиреНрдбрд┐рдПрдХреЛ, рдЭреБрдиреНрдбрд┐рдПрдХреЛ рдбреНрдпрд╛рд╢, рдбреНрдпрд╛рд╢, рд╡рд┐рд░рд╛рдо рдЪрд┐рдиреНрд╣
┬й => ┬й, рдкреНрд░рддрд┐рд▓рд┐рдкрд┐ рдЕрдзрд┐рдХрд╛рд░
┬о => ┬о, рджрд░реНрддрд╛ рдЧрд░рд┐рдПрдХреЛ
тДв => тДв, рдЪрд┐рдиреНрд╣, рдЯрд┐рдПрдо, рд╡реНрдпрд╛рдкрд╛рд░ рдЪрд┐рдиреНрд╣
ЁЯТп => ЁЯТп, резрежреж, рдЕрдВрдХ, рдкреВрд░рд╛, рд╕рдп, рд╕рдпрд╡рдЯрд╛ рдЕрдВрдХрд╣рд░реВ
ЁЯФа => ЁЯФа, рдЕрдХреНрд╖рд░рд╣рд░реВ, рдареВрд▓реЛ рдЕрдХреНрд╖рд░, рд░рд╛рдЦреНрди, рд▓реНрдпрд╛рдЯрд┐рди, рд▓реНрдпрд╛рдЯрд┐рди рдареВрд▓реЛ рдЕрдХреНрд╖рд░ рд░рд╛рдЦреНрди
ЁЯФб => ЁЯФб, рдЕрдХреНрд╖рд░рд╣рд░реВ, рдПрдмреАрд╕реАрдбреА, рд░рд╛рдЦреНрди, рд▓реНрдпрд╛рдЯрд┐рди, рд▓реНрдпрд╛рдЯрд┐рди рд╕рд╛рдиреЛ рдЕрдХреНрд╖рд░ рд░рд╛рдЦреНрди, рд╕рд╛рдиреЛ рдЕрдХреНрд╖рд░
ЁЯФв => ЁЯФв, резреирейрек, рдЕрдВрдХрд╣рд░реВ рд░рд╛рдЦреНрди, рд░рд╛рдЦреНрди, рд╕рдВрдЦреНрдпрд╛рд╣рд░реВ
ЁЯФг => ЁЯФг, рд░рд╛рдЦреНрди, рд╕рдВрдХреЗрддрд╣рд░реВ рд░рд╛рдЦреНрди
ЁЯФд => ЁЯФд, рдЕрдХреНрд╖рд░, рдЕрдХреНрд╖рд░рд╣рд░реВ, рдПрдмреАрд╕реА, рд░рд╛рдЦреНрди, рд▓реНрдпрд╛рдЯрд┐рди, рд▓реНрдпрд╛рдЯрд┐рди рдЕрдХреНрд╖рд░ рд░рд╛рдЦреНрди
ЁЯЕ░ => ЁЯЕ░, рдП, рдП рдмрдЯрди, рд░рдЧрдд
ЁЯЖО => ЁЯЖО, рдПрдмреА, рдПрдмреА рдмрдЯрди, рд░рдЧрдд
ЁЯЕ▒ => ЁЯЕ▒, рдмрд┐, рдмрд┐ рдмрдЯрди, рд░рдЧрдд
ЁЯЖС => ЁЯЖС, рд╕рд┐рдПрд▓, рд╕реНрдХреНрд╡рд╛рдпрд░реНрдб рд╕реАрдПрд▓
ЁЯЖТ => ЁЯЖТ, рдХреВрд▓, рд╕реНрдХреНрд╡рд╛рдпрд░реНрдбреНрдб рдХреБрд▓
ЁЯЖУ => ЁЯЖУ, рдирд┐рдГрд╢реБрд▓реНрдХ, рд╕реНрдХрд╛рд╡рд╛рдпрд░реНрдб рдлреНрд░реА
тД╣ => тД╣, рдЖрдИ, рдЬрд╛рдирдХрд╛рд░реА, рдЬрд╛рдирдХрд╛рд░реАрдХреЛ рд╢реНрд░реЛрдд
ЁЯЖФ => ЁЯЖФ, рдЖрдИрдбреА, рдкрд╣рд┐рдЪрд╛рди, рд╕реНрдХреНрд╡рд╛рдпрд░реНрдб рдЖрдЗрдбреА
тУВ => тУВ, рдПрдо, рдПрдо рдЕрдХреНрд╖рд░рдХреЛ рдЧреЛрд▓реЛрдХреЛ рдЕрдХреНрд╖рд░, рдЧреЛрд▓реЛ
ЁЯЖХ => ЁЯЖХ, рдирдпрд╛рдБ, рд╕реНрдХреНрд╡рд╛рдпрд░реНрдб рдирдпрд╛рдБ
ЁЯЖЦ => ЁЯЖЦ, рдПрдирдЬреА, рд╕реНрдХреНрд╡рд╛рдпрд░реНрдб рдПрдирдЬреА
ЁЯЕ╛ => ЁЯЕ╛, 0 рдмрдЯрди, рд░рдЧрдд
ЁЯЖЧ => ЁЯЖЧ, рдареАрдХ, рд╕реНрдХреНрд╡рд╛рд░реНрдб рдУрдХреЗ
ЁЯЕ┐ => ЁЯЕ┐, рдкрд╛рд░реНрдХрд┐рдЩреН, рдкрд┐ рдмрдЯрди
ЁЯЖШ => ЁЯЖШ, рдПрд╕рдУрдПрд╕, рдорджрдд, рд╕реНрдХреНрд╡рд╛рдпрд░реНрдб рдПрд╕рдУрдПрд╕
ЁЯЖЩ => ЁЯЖЩ, рдЪрд┐рдиреНрд╣, рдорд╛рдерд┐, рдорд╛рдерд┐! рдмрдЯрди
ЁЯЖЪ => ЁЯЖЪ, рдЙрд▓реНрдЯреЛ, рд╡рд┐рдкрд░реАрдд, рд╕реНрдХреНрд╡рд╛рдпрд░реНрдб рднрд░реНрд╕реЗрдЬ
ЁЯИБ => ЁЯИБ, рдЬрд╛рдкрд╛рдирд┐рдЬ, рд╕реНрдХреНрд╡рд╛рдпрд░реНрдб рдХрддрдХрд╛рдирд╛ рдХреЛрдХреЛ
ЁЯИВ => ЁЯИВ, рдЬрд╛рдкрд╛рдирд┐рдЬ, рд╕реНрдХреНрд╡рд╛рдпрд░реНрдб рдХрддрдХрд╛рдирд╛ рдПрд╕рдП
ЁЯИ╖ => ЁЯИ╖, рдЬрд╛рдкрд╛рдирд┐рдЬ, рд╕реНрдХреНрд╡рд╛рдпрд░реНрдб рдЪрдиреНрджреНрд░рдорд╛ рдЖрдЗрдбрд┐рдпреЛрдЧреНрд░рд╛рдл
ЁЯИ╢ => ЁЯИ╢, рдЬрд╛рдкрд╛рдирд┐рдЬ, рд╕реНрдХреНрд╡рд╛рдпрд░реНрдб рднрдПрдХреЛ рдЖрдЗрдбрд┐рдпреЛрдЧреНрд░рд╛рдл
ЁЯИп => ЁЯИп, рдЬрд╛рдкрд╛рдирд┐рдЬ, рд╕реНрдХреНрд╡рд╛рдпрд░реНрдб рдФрдВрд▓рд╛рдХреЛ рдЖрдЗрдбрд┐рдпреЛрдЧреНрд░рд╛рдл
ЁЯЙР => ЁЯЙР, рдЧреЛрд▓реЛ рдлрд╛рдЗрджрд╛ рдЖрдЗрдбрд┐рдпреЛрдЧреНрд░рд╛рдл, рдЬрд╛рдкрд╛рдирд┐рдЬ
ЁЯИ╣ => ЁЯИ╣, рдЬрд╛рдкрд╛рдирд┐рдЬ, рд╕реНрдХреНрд╡рд╛рдпрд░реНрдб рднрд╛рдЧ рд▓рдЧрд╛рдПрдХреЛ рдЖрдЗрдбрд┐рдпреЛрдЧреНрд░рд╛рдл
ЁЯИЪ => ЁЯИЪ, рдЬрд╛рдкрд╛рдирд┐рдЬ, рд╕реНрдХреНрд╡рд╛рдпрд░реНрдб рдиреЗрднрд┐рдЧреЗрд╕рди рдЖрдЗрдбрд┐рдпреЛрдЧреНрд░рд╛рдл
ЁЯИ▓ => ЁЯИ▓, рдЬрд╛рдкрд╛рдирд┐рдЬ, рд╕реНрдХреНрд╡рд╛рдпрд░реНрдб рдирд┐рд╖реЗрдзрд┐рдд рдЖрдЗрдбрд┐рдпреЛрдЧреНрд░рд╛рдл
ЁЯЙС => ЁЯЙС, рдЧреЛрд▓реЛ рд╕реНрд╡реАрдХрд╛рд░реЗрдХреЛ рдЖрдЗрдбрд┐рдпреЛрдЧреНрд░рд╛рдл, рдЪрд┐рдирд┐рдпрд╛рдБ
ЁЯИ╕ => ЁЯИ╕, рдЪрд┐рдирд┐рдпрд╛рдБ, рд╕реНрдХреНрд╡рд╛рдпрд░реНрдб рд▓рд╛рдЧреВ рдЧрд░реНрдиреЗ рдЖрдЗрдбрд┐рдпреЛрдЧреНрд░рд╛рдл
ЁЯИ┤ => ЁЯИ┤, рдЪрд┐рдирд┐рдпрд╛рдБ, рд╕рдБрдЧреИ рд╕реНрдХреНрд╡рд╛рдпрд░реНрдб рдЖрдЗрдбрд┐рдпреЛрдЧреНрд░рд╛рдл
ЁЯИ│ => ЁЯИ│, рдЪрд┐рдирд┐рдпрд╛рдБ, рд╕реНрдХреНрд╡рд╛рдпрд░реНрдб рдЦрд╛рд▓реА рдЖрдЗрдбрд┐рдпреЛрдЧреНрд░рд╛рдл
уКЧ => уКЧ, рдЧреЛрд▓реЛ рдмрдзрд╛рдИ рдЖрдЗрдбрд┐рдпреЛрдЧреНрд░рд╛рдл, рдЪрд┐рдирд┐рдпрд╛рдБ, рдмрдзрд╛рдИ, рдмрдзрд╛рдИрд╣рд░реВ рдЖрдЗрдбрд┐рдпреЛрдЧреНрд░рд╛рдл
уКЩ => уКЩ, рдЖрдЗрдбрд┐рдпреЛрдЧреНрд░рд╛рдл, рдЧреЛрдкреНрдп, рдЧреЛрд▓реЛ рдЧреЛрдкреНрдп рдЖрдЗрдбрд┐рдпреЛрдЧреНрд░рд╛рдл, рдЪрд┐рдирд┐рдпрд╛рдБ
ЁЯИ║ => ЁЯИ║, рдЪрд┐рдирд┐рдпрд╛рдБ, рд╕реНрдХреНрд╡рд╛рдпрд░реНрдб рд╕рдЮреНрдЪрд╛рд▓рди рдЖрдЗрдбрд┐рдпреЛрдЧреНрд░рд╛рдл
ЁЯИ╡ => ЁЯИ╡, рдЪрд┐рдирд┐рдпрд╛рдБ, рд╕реНрдХреНрд╡рд╛рдпрд░реНрдб рдкреВрд░реНрдг рдЖрдЗрдбрд┐рдпреЛрдЧреНрд░рд╛рдл
тЦк => тЦк, рдХрд╛рд▓реЛ рд╕рд╛рдиреЛ рд╡рд░реНрдЧ, рдЬреНрдпрд╛рдорд┐рддреАрдп, рд╡рд░реНрдЧ
тЦл => тЦл, рдЬреНрдпрд╛рдорд┐рддреАрдп, рд╡рд░реНрдЧ, рд╕реЗрддреЛ рд╕рд╛рдиреЛ рд╡рд░реНрдЧ
тЧ╗ => тЧ╗, рдЬреНрдпрд╛рдорд┐рддреАрдп, рд╡рд░реНрдЧ, рд╕реЗрддреЛ рдордзреНрдпрдо рд╡рд░реНрдЧ
тЧ╝ => тЧ╝, рдХрд╛рд▓реЛ рдордзреНрдпрдо рд╡рд░реНрдЧ, рдЬреНрдпрд╛рдорд┐рддреАрдп, рд╡рд░реНрдЧ
тЧ╜ => тЧ╜, рдЬреНрдпрд╛рдорд┐рддреАрдп, рд╡рд░реНрдЧ, рд╕реЗрддреЛ рдордзреНрдпрдо-рд╕рд╛рдиреЛ рд╡рд░реНрдЧ
тЧ╛ => тЧ╛, рдХрд╛рд▓реЛ рдордзреНрдпрдо-рд╕рд╛рдиреЛ рд╡рд░реНрдЧ, рдЬреНрдпрд╛рдорд┐рддреАрдп, рд╡рд░реНрдЧ
тмЫ => тмЫ, рдХрд╛рд▓реЛ рдареВрд▓реЛ рд╡рд░реНрдЧ, рдЬреНрдпрд╛рдорд┐рддреАрдп, рд╡рд░реНрдЧ
тмЬ => тмЬ, рдЬреНрдпрд╛рдорд┐рддреАрдп, рд╡рд░реНрдЧ, рд╕реЗрддреЛ рдареВрд▓реЛ рд╡рд░реНрдЧ
ЁЯФ╢ => ЁЯФ╢, рдЬреНрдпрд╛рдорд┐рддреАрдп, рдареВрд▓реЛ рд╕реБрдиреНрддрд▓рд╛ рд╣рд┐рд░рд╛, рд╕реБрдиреНрддрд▓рд╛, рд╣рд┐рд░рд╛
ЁЯФ╖ => ЁЯФ╖, рдЬреНрдпрд╛рдорд┐рддреАрдп, рдареВрд▓реЛ рдиреАрд▓реЛ рд╣рд┐рд░рд╛, рдиреАрд▓реЛ, рд╣рд┐рд░рд╛
ЁЯФ╕ => ЁЯФ╕, рдЬреНрдпрд╛рдорд┐рддреАрдп, рд╕рд╛рдиреЛ рд╕реБрдиреНрддрд▓рд╛ рд╣рд┐рд░рд╛, рд╕реБрдиреНрддрд▓рд╛, рд╣рд┐рд░рд╛
ЁЯФ╣ => ЁЯФ╣, рдЬреНрдпрд╛рдорд┐рддреАрдп, рдиреАрд▓реЛ, рд╕рд╛рдиреЛ рдиреАрд▓реЛ рд╣рд┐рд░рд╛, рд╣рд┐рд░рд╛
ЁЯФ║ => ЁЯФ║, рдЬреНрдпрд╛рдорд┐рддреАрдп, рдорд╛рдерд┐ рд╕рдВрдХреЗрдд рдЧрд░рд┐рдПрдХреЛ рд░рд╛рддреЛ рддреНрд░рд┐рдХреЛрдг, рд░рд╛рддреЛ
ЁЯФ╗ => ЁЯФ╗, рдЬреНрдпрд╛рдорд┐рддреАрдп, рддрд▓, рддрд▓ рд╕рдВрдХреЗрдд рдЧрд░рд┐рдПрдХреЛ рд░рд╛рддреЛ рддреНрд░рд┐рдХреЛрдг, рд░рд╛рддреЛ
ЁЯТа => ЁЯТа, рдЬреНрдпрд╛рдорд┐рддреАрдп, рдбрдЯрд╕рд╣рд┐рддрдХреЛ рд╣рд┐рд░рд╛, рднрд┐рддреНрд░, рд╣рдБрд╕рд╛рдЙрдиреЗ, рд╣рд┐рд░рд╛
ЁЯФШ => ЁЯФШ, рдЬреНрдпрд╛рдорд┐рддреАрдп, рдмрдЯрди, рд░реЗрдбрд┐рдпреЛ, рд░реЗрдбрд┐рдпреЛ рдмрдЯрди
ЁЯФ▓ => ЁЯФ▓, рдХрд╛рд▓реЛ рд╡рд░реНрдЧреАрдп рдмрдЯрди, рдЬреНрдпрд╛рдорд┐рддреАрдп, рдмрдЯрди, рд╡рд░реНрдЧ
ЁЯФ│ => ЁЯФ│, рдЫреЗрдЙрдХреЛ рд░реЗрдЦрд╛, рдЬреНрдпрд╛рдорд┐рддреАрдп, рдмрдЯрди, рд╡рд░реНрдЧ, рд╕реЗрддреЛ рд╡рд░реНрдЧреАрдп рдмрдЯрди
тЪк => тЪк, рдШреЗрд░рд╛, рдЬреНрдпрд╛рдорд┐рддреАрдп, рд╕реЗрддреЛ рдШреЗрд░рд╛
тЪл => тЪл, рдХрд╛рд▓реЛ рдШреЗрд░рд╛, рдШреЗрд░рд╛, рдЬреНрдпрд╛рдорд┐рддреАрдп
ЁЯФ┤ => ЁЯФ┤, рдШреЗрд░рд╛, рдЬреНрдпрд╛рдорд┐рддреАрдп, рд░рд╛рддреЛ, рд░рд╛рддреЛ рдШреЗрд░рд╛
ЁЯФ╡ => ЁЯФ╡, рдШреЗрд░рд╛, рдЬреНрдпрд╛рдорд┐рддреАрдп, рдиреАрд▓реЛ, рдиреАрд▓реЛ рдШреЗрд░рд╛
ЁЯПБ => ЁЯПБ, рдЪреЗрдХрд░рд╡рд╛рд▓рд╛, рдЪреЗрдХрд░рд╡рд╛рд▓рд╛ рдЭрдгреНрдбрд╛, рдЪреЗрдХрд░реНрдб, рджреМрдВрдб
ЁЯЪй => ЁЯЪй, рддреАрдирдХреБрдиреЗ рдЭрдгреНрдбрд╛, рдкреЛрд╕реНрдЯ
ЁЯОМ => ЁЯОМ, рдХреНрд░рд╕, рдХреНрд░рд╕ рдЧрд░рд┐рдПрдХреЛ, рдХреНрд░рд╕ рдЧрд░рд┐рдПрдХреЛ рдЭрдгреНрдбрд╛рд╣рд░реВ, рдЭрдгреНрдбрд╛рд╣рд░реВ, рд╕рдорд╛рд░реЛрд╣
ЁЯП┤ => ЁЯП┤, рд╣рд▓реНрд▓рд┐рд░рд╣реЗрдХреЛ, рд╣рд▓реНрд▓рд┐рд░рд╣реЗрдХреЛ рдХрд╛рд▓реЛ рдЭрдгреНрдбрд╛
ЁЯП│ => ЁЯП│, рд╣рд▓реНрд▓рд┐рд░рд╣реЗрдХреЛ, рд╣рд▓реНрд▓рд┐рд░рд╣реЗрдХреЛ рд╕реЗрддреЛ рдЭрдгреНрдбрд╛
ЁЯП│тАНЁЯМИ => ЁЯП│тАНЁЯМИ, рдЗрдиреНрджреНрд░реЗрдгреА, рдЗрдиреНрджреНрд░реЗрдгреА рдЭрдгреНрдбрд╛, рдЭрдгреНрдбрд╛
ЁЯЗжЁЯЗи => ЁЯЗжЁЯЗи, рдПрд╕реНрдХреЗрдиреНрд╕рди рдЯрд╛рдкреБ
ЁЯЗжЁЯЗй => ЁЯЗжЁЯЗй, рдЕрдиреНрдбреЛрд░реНрд░рд╛
ЁЯЗжЁЯЗк => ЁЯЗжЁЯЗк, рд╕рдВрдпреБрдХреНрдд рдЕрд░рдм рдЗрдорд┐рд░рд╛рдЯреНрд╕
ЁЯЗжЁЯЗл => ЁЯЗжЁЯЗл, рдЕрдлрдЧрд╛рдирд┐рд╕реНрддрд╛рди
ЁЯЗжЁЯЗм => ЁЯЗжЁЯЗм, рдПрдиреНрдЯрд┐рдЧреБрдЖ рд░ рдмрд╛рд░рдмреБрдбрд╛
ЁЯЗжЁЯЗо => ЁЯЗжЁЯЗо, рдЖрдЩреНрдЧреБрдЗрд▓рд╛
ЁЯЗжЁЯЗ▒ => ЁЯЗжЁЯЗ▒, рдЕрд▓реНрдмреЗрдирд┐рдпрд╛
ЁЯЗжЁЯЗ▓ => ЁЯЗжЁЯЗ▓, рдЖрд░реНрдореЗрдирд┐рдпрд╛
ЁЯЗжЁЯЗ┤ => ЁЯЗжЁЯЗ┤, рдЕрдЩреНрдЧреЛрд▓рд╛
ЁЯЗжЁЯЗ╢ => ЁЯЗжЁЯЗ╢, рдЕрдиреНрдЯрд╛рд░рдЯрд┐рдХрд╛
ЁЯЗжЁЯЗ╖ => ЁЯЗжЁЯЗ╖, рдЕрд░реНрдЬреЗрдиреНрдЯрд┐рдирд╛
ЁЯЗжЁЯЗ╕ => ЁЯЗжЁЯЗ╕, рдЕрдореЗрд░рд┐рдХреА рд╕рдореЛрдЖ
ЁЯЗжЁЯЗ╣ => ЁЯЗжЁЯЗ╣, рдЕрд╖реНрдЯреНрд░рд┐рдпрд╛
ЁЯЗжЁЯЗ║ => ЁЯЗжЁЯЗ║, рдЕрд╖реНрдЯреНрд░реЗрд▓рд┐рдпрд╛
ЁЯЗжЁЯЗ╝ => ЁЯЗжЁЯЗ╝, рдЕрд░реБрдмрд╛
ЁЯЗжЁЯЗ╜ => ЁЯЗжЁЯЗ╜, рдЕрд▓рд╛рдиреНрдб рдЯрд╛рдкреБрд╣рд░реБ
ЁЯЗжЁЯЗ┐ => ЁЯЗжЁЯЗ┐, рдЕрдЬрд░рдмреИрдЬрд╛рди
ЁЯЗзЁЯЗж => ЁЯЗзЁЯЗж, рдмреЛрд╕реНрдирд┐рдпрд╛ рдПрдгреНрдб рд╣рд░реНрдЬрдЧреЛрднрд┐рдирд┐рдпрд╛
ЁЯЗзЁЯЗз => ЁЯЗзЁЯЗз, рдмрд╛рд░реНрдмрд╛рдбреЛрд╕
ЁЯЗзЁЯЗй => ЁЯЗзЁЯЗй, рдмрдЩреНрдЧрд▓рд╛рджреЗрд╢
ЁЯЗзЁЯЗк => ЁЯЗзЁЯЗк, рдмреЗрд▓реНрдЬрд┐рдпрдо
ЁЯЗзЁЯЗл => ЁЯЗзЁЯЗл, рдмрд░реНрдХрд┐рдирд╛ рдлрд╛рд╕реЛ
ЁЯЗзЁЯЗм => ЁЯЗзЁЯЗм, рдмреБрд▓реНрдЧреЗрд░рд┐рдпрд╛
ЁЯЗзЁЯЗн => ЁЯЗзЁЯЗн, рдмрд╣рд░рд╛рдЗрди
ЁЯЗзЁЯЗо => ЁЯЗзЁЯЗо, рдмреБрд░реВрдгреНрдбреА
ЁЯЗзЁЯЗп => ЁЯЗзЁЯЗп, рдмреЗрдирд┐рди
ЁЯЗзЁЯЗ▒ => ЁЯЗзЁЯЗ▒, рд╕реЗрдиреНрдЯ рдмрд╛рд░реНрдерд╛рд▓реЗрдореА
ЁЯЗзЁЯЗ▓ => ЁЯЗзЁЯЗ▓, рдмрд░реНрдореБрдбрд╛
ЁЯЗзЁЯЗ│ => ЁЯЗзЁЯЗ│, рдмреНрд░реБрдирд╛рдЗ
ЁЯЗзЁЯЗ┤ => ЁЯЗзЁЯЗ┤, рдмреЛрд▓рд┐рднрд┐рдпрд╛
ЁЯЗзЁЯЗ╢ => ЁЯЗзЁЯЗ╢, рдХреНрдпрд╛рд░рд┐рд╡рд┐рдпрди рдиреЗрджрд░рд▓реНрдпрд╛рдгреНрдбреНрд╕
ЁЯЗзЁЯЗ╖ => ЁЯЗзЁЯЗ╖, рдмреНрд░рд╛рдЬрд┐рд▓
ЁЯЗзЁЯЗ╕ => ЁЯЗзЁЯЗ╕, рдмрд╣рд╛рдорд╛рд╕
ЁЯЗзЁЯЗ╣ => ЁЯЗзЁЯЗ╣, рднреБрдЯрд╛рди
ЁЯЗзЁЯЗ╗ => ЁЯЗзЁЯЗ╗, рдмреБрднреЗрдЯ рдЯрд╛рдкреБ
ЁЯЗзЁЯЗ╝ => ЁЯЗзЁЯЗ╝, рдмреЛрдЯреНрд╕реНрд╡рд╛рдирд╛
ЁЯЗзЁЯЗ╛ => ЁЯЗзЁЯЗ╛, рдмреЗрд▓рд╛рд░реВрд╕
ЁЯЗзЁЯЗ┐ => ЁЯЗзЁЯЗ┐, рдмреЗрд▓рд┐рдЬ
ЁЯЗиЁЯЗж => ЁЯЗиЁЯЗж, рдХреНрдпрд╛рдирд╛рдбрд╛
ЁЯЗиЁЯЗи => ЁЯЗиЁЯЗи, рдХреЛрдХреЛрд╕ (рдХрд┐рд▓рд┐рдВрдЧ) рдЯрд╛рдкреБрд╣рд░реБ
ЁЯЗиЁЯЗй => ЁЯЗиЁЯЗй, рдХрдЩреНрдЧреЛ - рдХрд┐рдиреНрд╢рд╛рд╕рд╛
ЁЯЗиЁЯЗл => ЁЯЗиЁЯЗл, рдХреЗрдиреНрджреНрд░реАрдп рдЕрдлреНрд░рд┐рдХреА рдЧрдгрддрдиреНрддреНрд░
ЁЯЗиЁЯЗм => ЁЯЗиЁЯЗм, рдХрдЩреНрдЧреЛ рдмреНрд░рд╛рдЬрд╛рднрд┐рд▓
ЁЯЗиЁЯЗн => ЁЯЗиЁЯЗн, рд╕реНрд╡рд┐рдЬрд░рд▓реНрдпрд╛рдгреНрдб
ЁЯЗиЁЯЗо => ЁЯЗиЁЯЗо, рдЖрдЗрднреЛрд░реА рдХреЛрд╕реНрдЯ
ЁЯЗиЁЯЗ░ => ЁЯЗиЁЯЗ░, рдХреБрдХ рдЯрд╛рдкреБрд╣рд░реБ
ЁЯЗиЁЯЗ▒ => ЁЯЗиЁЯЗ▒, рдЪрд┐рд▓реА
ЁЯЗиЁЯЗ▓ => ЁЯЗиЁЯЗ▓, рдХреНрдпрд╛рдорд░реВрди
ЁЯЗиЁЯЗ│ => ЁЯЗиЁЯЗ│, рдЪреАрди
ЁЯЗиЁЯЗ┤ => ЁЯЗиЁЯЗ┤, рдХреЛрд▓реЛрдореНрдмрд┐рдпрд╛
ЁЯЗиЁЯЗ╡ => ЁЯЗиЁЯЗ╡, рдХреНрд▓рд┐рдкреНрдкреЗрд░реНрдЯрди рдЯрд╛рдкреБ
ЁЯЗиЁЯЗ╖ => ЁЯЗиЁЯЗ╖, рдХреЛрд╖реНрдЯрд╛рд░рд┐рдХрд╛
ЁЯЗиЁЯЗ║ => ЁЯЗиЁЯЗ║, рдХреНрдпреБрдмрд╛
ЁЯЗиЁЯЗ╗ => ЁЯЗиЁЯЗ╗, рдХреЗрдк рднрд░реНрдбреЗ
ЁЯЗиЁЯЗ╝ => ЁЯЗиЁЯЗ╝, рдХреБрд░рд╛рдХрд╛рдУ
ЁЯЗиЁЯЗ╜ => ЁЯЗиЁЯЗ╜, рдХреНрд░рд┐рд╖реНрдЯрдорд╕ рдЯрд╛рдкреБ
ЁЯЗиЁЯЗ╛ => ЁЯЗиЁЯЗ╛, рд╕рд╛рдЗрдкреНрд░рд╕
ЁЯЗиЁЯЗ┐ => ЁЯЗиЁЯЗ┐, рдЪреЗрдХрд┐рдпрд╛
ЁЯЗйЁЯЗк => ЁЯЗйЁЯЗк, рдЬрд░реНрдордиреА
ЁЯЗйЁЯЗм => ЁЯЗйЁЯЗм, рдбрд┐рдпрдЧреЛ рдЧрд╛рд░реНрд╕рд┐рдпрд╛
ЁЯЗйЁЯЗп => ЁЯЗйЁЯЗп, рдбрд┐рдЬрд┐рдмреБрдЯреА
ЁЯЗйЁЯЗ░ => ЁЯЗйЁЯЗ░, рдбреЗрдирдорд╛рд░реНрдХ
ЁЯЗйЁЯЗ▓ => ЁЯЗйЁЯЗ▓, рдбреЛрдорд┐рдирд┐рдХрд╛
ЁЯЗйЁЯЗ┤ => ЁЯЗйЁЯЗ┤, рдбреЛрдорд┐рдирд┐рдХрди рдЧрдгрддрдиреНрддреНрд░
ЁЯЗйЁЯЗ┐ => ЁЯЗйЁЯЗ┐, рдЕрд▓реНрдЬреЗрд░рд┐рдпрд╛
ЁЯЗкЁЯЗж => ЁЯЗкЁЯЗж, рд╕рд┐рдЙрдЯрд╛ рд░ рдореЗрд▓рд┐рд▓рд╛
ЁЯЗкЁЯЗи => ЁЯЗкЁЯЗи, рдЗрдХреНрд╡реЗрдбреЛрд░
ЁЯЗкЁЯЗк => ЁЯЗкЁЯЗк, рдЗрд╕реНрдЯреЛрдирд┐рдпрд╛
ЁЯЗкЁЯЗм => ЁЯЗкЁЯЗм, рдЗрдЬрд┐рдкреНрдЯ
ЁЯЗкЁЯЗн => ЁЯЗкЁЯЗн, рдкрд╢реНрдЪрд┐рдореА рд╕рд╛рд╣рд╛рд░рд╛
ЁЯЗкЁЯЗ╖ => ЁЯЗкЁЯЗ╖, рдПрд░рд┐рддреНрд░рд┐рдпрд╛
ЁЯЗкЁЯЗ╕ => ЁЯЗкЁЯЗ╕, рд╕реНрдкреЗрди
ЁЯЗкЁЯЗ╣ => ЁЯЗкЁЯЗ╣, рдЗрдерд┐рдпреЛрдкрд┐рдпрд╛
ЁЯЗкЁЯЗ║ => ЁЯЗкЁЯЗ║, рдпреБрд░реЛрдкрд┐рдпрди рдпреБрдирд┐рдпрди
ЁЯЗкЁЯЗ┐ => ЁЯЗкЁЯЗ┐, рдпреБрд░реЛрдЬреЛрди
ЁЯЗлЁЯЗо => ЁЯЗлЁЯЗо, рдлрд┐рдиреНрд▓реНрдпрд╛рдгреНрдб
ЁЯЗлЁЯЗп => ЁЯЗлЁЯЗп, рдлрд┐рдЬреА
ЁЯЗлЁЯЗ░ => ЁЯЗлЁЯЗ░, рдлрдХрд▓реНрдпрд╛рдгреНрдб рдЯрд╛рдкреБрд╣рд░реБ
ЁЯЗлЁЯЗ▓ => ЁЯЗлЁЯЗ▓, рдорд╛рдЗрдХреНрд░реЛрдиреЗрд╕рд┐рдпрд╛
ЁЯЗлЁЯЗ┤ => ЁЯЗлЁЯЗ┤, рдлрд╛рд░реЛ рдЯрд╛рдкреБрд╣рд░реВ
ЁЯЗлЁЯЗ╖ => ЁЯЗлЁЯЗ╖, рдлреНрд░рд╛рдиреНрд╕
ЁЯЗмЁЯЗж => ЁЯЗмЁЯЗж, рдЧрд╛рд╡реЛрди
ЁЯЗмЁЯЗз => ЁЯЗмЁЯЗз, рдмреЗрд▓рд╛рдпрдд
ЁЯЗмЁЯЗй => ЁЯЗмЁЯЗй, рдЧреНрд░реЗрдирд╛рдбрд╛
ЁЯЗмЁЯЗк => ЁЯЗмЁЯЗк, рдЬрд░реНрдЬрд┐рдпрд╛
ЁЯЗмЁЯЗл => ЁЯЗмЁЯЗл, рдлреНрд░рд╛рдиреНрд╕реЗрд▓реА рдЧрд╛рдпрдирд╛
ЁЯЗмЁЯЗм => ЁЯЗмЁЯЗм, рдЧреБрдПрд░реНрдирд╕реЗ
ЁЯЗмЁЯЗн => ЁЯЗмЁЯЗн, рдШрд╛рдирд╛
ЁЯЗмЁЯЗо => ЁЯЗмЁЯЗо, рдЬрд┐рдмреНрд░рд╛рд▓реНрдЯрд╛рд░
ЁЯЗмЁЯЗ▒ => ЁЯЗмЁЯЗ▒, рдЧреНрд░рд┐рдирд▓реНрдпрд╛рдгреНрдб
ЁЯЗмЁЯЗ▓ => ЁЯЗмЁЯЗ▓, рдЧрд╛рдореНрд╡рд┐рдпрд╛
ЁЯЗмЁЯЗ│ => ЁЯЗмЁЯЗ│, рдЧрд┐рдиреА
ЁЯЗмЁЯЗ╡ => ЁЯЗмЁЯЗ╡, рдЧреНрд╡рд╛рдбреЗрд▓реБрдк
ЁЯЗмЁЯЗ╢ => ЁЯЗмЁЯЗ╢, рднреВ-рдордзреНрдпреАрдп рдЧрд┐рдиреА
ЁЯЗмЁЯЗ╖ => ЁЯЗмЁЯЗ╖, рдЧреНрд░рд┐рд╕
ЁЯЗмЁЯЗ╕ => ЁЯЗмЁЯЗ╕, рджрдХреНрд╖рд┐рдг рдЬрд░реНрдЬрд┐рдпрд╛ рд░ рджрдХреНрд╖рд┐рдг рд╕реНрдпрд╛рдиреНрдбрд╡реАрдЪ рдЯрд╛рдкреБрд╣рд░реВ
ЁЯЗмЁЯЗ╣ => ЁЯЗмЁЯЗ╣, рдЧреНрд╡рд╛рдЯреЗрдорд╛рд▓рд╛
ЁЯЗмЁЯЗ║ => ЁЯЗмЁЯЗ║, рдЧреБрд╡рд╛рдо
ЁЯЗмЁЯЗ╝ => ЁЯЗмЁЯЗ╝, рдЧрд┐рдиреА-рдмрд┐рд╕рд╛рдЙ
ЁЯЗмЁЯЗ╛ => ЁЯЗмЁЯЗ╛, рдЧреБрдпрд╛рдирд╛
ЁЯЗнЁЯЗ░ => ЁЯЗнЁЯЗ░, рд╣рдЩрдХрдЩ рдЪрд┐рдирд┐рдпрд╛рдБ рд╕рдорд╛рдЬрдмрд╛рджреА рд╕реНрд╡рд╛рдпрддреНрдд рдХреНрд╖реЗрддреНрд░
ЁЯЗнЁЯЗ▓ => ЁЯЗнЁЯЗ▓, рд╣рд░реНрдб рдЯрд╛рдкреБ рд░ рдореНрдпрд╛рдХрдбреЛрдирд╛рд▓реНрдб рдЯрд╛рдкреБрд╣рд░реБ
ЁЯЗнЁЯЗ│ => ЁЯЗнЁЯЗ│, рд╣рдиреНрдбреБрд░рд╛рд╕
ЁЯЗнЁЯЗ╖ => ЁЯЗнЁЯЗ╖, рдХреНрд░реЛрдПрд╢рд┐рдпрд╛
ЁЯЗнЁЯЗ╣ => ЁЯЗнЁЯЗ╣, рд╣реИрдЯреА
ЁЯЗнЁЯЗ║ => ЁЯЗнЁЯЗ║, рд╣рдЩреНрдЧреЗрд░реА
ЁЯЗоЁЯЗи => ЁЯЗоЁЯЗи, рдХреНрдпрд╛рдирд╛рд░реА рдЯрд╛рдкреБрд╣рд░реВ
ЁЯЗоЁЯЗй => ЁЯЗоЁЯЗй, рдЗрдиреНрдбреЛрдиреЗрд╢рд┐рдпрд╛
ЁЯЗоЁЯЗк => ЁЯЗоЁЯЗк, рдЖрдпрд░рд▓реНрдпрд╛рдгреНрдб
ЁЯЗоЁЯЗ▒ => ЁЯЗоЁЯЗ▒, рдЗрдЬрд░рд╛рдпрд▓
ЁЯЗоЁЯЗ▓ => ЁЯЗоЁЯЗ▓, рдЖрдЗрд▓ рдЕрдл рдореНрдпрд╛рди
ЁЯЗоЁЯЗ│ => ЁЯЗоЁЯЗ│, рднрд╛рд░рдд
ЁЯЗоЁЯЗ┤ => ЁЯЗоЁЯЗ┤, рдмреЗрд▓рд╛рдпрддреА рд╣рд┐рдиреНрдж рдорд╣рд╛рд╕рд╛рдЧрд░ рдХреНрд╖реЗрддреНрд░
ЁЯЗоЁЯЗ╢ => ЁЯЗоЁЯЗ╢, рдЗрд░рд╛рдХ
ЁЯЗоЁЯЗ╖ => ЁЯЗоЁЯЗ╖, рдЗрд░рд╛рди
ЁЯЗоЁЯЗ╕ => ЁЯЗоЁЯЗ╕, рдЖрдЗрд╕реНрд▓реНрдпрд╛рдгреНрдб
ЁЯЗоЁЯЗ╣ => ЁЯЗоЁЯЗ╣, рдЗрдЯрд╛рд▓реА
ЁЯЗпЁЯЗк => ЁЯЗпЁЯЗк, рдЬрд░реНрд╕реА
ЁЯЗпЁЯЗ▓ => ЁЯЗпЁЯЗ▓, рдЬрдорд╛рдЗрдХрд╛
ЁЯЗпЁЯЗ┤ => ЁЯЗпЁЯЗ┤, рдЬреЛрд░реНрдбрди
ЁЯЗпЁЯЗ╡ => ЁЯЗпЁЯЗ╡, рдЬрд╛рдкрд╛рди
ЁЯЗ░ЁЯЗк => ЁЯЗ░ЁЯЗк, рдХреЗрдиреНрдпрд╛
ЁЯЗ░ЁЯЗм => ЁЯЗ░ЁЯЗм, рдХрд┐рд░реНрдЧрд┐рд╕реНрддрд╛рди
ЁЯЗ░ЁЯЗн => ЁЯЗ░ЁЯЗн, рдХрдореНрдмреЛрдбрд┐рдпрд╛
ЁЯЗ░ЁЯЗо => ЁЯЗ░ЁЯЗо, рдХрд┐рд░рд┐рдмрд╛рдЯреА
ЁЯЗ░ЁЯЗ▓ => ЁЯЗ░ЁЯЗ▓, рдХреЛрдореЛрд░реЛрд╕
ЁЯЗ░ЁЯЗ│ => ЁЯЗ░ЁЯЗ│, рд╕реЗрдиреНрдЯ рдХрд┐рдЯреНрд╕ рд░ рдиреЗрднрд┐рд╕
ЁЯЗ░ЁЯЗ╡ => ЁЯЗ░ЁЯЗ╡, рдЙрддреНрддрд░ рдХреЛрд░рд┐рдпрд╛
ЁЯЗ░ЁЯЗ╖ => ЁЯЗ░ЁЯЗ╖, рджрдХреНрд╖рд┐рдг рдХреЛрд░рд┐рдпрд╛
ЁЯЗ░ЁЯЗ╝ => ЁЯЗ░ЁЯЗ╝, рдХреБрд╡реЗрдд
ЁЯЗ░ЁЯЗ╛ => ЁЯЗ░ЁЯЗ╛, рдХреЗрдпрдорд╛рди рдЯрд╛рдкреБ
ЁЯЗ░ЁЯЗ┐ => ЁЯЗ░ЁЯЗ┐, рдХрд╛рдЬрд╛рдХрд╕реНрддрд╛рди
ЁЯЗ▒ЁЯЗж => ЁЯЗ▒ЁЯЗж, рд▓рд╛рдУрд╕
ЁЯЗ▒ЁЯЗз => ЁЯЗ▒ЁЯЗз, рд▓реЗрдмрдирди
ЁЯЗ▒ЁЯЗи => ЁЯЗ▒ЁЯЗи, рд╕реЗрдиреНрдЯ рд▓реБрд╕рд┐рдпрд╛
ЁЯЗ▒ЁЯЗо => ЁЯЗ▒ЁЯЗо, рд▓рд┐рдПрдЦрдЯреЗрдиреНрд╕реНрдЯрд╛рдЗрди
ЁЯЗ▒ЁЯЗ░ => ЁЯЗ▒ЁЯЗ░, рд╢реНрд░реАрд▓рдЩреНрдХрд╛
ЁЯЗ▒ЁЯЗ╖ => ЁЯЗ▒ЁЯЗ╖, рд▓рд╛рдЗрдмреЗрд░рд┐рдпрд╛
ЁЯЗ▒ЁЯЗ╕ => ЁЯЗ▒ЁЯЗ╕, рд▓реЗрд╕реЛрдереЛ
ЁЯЗ▒ЁЯЗ╣ => ЁЯЗ▒ЁЯЗ╣, рд▓рд┐рдереБрдПрдирд┐рдпрд╛
ЁЯЗ▒ЁЯЗ║ => ЁЯЗ▒ЁЯЗ║, рд▓рдХреНрдЬреЗрдордмрд░реНрдЧ
ЁЯЗ▒ЁЯЗ╗ => ЁЯЗ▒ЁЯЗ╗, рд▓рд╛рдЯреНрднрд┐рдпрд╛
ЁЯЗ▒ЁЯЗ╛ => ЁЯЗ▒ЁЯЗ╛, рд▓рд┐рдмрд┐рдпрд╛
ЁЯЗ▓ЁЯЗж => ЁЯЗ▓ЁЯЗж, рдореЛрд░реЛрдХреНрдХреЛ
ЁЯЗ▓ЁЯЗи => ЁЯЗ▓ЁЯЗи, рдореЛрдирд╛рдХреЛ
ЁЯЗ▓ЁЯЗй => ЁЯЗ▓ЁЯЗй, рдорд╛рд▓реНрдбреЛрднрд╛
ЁЯЗ▓ЁЯЗк => ЁЯЗ▓ЁЯЗк, рдореЛрдиреНрдЯреЗрдиреЗрдЧреНрд░реЛ
ЁЯЗ▓ЁЯЗл => ЁЯЗ▓ЁЯЗл, рд╕реЗрдиреНрдЯ рдорд╛рд░реНрдЯрд┐рди
ЁЯЗ▓ЁЯЗм => ЁЯЗ▓ЁЯЗм, рдорд╛рдбрд╛рдЧрд╛рд╕реНрдХрд░
ЁЯЗ▓ЁЯЗн => ЁЯЗ▓ЁЯЗн, рдорд╛рд░реНрд╢рд▓ рдЯрд╛рдкреБрд╣рд░реБ
ЁЯЗ▓ЁЯЗ░ => ЁЯЗ▓ЁЯЗ░, рдореНрдпрд╛рд╕реЗрдбреЛрдирд┐рдпрд╛
ЁЯЗ▓ЁЯЗ▒ => ЁЯЗ▓ЁЯЗ▒, рдорд╛рд▓реА
ЁЯЗ▓ЁЯЗ▓ => ЁЯЗ▓ЁЯЗ▓, рдореНрдпрд╛рдиреНрдорд╛рд░ (рдмрд░реНрдорд╛)
ЁЯЗ▓ЁЯЗ│ => ЁЯЗ▓ЁЯЗ│, рдордЩреНрдЧреЛрд▓рд┐рдпрд╛
ЁЯЗ▓ЁЯЗ┤ => ЁЯЗ▓ЁЯЗ┤, рдордХрд╛рдЙ рдЪрд┐рдирд┐рдпрд╛рдБ рд╕реНрд╡рд╢рд╛рд╕рд┐рдд рдХреНрд╖реЗрддреНрд░
ЁЯЗ▓ЁЯЗ╡ => ЁЯЗ▓ЁЯЗ╡, рдЙрддреНрддрд░реА рдорд╛рд░рд┐рдЖрдирд╛ рдЯрд╛рдкреБ
ЁЯЗ▓ЁЯЗ╢ => ЁЯЗ▓ЁЯЗ╢, рдорд╛рд░реНрдЯрд┐рдирд┐рдХ
ЁЯЗ▓ЁЯЗ╖ => ЁЯЗ▓ЁЯЗ╖, рдорд╛рдЙрд░рд┐рдЯрд╛рдирд┐рдпрд╛
ЁЯЗ▓ЁЯЗ╕ => ЁЯЗ▓ЁЯЗ╕, рдореЛрдиреНрдЯрд╕реЗрд░реНрд░рд╛рдЯ
ЁЯЗ▓ЁЯЗ╣ => ЁЯЗ▓ЁЯЗ╣, рдорд╛рд▓реНрдЯрд╛
ЁЯЗ▓ЁЯЗ║ => ЁЯЗ▓ЁЯЗ║, рдорд╛рдЙрд░рд┐рдЯрд╕
ЁЯЗ▓ЁЯЗ╗ => ЁЯЗ▓ЁЯЗ╗, рдорд╛рд▓реНрджрд┐рднреНрд╕
ЁЯЗ▓ЁЯЗ╝ => ЁЯЗ▓ЁЯЗ╝, рдорд╛рд▓рд╛рд╡реА
ЁЯЗ▓ЁЯЗ╜ => ЁЯЗ▓ЁЯЗ╜, рдореЗрдХреНрд╕рд┐рдХреЛ
ЁЯЗ▓ЁЯЗ╛ => ЁЯЗ▓ЁЯЗ╛, рдорд▓реЗрд╕рд┐рдпрд╛
ЁЯЗ▓ЁЯЗ┐ => ЁЯЗ▓ЁЯЗ┐, рдореЛрдЬрд╛рдореНрдмрд┐рдХ
ЁЯЗ│ЁЯЗж => ЁЯЗ│ЁЯЗж, рдирд╛рдорд┐рдмрд┐рдпрд╛
ЁЯЗ│ЁЯЗи => ЁЯЗ│ЁЯЗи, рдиреНрдпреБ рдХреНрдпрд╛рд▓реЗрдбреЛрдирд┐рдпрд╛
ЁЯЗ│ЁЯЗк => ЁЯЗ│ЁЯЗк, рдирд╛рдЗрдЬрд░
ЁЯЗ│ЁЯЗл => ЁЯЗ│ЁЯЗл, рдиреЛрд░рдлреЛрд▓реНрдХ рдЯрд╛рдкреБ
ЁЯЗ│ЁЯЗм => ЁЯЗ│ЁЯЗм, рдирд╛рдЗрдЬреЗрд░рд┐рдпрд╛
ЁЯЗ│ЁЯЗо => ЁЯЗ│ЁЯЗо, рдирд┐рдХрд╛рд░рд╛рдЧреБрд╡рд╛
ЁЯЗ│ЁЯЗ▒ => ЁЯЗ│ЁЯЗ▒, рдиреЗрджрд░рд▓реНрдпрд╛рдгреНрдб
ЁЯЗ│ЁЯЗ┤ => ЁЯЗ│ЁЯЗ┤, рдирд░реНрд╡реЗ
ЁЯЗ│ЁЯЗ╡ => ЁЯЗ│ЁЯЗ╡, рдиреЗрдкрд╛рд▓
ЁЯЗ│ЁЯЗ╖ => ЁЯЗ│ЁЯЗ╖, рдирд╛рдЙрд░реВ
ЁЯЗ│ЁЯЗ║ => ЁЯЗ│ЁЯЗ║, рдирд┐рдпреБрдЗ
ЁЯЗ│ЁЯЗ┐ => ЁЯЗ│ЁЯЗ┐, рдиреНрдпреБрдЬрд┐рд▓реНрдпрд╛рдгреНрдб
ЁЯЗ┤ЁЯЗ▓ => ЁЯЗ┤ЁЯЗ▓, рдУрдорди
ЁЯЗ╡ЁЯЗж => ЁЯЗ╡ЁЯЗж, рдкреНрдпрд╛рдирд╛рдорд╛
ЁЯЗ╡ЁЯЗк => ЁЯЗ╡ЁЯЗк, рдкреЗрд░реВ
ЁЯЗ╡ЁЯЗл => ЁЯЗ╡ЁЯЗл, рдлреНрд░рд╛рдиреНрд╕реЗрд▓реА рдкреЛрд▓рд┐рдиреЗрд╕рд┐рдпрд╛
ЁЯЗ╡ЁЯЗм => ЁЯЗ╡ЁЯЗм, рдкрдкреБрдЖ рдиреНрдпреВ рдЧрд╛рдЗрдирд┐рдпрд╛
ЁЯЗ╡ЁЯЗн => ЁЯЗ╡ЁЯЗн, рдлрд┐рд▓рд┐рдкрд┐рдиреНрд╕
ЁЯЗ╡ЁЯЗ░ => ЁЯЗ╡ЁЯЗ░, рдкрд╛рдХрд┐рд╕реНрддрд╛рди
ЁЯЗ╡ЁЯЗ▒ => ЁЯЗ╡ЁЯЗ▒, рдкреЛрд▓реНрдпрд╛рдгреНрдб
ЁЯЗ╡ЁЯЗ▓ => ЁЯЗ╡ЁЯЗ▓, рд╕реЗрдиреНрдЯ рдкрд┐рд░реНрд░реЗ рд░ рдорд┐рдХреНрдХреЗрд▓реЛрди
ЁЯЗ╡ЁЯЗ│ => ЁЯЗ╡ЁЯЗ│, рдкрд┐рдЯрдХрд╛рдЗрд░реНрди рдЯрд╛рдкреБрд╣рд░реБ
ЁЯЗ╡ЁЯЗ╖ => ЁЯЗ╡ЁЯЗ╖, рдкреБрдПрд░реНрдЯреЛ рд░рд┐рдХреЛ
ЁЯЗ╡ЁЯЗ╕ => ЁЯЗ╡ЁЯЗ╕, рдкреНрдпрд╛рд▓реЗрд╕реНрдЯрдиреА рднреВ-рднрд╛рдЧрд╣рд░реБ
ЁЯЗ╡ЁЯЗ╣ => ЁЯЗ╡ЁЯЗ╣, рдкреЛрд░реНрдЪреБрдЧрд▓
ЁЯЗ╡ЁЯЗ╝ => ЁЯЗ╡ЁЯЗ╝, рдкрд▓рд╛рдЙ
ЁЯЗ╡ЁЯЗ╛ => ЁЯЗ╡ЁЯЗ╛, рдкреНрдпрд╛рд░рд╛рдЧреНрд╡реЗ
ЁЯЗ╢ЁЯЗж => ЁЯЗ╢ЁЯЗж, рдХрддрд╛рд░
ЁЯЗ╢ЁЯЗ┤ => ЁЯЗ╢ЁЯЗ┤, рдмрд╛рд╣реНрдп рдУрд╕рдирд┐рдпрд╛
ЁЯЗ╖ЁЯЗк => ЁЯЗ╖ЁЯЗк, рд░рд┐рдпреБрдирд┐рдпрди
ЁЯЗ╖ЁЯЗ┤ => ЁЯЗ╖ЁЯЗ┤, рд░реЛрдореЗрдирд┐рдпрд╛
ЁЯЗ╖ЁЯЗ╕ => ЁЯЗ╖ЁЯЗ╕, рд╕рд░реНрдмрд┐рдпрд╛
ЁЯЗ╖ЁЯЗ║ => ЁЯЗ╖ЁЯЗ║, рд░реВрд╕
ЁЯЗ╖ЁЯЗ╝ => ЁЯЗ╖ЁЯЗ╝, рд░рд╡рд╛рдгреНрдбрд╛
ЁЯЗ╕ЁЯЗж => ЁЯЗ╕ЁЯЗж, рд╕рд╛рдЙрджреА рдЕрд░рдм
ЁЯЗ╕ЁЯЗз => ЁЯЗ╕ЁЯЗз, рд╕реЛрд▓реЛрдореЛрди рдЯрд╛рдкреБрд╣рд░реБ
ЁЯЗ╕ЁЯЗи => ЁЯЗ╕ЁЯЗи, рд╕реЗрдЪреЗрд▓реЗрд╕
ЁЯЗ╕ЁЯЗй => ЁЯЗ╕ЁЯЗй, рд╕реБрдбрд╛рди
ЁЯЗ╕ЁЯЗк => ЁЯЗ╕ЁЯЗк, рд╕реНрд╡рд┐рдбреЗрди
ЁЯЗ╕ЁЯЗм => ЁЯЗ╕ЁЯЗм, рд╕рд┐рдЩреНрдЧрд╛рдкреБрд░
ЁЯЗ╕ЁЯЗн => ЁЯЗ╕ЁЯЗн, рд╕реЗрдиреНрдЯ рд╣реЗрд▓реЗрдирд╛
ЁЯЗ╕ЁЯЗо => ЁЯЗ╕ЁЯЗо, рд╕реНрд▓реЛрднреЗрдирд┐рдпрд╛
ЁЯЗ╕ЁЯЗп => ЁЯЗ╕ЁЯЗп, рд╕рднрд╛рд▓реНрдмрд╛рд░реНрдб рд░ рдЬрд╛рди рдорд╛рдпреЗрди
ЁЯЗ╕ЁЯЗ░ => ЁЯЗ╕ЁЯЗ░, рд╕реНрд▓реЛрднрд╛рдХрд┐рдпрд╛
ЁЯЗ╕ЁЯЗ▒ => ЁЯЗ╕ЁЯЗ▒, рд╕рд┐рдПрд░реНрд░рд╛ рд▓рд┐рдУрди
ЁЯЗ╕ЁЯЗ▓ => ЁЯЗ╕ЁЯЗ▓, рд╕рд╛рдиреН рдорд╛рд░рд┐рдиреЛ
ЁЯЗ╕ЁЯЗ│ => ЁЯЗ╕ЁЯЗ│, рд╕реЗрдиреЗрдЧрд▓
ЁЯЗ╕ЁЯЗ┤ => ЁЯЗ╕ЁЯЗ┤, рд╕реЛрдорд╛рд▓рд┐рдпрд╛
ЁЯЗ╕ЁЯЗ╖ => ЁЯЗ╕ЁЯЗ╖, рд╕реБрд░рд┐рдиреЗрдо
ЁЯЗ╕ЁЯЗ╕ => ЁЯЗ╕ЁЯЗ╕, рджрдХреНрд╖рд┐рдгреА рд╕реБрдбрд╛рди
ЁЯЗ╕ЁЯЗ╣ => ЁЯЗ╕ЁЯЗ╣, рд╕рд╛рдУ рдЯреЛрдореЗ рд░ рдкреНрд░рд┐рдиреНрд╕рд┐рдк
ЁЯЗ╕ЁЯЗ╗ => ЁЯЗ╕ЁЯЗ╗, рдПрд▓реН рд╕рд╛рд▓реНрднрд╛рдбреЛрд░
ЁЯЗ╕ЁЯЗ╜ => ЁЯЗ╕ЁЯЗ╜, рд╕рд┐рдиреНрдЯ рдорд╛рд░реНрдЯреЗрди
ЁЯЗ╕ЁЯЗ╛ => ЁЯЗ╕ЁЯЗ╛, рд╕рд┐рд░рд┐рдпрд╛
ЁЯЗ╕ЁЯЗ┐ => ЁЯЗ╕ЁЯЗ┐, рд╕реНрд╡рд╛рдЬрд┐рд▓реНрдпрд╛рдгреНрдб
ЁЯЗ╣ЁЯЗж => ЁЯЗ╣ЁЯЗж, рдЯреНрд░рд┐рд╕реНрдЯрд╛рди рдбрд╛ рдХреБрдиреНрд╣рд╛
ЁЯЗ╣ЁЯЗи => ЁЯЗ╣ЁЯЗи, рддреБрд░реНрдХ рд░ рдХрд╛рдЗрдХреЛрд╕ рдЯрд╛рдкреБ
ЁЯЗ╣ЁЯЗй => ЁЯЗ╣ЁЯЗй, рдЪрд╛рдб
ЁЯЗ╣ЁЯЗл => ЁЯЗ╣ЁЯЗл, рдлреНрд░рд╛рдиреНрд╕реЗрд▓реА рджрдХреНрд╖рд┐рдгреА рдХреНрд╖реЗрддреНрд░рд╣рд░реБ
ЁЯЗ╣ЁЯЗм => ЁЯЗ╣ЁЯЗм, рдЯреЛрдЧреЛ
ЁЯЗ╣ЁЯЗн => ЁЯЗ╣ЁЯЗн, рдерд╛рдЗрд▓реНрдпрд╛рдгреНрдб
ЁЯЗ╣ЁЯЗп => ЁЯЗ╣ЁЯЗп, рддрд╛рдЬрд┐рдХрд┐рд╕реНрддрд╛рди
ЁЯЗ╣ЁЯЗ░ => ЁЯЗ╣ЁЯЗ░, рддреЛрдХреЗрд▓рд╛рдЙ
ЁЯЗ╣ЁЯЗ▒ => ЁЯЗ╣ЁЯЗ▒, рдЯрд┐рдореЛрд░-рд▓реЗрд╕реНрдЯреЗ
ЁЯЗ╣ЁЯЗ▓ => ЁЯЗ╣ЁЯЗ▓, рддреБрд░реНрдХрдореЗрдирд┐рд╕реНрддрд╛рди
ЁЯЗ╣ЁЯЗ│ => ЁЯЗ╣ЁЯЗ│, рдЯреНрдпреБрдирд┐рд╕рд┐рдпрд╛
ЁЯЗ╣ЁЯЗ┤ => ЁЯЗ╣ЁЯЗ┤, рдЯреЛрдВрдЧрд╛
ЁЯЗ╣ЁЯЗ╖ => ЁЯЗ╣ЁЯЗ╖, рдЯрд░реНрдХреА
ЁЯЗ╣ЁЯЗ╣ => ЁЯЗ╣ЁЯЗ╣, рддреНрд░рд┐рдирд┐рдбрд╛рдб рдПрдгреНрдб рдЯреЛрдмрд╛рдЧреЛ
ЁЯЗ╣ЁЯЗ╗ => ЁЯЗ╣ЁЯЗ╗, рддреБрднрд╛рд▓реБ
ЁЯЗ╣ЁЯЗ╝ => ЁЯЗ╣ЁЯЗ╝, рддрд╛рдЗрд╡рд╛рди
ЁЯЗ╣ЁЯЗ┐ => ЁЯЗ╣ЁЯЗ┐, рддрд╛рдиреНрдЬрд╛рдирд┐рдпрд╛
ЁЯЗ║ЁЯЗж => ЁЯЗ║ЁЯЗж, рдпреБрдХреНрд░реЗрди
ЁЯЗ║ЁЯЗм => ЁЯЗ║ЁЯЗм, рдпреБрдЧрд╛рдгреНрдбрд╛
ЁЯЗ║ЁЯЗ▓ => ЁЯЗ║ЁЯЗ▓, рд╕рдВрдпреБрдХреНрдд рд░рд╛рдЬреНрдпрдХрд╛ рдмрд╛рд╣реНрдп рдЯрд╛рдкреБрд╣рд░реБ
ЁЯЗ║ЁЯЗ│ => ЁЯЗ║ЁЯЗ│, рд╕рдВрдпреБрдХреНрдд рд░рд╛рд╖реНрдЯреНрд░ рд╕рдВрдШ
ЁЯЗ║ЁЯЗ╕ => ЁЯЗ║ЁЯЗ╕, рд╕рдВрдпреБрдХреНрдд рд░рд╛рдЬреНрдп
ЁЯЗ║ЁЯЗ╛ => ЁЯЗ║ЁЯЗ╛, рдЙрд░реВрдЧреНрд╡реЗ
ЁЯЗ║ЁЯЗ┐ => ЁЯЗ║ЁЯЗ┐, рдЙрдЬреНрдмреЗрдХрд┐рд╕реНрддрд╛рди
ЁЯЗ╗ЁЯЗж => ЁЯЗ╗ЁЯЗж, рднреЗрдЯрд┐рдХрди рд╕рд┐рдЯреА
ЁЯЗ╗ЁЯЗи => ЁЯЗ╗ЁЯЗи, рд╕реЗрдиреНрдЯ рднрд┐рдиреНрд╕реЗрдиреНрдЯ рд░ рдЧреНрд░реЗрдирд╛рдбрд┐рдиреНрд╕
ЁЯЗ╗ЁЯЗк => ЁЯЗ╗ЁЯЗк, рднреЗрдиреЗрдЬреБрдПрд▓рд╛
ЁЯЗ╗ЁЯЗм => ЁЯЗ╗ЁЯЗм, рдмреЗрд▓рд╛рдпрддреА рднрд░реНрдЬрд┐рди рдЯрд╛рдкреБрд╣рд░реБ
ЁЯЗ╗ЁЯЗо => ЁЯЗ╗ЁЯЗо, рд╕рдВрдпреБрдХреНрдд рд░рд╛рдЬреНрдп рднрд░реНрдЬрд┐рди рдЯрд╛рдкреБрд╣рд░реБ
ЁЯЗ╗ЁЯЗ│ => ЁЯЗ╗ЁЯЗ│, рднрд┐рдПрддрдирд╛рдо
ЁЯЗ╗ЁЯЗ║ => ЁЯЗ╗ЁЯЗ║, рднрд╛рдиреБрдЖрддреБ
ЁЯЗ╝ЁЯЗл => ЁЯЗ╝ЁЯЗл, рд╡рд╛рд▓рд┐рд╕ рд░ рдлреБрдЯреБрдирд╛
ЁЯЗ╝ЁЯЗ╕ => ЁЯЗ╝ЁЯЗ╕, рд╕рд╛рдореЛрдЖ
ЁЯЗ╜ЁЯЗ░ => ЁЯЗ╜ЁЯЗ░, рдХреЛрд╕реЛрднреЛ
ЁЯЗ╛ЁЯЗк => ЁЯЗ╛ЁЯЗк, рдпреЗрдореЗрди
ЁЯЗ╛ЁЯЗ╣ => ЁЯЗ╛ЁЯЗ╣, рдорд╛рдпреЛрдЯреНрдЯ
ЁЯЗ┐ЁЯЗж => ЁЯЗ┐ЁЯЗж, рджрдХреНрд╖рд┐рдг рдЕрдлреНрд░рд┐рдХрд╛
ЁЯЗ┐ЁЯЗ▓ => ЁЯЗ┐ЁЯЗ▓, рдЬрд╛рдореНрдмрд┐рдпрд╛
ЁЯЗ┐ЁЯЗ╝ => ЁЯЗ┐ЁЯЗ╝, рдЬрд┐рдореНрдмрд╛рдмреЗ
ЁЯЗ┐ЁЯЗ┐ => ЁЯЗ┐ЁЯЗ┐, рдЕрдЬреНрдЮрд╛рдд рдХреНрд╖реЗрддреНрд░